Orthogroup	apple_prot	fruticosa_prot	peach_prot	subA___prot	subA_prot	subB_prot	sweet_cherry_prot	Total
OG0000000	0	1	3	2	1	2	1065	1074
OG0000001	0	0	1	3	0	0	759	763
OG0000002	0	2	0	0	0	0	497	499
OG0000003	0	0	1	0	0	0	337	338
OG0000004	1	86	0	33	47	126	4	297
OG0000005	1	0	0	0	0	0	267	268
OG0000006	6	1	0	120	53	68	1	249
OG0000007	246	0	0	0	0	0	0	246
OG0000008	163	2	12	17	30	18	2	244
OG0000009	0	0	0	0	0	1	243	244
OG0000010	1	0	1	0	0	0	222	224
OG0000011	0	0	0	0	0	0	213	213
OG0000012	0	0	1	0	1	0	205	207
OG0000013	0	0	0	0	0	0	198	198
OG0000014	0	85	1	13	49	37	0	185
OG0000015	11	5	5	50	73	37	2	183
OG0000016	0	1	0	0	1	0	180	182
OG0000017	0	0	0	0	0	1	173	174
OG0000018	0	0	0	0	1	0	166	167
OG0000019	159	0	0	0	0	0	0	159
OG0000020	5	52	8	16	20	16	34	151
OG0000021	0	1	0	0	0	0	148	149
OG0000022	0	0	0	0	0	1	145	146
OG0000023	13	6	0	34	46	34	8	141
OG0000024	0	54	0	15	17	25	28	139
OG0000025	3	49	14	14	18	15	16	129
OG0000026	64	18	5	7	15	11	7	127
OG0000027	1	57	17	8	7	13	21	124
OG0000028	52	3	2	9	37	12	8	123
OG0000029	19	39	12	9	13	19	10	121
OG0000030	0	0	0	1	0	0	119	120
OG0000031	7	37	14	9	15	11	22	115
OG0000032	0	11	0	2	2	43	54	112
OG0000033	7	46	3	6	20	14	15	111
OG0000034	20	13	37	6	3	3	29	111
OG0000035	4	1	0	45	34	27	0	111
OG0000036	0	3	0	0	0	0	107	110
OG0000037	106	3	0	0	0	0	0	109
OG0000038	1	42	13	16	9	15	12	108
OG0000039	5	36	14	11	16	14	8	104
OG0000040	12	22	16	12	18	9	13	102
OG0000041	26	4	18	13	14	15	10	100
OG0000042	5	33	12	12	16	13	8	99
OG0000043	0	0	0	0	0	0	99	99
OG0000044	0	0	0	0	0	0	99	99
OG0000045	7	4	2	20	25	38	2	98
OG0000046	6	28	12	12	15	15	8	96
OG0000047	19	10	0	32	20	13	0	94
OG0000048	0	28	12	14	17	17	6	94
OG0000049	0	0	0	0	0	0	94	94
OG0000050	2	10	5	7	20	32	17	93
OG0000051	2	28	1	6	10	16	29	92
OG0000052	0	45	12	0	1	5	28	91
OG0000053	10	15	5	15	21	16	8	90
OG0000054	0	1	1	0	0	0	87	89
OG0000055	9	32	13	7	5	17	5	88
OG0000056	0	0	1	0	2	1	83	87
OG0000057	21	32	9	7	6	11	0	86
OG0000058	8	23	11	10	11	8	14	85
OG0000059	1	34	2	11	20	13	4	85
OG0000060	0	0	0	1	1	83	0	85
OG0000061	11	18	12	12	7	11	12	83
OG0000062	7	45	0	5	7	1	18	83
OG0000063	4	20	13	11	9	14	11	82
OG0000064	3	23	4	11	19	19	2	81
OG0000065	0	1	1	1	0	0	78	81
OG0000066	23	28	7	4	11	4	3	80
OG0000067	0	0	0	0	0	0	80	80
OG0000068	0	15	3	21	19	16	5	79
OG0000069	23	19	1	3	14	17	1	78
OG0000070	22	22	11	0	7	8	8	78
OG0000071	3	30	6	9	10	11	9	78
OG0000072	3	7	11	18	10	13	16	78
OG0000073	0	0	0	0	1	0	77	78
OG0000074	9	22	12	10	13	7	4	77
OG0000075	76	0	0	0	0	0	0	76
OG0000076	8	25	7	5	14	9	8	76
OG0000077	3	1	4	17	30	18	2	75
OG0000078	20	3	2	16	15	16	3	75
OG0000079	7	19	13	11	5	10	10	75
OG0000080	0	1	0	0	0	0	74	75
OG0000081	0	0	0	0	0	0	75	75
OG0000082	3	34	0	12	7	8	10	74
OG0000083	0	74	0	0	0	0	0	74
OG0000084	46	5	1	8	5	5	3	73
OG0000085	73	0	0	0	0	0	0	73
OG0000086	5	5	2	25	16	17	2	72
OG0000087	1	16	6	17	16	10	5	71
OG0000088	70	0	0	0	0	0	0	70
OG0000089	0	35	2	10	7	16	0	70
OG0000090	14	10	9	9	9	8	10	69
OG0000091	5	26	9	9	7	6	7	69
OG0000092	0	37	0	7	10	11	4	69
OG0000093	0	0	0	0	0	0	69	69
OG0000094	0	0	0	0	0	0	69	69
OG0000095	0	0	1	1	64	2	0	68
OG0000096	2	38	9	3	2	3	10	67
OG0000097	7	7	2	6	8	17	19	66
OG0000098	2	31	8	2	13	7	3	66
OG0000099	13	18	9	7	7	6	6	66
OG0000100	19	25	5	4	5	2	5	65
OG0000101	13	1	2	15	20	14	0	65
OG0000102	15	23	7	2	6	5	7	65
OG0000103	5	21	9	7	5	6	12	65
OG0000104	0	27	7	8	5	8	10	65
OG0000105	0	0	65	0	0	0	0	65
OG0000106	64	0	0	0	0	0	0	64
OG0000107	44	0	4	4	5	4	3	64
OG0000108	12	22	6	6	6	6	6	64
OG0000109	2	25	6	6	8	5	12	64
OG0000110	3	24	11	4	4	8	9	63
OG0000111	4	28	2	5	10	7	7	63
OG0000112	2	30	8	6	3	8	6	63
OG0000113	14	20	4	2	11	11	1	63
OG0000114	2	30	0	3	1	4	23	63
OG0000115	0	62	1	0	0	0	0	63
OG0000116	2	23	8	10	7	5	7	62
OG0000117	9	17	6	9	13	2	6	62
OG0000118	6	19	8	11	4	7	7	62
OG0000119	4	22	3	12	5	9	7	62
OG0000120	6	19	6	7	8	8	8	62
OG0000121	0	38	1	5	8	4	6	62
OG0000122	3	22	7	9	5	8	7	61
OG0000123	1	20	20	7	3	7	3	61
OG0000124	22	6	8	4	7	6	7	60
OG0000125	7	13	9	6	7	9	9	60
OG0000126	1	0	1	0	0	0	58	60
OG0000127	0	14	10	6	11	11	8	60
OG0000128	0	0	0	0	0	0	60	60
OG0000129	2	14	6	9	15	6	7	59
OG0000130	1	27	8	1	1	3	18	59
OG0000131	10	11	9	6	6	12	4	58
OG0000132	3	17	14	5	6	6	7	58
OG0000133	21	9	6	9	6	4	2	57
OG0000134	30	19	6	0	1	1	0	57
OG0000135	10	15	7	5	6	4	10	57
OG0000136	2	18	7	6	7	9	8	57
OG0000137	2	27	6	6	4	6	6	57
OG0000138	3	23	6	6	12	0	7	57
OG0000139	4	25	2	6	7	6	7	57
OG0000140	1	13	13	9	10	8	3	57
OG0000141	2	21	1	4	8	11	10	57
OG0000142	0	0	0	0	0	0	57	57
OG0000143	4	11	6	8	6	10	11	56
OG0000144	0	54	0	1	1	0	0	56
OG0000145	9	5	8	8	8	7	10	55
OG0000146	4	17	2	3	11	5	13	55
OG0000147	9	7	8	8	8	7	8	55
OG0000148	4	23	3	5	7	9	4	55
OG0000149	3	26	3	8	6	5	4	55
OG0000150	3	8	8	7	9	10	10	55
OG0000151	0	55	0	0	0	0	0	55
OG0000152	0	22	5	11	7	9	1	55
OG0000153	0	0	0	0	0	0	55	55
OG0000154	6	15	7	5	3	6	12	54
OG0000155	1	21	6	7	6	7	6	54
OG0000156	3	17	10	6	6	7	5	54
OG0000157	4	2	8	7	18	8	7	54
OG0000158	0	15	2	6	10	12	9	54
OG0000159	8	16	6	10	1	11	1	53
OG0000160	7	24	8	3	2	3	6	53
OG0000161	4	15	8	5	8	7	6	53
OG0000162	9	14	6	6	6	6	6	53
OG0000163	0	45	0	0	1	1	6	53
OG0000164	4	23	3	7	6	5	4	52
OG0000165	1	21	4	7	6	6	7	52
OG0000166	6	27	4	2	4	4	5	52
OG0000167	2	17	10	6	1	9	7	52
OG0000168	7	15	6	5	5	6	8	52
OG0000169	2	7	9	6	12	8	7	51
OG0000170	0	41	0	3	1	1	5	51
OG0000171	0	0	0	0	0	0	51	51
OG0000172	0	0	0	0	0	0	51	51
OG0000173	24	0	0	10	9	7	0	50
OG0000174	6	18	5	6	3	7	5	50
OG0000175	7	20	8	4	4	4	3	50
OG0000176	8	14	7	6	5	5	5	50
OG0000177	2	23	3	5	7	4	6	50
OG0000178	0	14	3	10	7	7	9	50
OG0000179	0	10	0	2	8	17	13	50
OG0000180	5	14	6	3	6	7	8	49
OG0000181	4	26	8	1	2	4	4	49
OG0000182	5	20	4	5	6	6	3	49
OG0000183	8	20	5	3	1	8	4	49
OG0000184	16	15	5	3	3	5	2	49
OG0000185	8	12	5	6	6	7	5	49
OG0000186	6	22	3	4	7	3	4	49
OG0000187	2	17	10	5	3	6	6	49
OG0000188	0	29	3	7	8	0	2	49
OG0000189	0	0	0	21	13	11	4	49
OG0000190	0	0	0	0	0	0	49	49
OG0000191	10	10	7	6	4	6	5	48
OG0000192	20	16	1	1	1	0	9	48
OG0000193	1	14	9	4	7	7	6	48
OG0000194	6	15	7	6	6	2	6	48
OG0000195	2	7	7	8	8	9	7	48
OG0000196	3	16	3	4	9	7	6	48
OG0000197	0	12	6	8	4	10	8	48
OG0000198	0	4	0	0	0	0	44	48
OG0000199	0	0	0	1	5	10	32	48
OG0000200	0	0	0	1	0	0	47	48
OG0000201	24	5	11	1	1	5	0	47
OG0000202	3	17	7	4	4	6	6	47
OG0000203	5	12	8	6	4	5	7	47
OG0000204	5	22	4	5	3	4	4	47
OG0000205	1	27	2	4	6	1	6	47
OG0000206	0	29	5	2	0	0	11	47
OG0000207	0	23	0	2	1	3	18	47
OG0000208	0	25	4	1	4	5	8	47
OG0000209	0	0	0	0	0	0	47	47
OG0000210	5	19	6	2	1	5	8	46
OG0000211	3	12	7	8	7	5	4	46
OG0000212	5	3	0	5	9	19	5	46
OG0000213	2	16	4	6	6	7	5	46
OG0000214	0	19	7	5	10	5	0	46
OG0000215	0	1	0	0	0	0	45	46
OG0000216	0	0	0	0	0	0	46	46
OG0000217	8	8	4	5	6	7	7	45
OG0000218	7	11	7	5	4	5	6	45
OG0000219	11	14	3	3	7	4	3	45
OG0000220	2	13	5	4	4	6	11	45
OG0000221	6	14	5	5	5	5	5	45
OG0000222	1	13	4	7	8	5	7	45
OG0000223	0	14	8	3	5	6	9	45
OG0000224	0	30	2	1	1	1	10	45
OG0000225	0	16	5	4	8	6	6	45
OG0000226	12	14	1	3	5	5	4	44
OG0000227	6	10	6	6	6	5	5	44
OG0000228	2	14	4	7	3	8	6	44
OG0000229	5	23	3	4	5	2	2	44
OG0000230	1	20	5	11	5	1	1	44
OG0000231	4	6	7	0	2	8	17	44
OG0000232	1	16	6	2	8	6	5	44
OG0000233	1	18	3	5	6	6	5	44
OG0000234	0	40	0	0	1	0	3	44
OG0000235	0	24	4	6	3	3	4	44
OG0000236	7	3	6	7	3	10	7	43
OG0000237	26	5	3	2	3	3	1	43
OG0000238	10	0	19	1	0	0	13	43
OG0000239	5	16	3	4	3	6	6	43
OG0000240	36	0	0	1	5	1	0	43
OG0000241	8	3	8	7	8	7	2	43
OG0000242	7	13	2	2	10	4	5	43
OG0000243	11	13	6	2	7	2	2	43
OG0000244	10	31	0	2	0	0	0	43
OG0000245	3	21	4	6	3	3	3	43
OG0000246	2	13	6	6	5	5	6	43
OG0000247	7	9	6	6	4	5	6	43
OG0000248	3	13	0	6	6	7	8	43
OG0000249	6	12	4	5	6	5	5	43
OG0000250	6	12	3	6	5	5	6	43
OG0000251	1	17	6	6	6	1	6	43
OG0000252	1	7	6	8	3	14	4	43
OG0000253	2	26	7	1	0	0	7	43
OG0000254	42	0	0	0	0	0	0	42
OG0000255	3	17	0	7	4	6	5	42
OG0000256	5	1	2	17	17	0	0	42
OG0000257	7	23	0	3	4	2	3	42
OG0000258	17	4	5	3	9	2	2	42
OG0000259	4	12	5	5	5	7	4	42
OG0000260	1	15	4	2	4	9	7	42
OG0000261	3	14	4	3	5	8	5	42
OG0000262	1	22	2	3	7	4	3	42
OG0000263	0	1	2	0	2	0	37	42
OG0000264	2	13	8	4	4	6	4	41
OG0000265	3	12	5	6	5	5	5	41
OG0000266	0	41	0	0	0	0	0	41
OG0000267	0	6	5	6	9	9	6	41
OG0000268	0	0	0	0	0	0	41	41
OG0000269	13	6	4	4	6	4	3	40
OG0000270	4	26	3	2	1	3	1	40
OG0000271	12	10	3	3	4	8	0	40
OG0000272	13	7	5	2	5	2	6	40
OG0000273	5	13	5	4	5	4	4	40
OG0000274	5	13	2	4	5	7	4	40
OG0000275	3	13	7	1	9	6	1	40
OG0000276	2	25	1	2	4	2	4	40
OG0000277	2	15	6	4	5	5	3	40
OG0000278	7	13	4	5	4	3	4	40
OG0000279	4	0	0	9	20	7	0	40
OG0000280	4	20	4	1	1	5	5	40
OG0000281	3	9	5	4	5	6	8	40
OG0000282	6	7	5	4	6	5	7	40
OG0000283	2	4	7	6	6	9	6	40
OG0000284	1	17	4	4	5	4	5	40
OG0000285	1	12	5	4	4	8	6	40
OG0000286	1	22	6	1	2	3	5	40
OG0000287	0	39	0	0	1	0	0	40
OG0000288	0	4	0	0	1	0	35	40
OG0000289	0	0	0	0	0	0	40	40
OG0000290	2	17	3	4	5	4	4	39
OG0000291	4	7	9	4	4	7	4	39
OG0000292	22	8	2	3	2	1	1	39
OG0000293	3	17	6	3	4	5	1	39
OG0000294	5	10	7	3	6	3	5	39
OG0000295	1	10	16	2	3	1	6	39
OG0000296	2	6	7	5	7	0	12	39
OG0000297	3	15	5	4	5	4	3	39
OG0000298	3	26	2	2	3	2	1	39
OG0000299	3	3	5	5	4	8	11	39
OG0000300	12	12	2	4	5	2	2	39
OG0000301	1	15	7	5	4	5	2	39
OG0000302	1	32	0	0	0	0	6	39
OG0000303	2	17	3	6	2	6	3	39
OG0000304	2	12	6	6	5	6	2	39
OG0000305	3	13	4	5	4	5	5	39
OG0000306	2	9	2	5	6	7	8	39
OG0000307	0	2	0	0	0	0	37	39
OG0000308	0	10	2	4	3	9	11	39
OG0000309	0	0	1	0	0	0	38	39
OG0000310	38	0	0	0	0	0	0	38
OG0000311	1	16	5	5	4	3	4	38
OG0000312	38	0	0	0	0	0	0	38
OG0000313	4	10	9	3	2	4	6	38
OG0000314	6	14	4	3	3	4	4	38
OG0000315	6	12	4	5	5	4	2	38
OG0000316	1	26	2	2	2	1	4	38
OG0000317	1	14	6	2	5	5	5	38
OG0000318	0	19	2	1	9	1	6	38
OG0000319	0	28	1	4	4	1	0	38
OG0000320	0	23	2	4	2	7	0	38
OG0000321	0	15	9	2	5	4	3	38
OG0000322	0	38	0	0	0	0	0	38
OG0000323	0	9	1	4	6	8	10	38
OG0000324	0	17	2	6	4	4	5	38
OG0000325	8	8	4	4	5	4	4	37
OG0000326	4	20	2	3	2	2	4	37
OG0000327	2	9	5	5	5	6	5	37
OG0000328	1	14	5	5	5	4	3	37
OG0000329	1	21	2	5	2	3	3	37
OG0000330	1	5	1	9	8	12	1	37
OG0000331	10	10	5	3	4	3	2	37
OG0000332	2	11	4	5	6	5	4	37
OG0000333	1	1	1	0	1	0	33	37
OG0000334	2	15	4	5	5	3	3	37
OG0000335	2	15	1	4	6	5	4	37
OG0000336	1	30	1	1	1	1	2	37
OG0000337	1	12	12	3	3	3	3	37
OG0000338	0	17	4	6	4	2	4	37
OG0000339	0	1	0	1	0	0	35	37
OG0000340	8	7	7	3	4	4	3	36
OG0000341	6	8	0	6	9	5	2	36
OG0000342	22	4	1	2	2	2	3	36
OG0000343	4	5	3	0	1	2	21	36
OG0000344	5	1	10	2	3	4	11	36
OG0000345	1	11	5	4	5	4	6	36
OG0000346	2	14	7	3	1	4	5	36
OG0000347	2	10	5	5	5	3	6	36
OG0000348	0	17	0	9	4	3	3	36
OG0000349	0	13	3	5	3	6	6	36
OG0000350	0	22	3	5	1	2	3	36
OG0000351	0	0	4	14	16	2	0	36
OG0000352	0	0	0	0	0	0	36	36
OG0000353	23	0	2	2	5	2	1	35
OG0000354	8	8	4	4	4	3	4	35
OG0000355	5	13	3	2	4	4	4	35
OG0000356	8	12	6	3	2	2	2	35
OG0000357	5	14	4	1	4	3	4	35
OG0000358	35	0	0	0	0	0	0	35
OG0000359	35	0	0	0	0	0	0	35
OG0000360	25	0	0	1	4	3	2	35
OG0000361	5	11	3	3	5	4	4	35
OG0000362	5	14	3	3	5	3	2	35
OG0000363	2	16	1	9	0	2	5	35
OG0000364	7	3	2	7	7	7	2	35
OG0000365	2	18	2	3	3	5	2	35
OG0000366	4	10	8	3	3	3	4	35
OG0000367	4	2	7	6	6	5	5	35
OG0000368	3	12	4	4	4	4	4	35
OG0000369	3	9	5	3	5	3	7	35
OG0000370	1	28	1	1	0	1	3	35
OG0000371	3	15	4	4	3	4	2	35
OG0000372	3	7	4	4	5	6	6	35
OG0000373	8	9	5	0	3	3	7	35
OG0000374	7	8	4	5	6	0	5	35
OG0000375	2	9	4	2	5	0	13	35
OG0000376	3	7	5	0	8	4	8	35
OG0000377	2	16	4	4	6	0	3	35
OG0000378	2	11	8	5	0	0	9	35
OG0000379	1	16	2	5	4	4	3	35
OG0000380	0	13	3	2	3	6	8	35
OG0000381	0	27	0	1	1	2	4	35
OG0000382	0	4	4	1	3	11	12	35
OG0000383	32	0	0	1	0	1	0	34
OG0000384	34	0	0	0	0	0	0	34
OG0000385	6	12	3	3	3	3	4	34
OG0000386	32	0	0	0	0	1	1	34
OG0000387	2	10	6	4	5	3	4	34
OG0000388	32	0	0	2	0	0	0	34
OG0000389	34	0	0	0	0	0	0	34
OG0000390	3	14	3	5	5	1	3	34
OG0000391	4	16	4	3	2	2	3	34
OG0000392	8	8	4	5	3	3	3	34
OG0000393	2	17	3	1	2	2	7	34
OG0000394	6	12	3	3	3	3	4	34
OG0000395	4	10	1	3	2	7	7	34
OG0000396	7	12	2	3	2	4	4	34
OG0000397	4	12	4	3	3	4	4	34
OG0000398	6	10	4	2	4	4	4	34
OG0000399	5	6	4	4	5	5	5	34
OG0000400	1	18	5	4	3	2	1	34
OG0000401	0	10	5	2	1	4	12	34
OG0000402	0	11	4	5	4	5	5	34
OG0000403	7	8	4	3	4	4	3	33
OG0000404	19	5	1	5	1	1	1	33
OG0000405	3	8	3	9	7	3	0	33
OG0000406	3	14	4	3	3	3	3	33
OG0000407	2	12	4	4	4	4	3	33
OG0000408	1	10	1	4	3	7	7	33
OG0000409	10	9	6	0	5	2	1	33
OG0000410	3	8	5	0	6	7	4	33
OG0000411	4	8	4	4	4	3	6	33
OG0000412	1	15	4	4	3	3	3	33
OG0000413	1	10	9	4	3	1	5	33
OG0000414	8	0	0	5	9	11	0	33
OG0000415	33	0	0	0	0	0	0	33
OG0000416	1	4	3	7	4	9	5	33
OG0000417	5	7	4	6	4	4	3	33
OG0000418	4	11	2	5	4	3	4	33
OG0000419	8	9	4	3	3	3	3	33
OG0000420	4	11	3	5	3	3	4	33
OG0000421	1	11	3	5	0	6	7	33
OG0000422	5	9	6	4	3	1	5	33
OG0000423	2	13	2	4	4	4	4	33
OG0000424	1	13	8	3	5	3	0	33
OG0000425	3	1	5	5	5	5	9	33
OG0000426	3	13	4	2	5	1	5	33
OG0000427	3	12	7	2	3	2	4	33
OG0000428	3	11	2	4	4	4	5	33
OG0000429	3	17	3	1	3	2	4	33
OG0000430	1	12	5	4	2	4	5	33
OG0000431	0	16	3	2	8	1	3	33
OG0000432	0	6	7	3	1	9	7	33
OG0000433	0	1	5	0	0	1	26	33
OG0000434	0	9	4	9	5	4	2	33
OG0000435	0	10	5	3	3	5	7	33
OG0000436	0	13	6	5	0	4	5	33
OG0000437	32	0	0	0	0	0	0	32
OG0000438	23	0	1	3	4	1	0	32
OG0000439	1	12	6	2	3	5	3	32
OG0000440	32	0	0	0	0	0	0	32
OG0000441	2	13	3	3	4	6	1	32
OG0000442	1	21	7	0	1	2	0	32
OG0000443	6	9	6	3	1	4	3	32
OG0000444	4	11	4	3	4	4	2	32
OG0000445	2	10	4	3	4	5	4	32
OG0000446	5	13	2	3	2	3	4	32
OG0000447	8	5	4	4	4	4	3	32
OG0000448	2	11	5	3	5	2	4	32
OG0000449	2	9	3	4	3	4	7	32
OG0000450	3	9	4	3	5	4	4	32
OG0000451	6	13	8	0	2	3	0	32
OG0000452	2	16	3	3	4	1	3	32
OG0000453	2	12	5	4	0	5	4	32
OG0000454	3	12	1	8	3	4	1	32
OG0000455	1	6	1	3	4	10	7	32
OG0000456	5	9	4	2	3	3	6	32
OG0000457	2	13	3	4	4	2	4	32
OG0000458	1	13	4	2	5	5	2	32
OG0000459	3	16	4	3	2	3	1	32
OG0000460	1	13	2	3	5	6	2	32
OG0000461	0	32	0	0	0	0	0	32
OG0000462	0	18	4	1	4	1	4	32
OG0000463	0	5	0	2	1	1	23	32
OG0000464	0	2	1	4	4	18	3	32
OG0000465	0	8	1	5	12	3	3	32
OG0000466	0	6	7	5	2	6	6	32
OG0000467	0	1	2	0	0	0	29	32
OG0000468	0	1	0	0	0	0	31	32
OG0000469	0	0	0	1	0	0	31	32
OG0000470	0	0	0	1	1	0	30	32
OG0000471	0	0	0	0	2	0	30	32
OG0000472	29	0	1	1	0	0	0	31
OG0000473	6	8	3	3	2	4	5	31
OG0000474	31	0	0	0	0	0	0	31
OG0000475	6	11	3	3	4	1	3	31
OG0000476	4	10	5	2	3	3	4	31
OG0000477	4	10	4	4	3	3	3	31
OG0000478	3	11	3	3	5	3	3	31
OG0000479	3	12	1	2	4	4	5	31
OG0000480	8	7	5	2	2	3	4	31
OG0000481	4	4	2	0	1	1	19	31
OG0000482	4	10	3	2	3	4	5	31
OG0000483	5	8	4	4	4	3	3	31
OG0000484	2	12	3	2	3	3	6	31
OG0000485	4	10	3	4	2	4	4	31
OG0000486	3	13	3	5	3	3	1	31
OG0000487	1	1	5	6	9	7	2	31
OG0000488	2	8	3	4	4	0	10	31
OG0000489	3	8	11	2	2	3	2	31
OG0000490	2	10	5	3	4	4	3	31
OG0000491	4	6	4	5	3	5	4	31
OG0000492	2	11	5	4	3	2	4	31
OG0000493	0	13	3	10	0	2	3	31
OG0000494	0	30	0	0	0	0	1	31
OG0000495	0	16	0	1	4	6	4	31
OG0000496	0	30	0	0	0	1	0	31
OG0000497	0	17	0	0	0	0	14	31
OG0000498	0	24	3	0	1	3	0	31
OG0000499	0	29	0	0	0	0	2	31
OG0000500	0	13	4	10	1	3	0	31
OG0000501	0	11	4	2	5	4	5	31
OG0000502	0	0	0	1	0	0	30	31
OG0000503	3	7	4	3	4	5	4	30
OG0000504	5	10	3	3	3	4	2	30
OG0000505	2	3	6	5	3	6	5	30
OG0000506	14	3	2	3	4	3	1	30
OG0000507	5	10	2	2	2	4	5	30
OG0000508	5	9	4	3	3	4	2	30
OG0000509	3	13	2	1	3	2	6	30
OG0000510	5	12	3	3	2	3	2	30
OG0000511	3	5	6	6	4	1	5	30
OG0000512	3	15	1	1	4	1	5	30
OG0000513	3	11	3	4	3	4	2	30
OG0000514	2	12	4	4	1	4	3	30
OG0000515	5	11	3	2	2	2	5	30
OG0000516	2	15	2	4	3	3	1	30
OG0000517	1	8	4	2	3	7	5	30
OG0000518	5	6	6	2	0	2	9	30
OG0000519	3	10	4	3	1	1	8	30
OG0000520	6	10	3	2	3	4	2	30
OG0000521	1	14	2	4	4	3	2	30
OG0000522	2	7	5	3	1	5	7	30
OG0000523	3	14	4	4	2	3	0	30
OG0000524	2	3	7	2	6	5	5	30
OG0000525	0	19	0	3	3	1	4	30
OG0000526	0	9	3	4	3	4	7	30
OG0000527	0	15	5	2	3	3	2	30
OG0000528	0	0	0	0	0	0	30	30
OG0000529	10	0	2	2	8	7	0	29
OG0000530	29	0	0	0	0	0	0	29
OG0000531	3	6	4	4	4	4	4	29
OG0000532	29	0	0	0	0	0	0	29
OG0000533	2	11	5	3	3	3	2	29
OG0000534	20	7	0	1	0	0	1	29
OG0000535	29	0	0	0	0	0	0	29
OG0000536	17	5	2	1	2	1	1	29
OG0000537	29	0	0	0	0	0	0	29
OG0000538	2	10	3	3	5	3	3	29
OG0000539	8	3	5	1	3	4	5	29
OG0000540	1	10	3	5	3	4	3	29
OG0000541	6	10	3	3	2	3	2	29
OG0000542	5	9	3	3	3	3	3	29
OG0000543	5	11	3	3	3	3	1	29
OG0000544	6	11	1	3	3	1	4	29
OG0000545	1	8	4	5	3	4	4	29
OG0000546	2	6	4	5	2	5	5	29
OG0000547	3	10	4	3	3	3	3	29
OG0000548	2	8	4	4	4	4	3	29
OG0000549	17	8	0	0	1	0	3	29
OG0000550	2	10	4	3	3	5	2	29
OG0000551	3	8	1	1	5	9	2	29
OG0000552	5	10	3	2	3	3	3	29
OG0000553	1	15	1	4	4	2	2	29
OG0000554	2	10	4	4	1	5	3	29
OG0000555	2	9	6	3	4	3	2	29
OG0000556	2	7	6	3	3	4	4	29
OG0000557	2	7	5	4	3	4	4	29
OG0000558	4	9	4	4	0	3	5	29
OG0000559	2	11	4	2	3	4	3	29
OG0000560	3	9	3	3	4	3	4	29
OG0000561	2	10	1	2	6	5	3	29
OG0000562	1	16	0	0	0	0	12	29
OG0000563	2	13	3	5	4	0	2	29
OG0000564	2	12	4	2	5	2	2	29
OG0000565	1	16	2	1	2	2	5	29
OG0000566	1	13	3	3	3	4	2	29
OG0000567	1	13	6	2	2	2	3	29
OG0000568	0	14	1	5	4	3	2	29
OG0000569	0	14	0	0	2	1	12	29
OG0000570	0	11	5	4	3	3	3	29
OG0000571	0	17	1	1	2	3	5	29
OG0000572	0	13	1	5	3	3	4	29
OG0000573	0	11	3	5	4	3	3	29
OG0000574	0	15	1	5	1	3	4	29
OG0000575	0	10	0	2	5	3	9	29
OG0000576	0	1	5	3	9	8	3	29
OG0000577	0	1	0	0	0	0	28	29
OG0000578	7	8	3	3	3	3	1	28
OG0000579	2	9	5	3	5	0	4	28
OG0000580	13	7	2	1	1	1	3	28
OG0000581	6	10	3	1	3	3	2	28
OG0000582	1	10	4	4	2	3	4	28
OG0000583	1	11	3	4	4	3	2	28
OG0000584	3	13	4	0	5	1	2	28
OG0000585	4	10	2	4	0	4	4	28
OG0000586	3	6	4	3	4	4	4	28
OG0000587	6	6	2	3	1	3	7	28
OG0000588	1	11	2	1	3	7	3	28
OG0000589	2	12	2	2	2	3	5	28
OG0000590	8	3	4	4	3	3	3	28
OG0000591	5	6	2	3	1	4	7	28
OG0000592	10	2	2	3	3	5	3	28
OG0000593	2	10	4	3	3	3	3	28
OG0000594	6	7	3	3	3	3	3	28
OG0000595	7	6	3	1	3	4	4	28
OG0000596	2	4	1	2	4	7	8	28
OG0000597	4	10	2	3	3	3	3	28
OG0000598	4	9	4	3	2	3	3	28
OG0000599	2	10	3	2	1	6	4	28
OG0000600	2	12	2	4	3	2	3	28
OG0000601	3	10	4	2	3	3	3	28
OG0000602	1	9	4	2	4	3	5	28
OG0000603	1	8	3	4	4	5	3	28
OG0000604	3	11	6	1	2	1	4	28
OG0000605	3	12	3	3	3	3	1	28
OG0000606	1	9	3	3	4	4	4	28
OG0000607	0	26	0	0	0	1	1	28
OG0000608	0	17	3	1	0	0	7	28
OG0000609	0	13	2	3	3	3	4	28
OG0000610	0	14	4	2	1	2	5	28
OG0000611	0	14	2	3	4	3	2	28
OG0000612	0	1	0	0	0	0	27	28
OG0000613	0	0	0	0	0	0	28	28
OG0000614	0	0	0	0	0	0	28	28
OG0000615	0	0	0	0	0	0	28	28
OG0000616	0	0	0	0	0	0	28	28
OG0000617	7	6	2	3	4	3	2	27
OG0000618	27	0	0	0	0	0	0	27
OG0000619	6	8	3	1	3	3	3	27
OG0000620	27	0	0	0	0	0	0	27
OG0000621	2	13	2	2	4	1	3	27
OG0000622	9	6	3	3	2	2	2	27
OG0000623	2	15	3	2	3	1	1	27
OG0000624	10	12	1	0	0	1	3	27
OG0000625	26	0	0	0	1	0	0	27
OG0000626	1	13	3	4	2	0	4	27
OG0000627	4	6	2	4	7	3	1	27
OG0000628	8	8	3	3	2	2	1	27
OG0000629	25	2	0	0	0	0	0	27
OG0000630	3	9	2	3	3	3	4	27
OG0000631	8	5	2	2	3	4	3	27
OG0000632	4	7	3	3	3	3	4	27
OG0000633	5	9	3	3	1	3	3	27
OG0000634	2	10	4	3	0	4	4	27
OG0000635	1	9	2	4	2	6	3	27
OG0000636	7	6	2	3	3	3	3	27
OG0000637	3	8	4	4	4	0	4	27
OG0000638	7	7	3	3	2	2	3	27
OG0000639	6	7	4	3	3	3	1	27
OG0000640	1	12	2	4	2	3	3	27
OG0000641	4	9	5	3	2	3	1	27
OG0000642	1	7	5	3	5	3	3	27
OG0000643	3	6	4	2	6	3	3	27
OG0000644	4	8	3	5	3	2	2	27
OG0000645	2	9	3	2	3	4	4	27
OG0000646	5	6	4	3	3	3	3	27
OG0000647	1	9	6	0	4	4	3	27
OG0000648	2	11	2	2	3	3	4	27
OG0000649	2	10	2	1	3	3	6	27
OG0000650	3	6	3	3	4	4	4	27
OG0000651	2	8	3	4	3	4	3	27
OG0000652	2	11	1	6	3	1	3	27
OG0000653	3	6	4	4	4	3	3	27
OG0000654	6	10	2	2	2	2	3	27
OG0000655	1	9	3	4	0	4	6	27
OG0000656	2	13	0	0	2	2	8	27
OG0000657	1	11	3	1	5	3	3	27
OG0000658	1	13	1	3	5	3	1	27
OG0000659	1	11	3	3	5	2	2	27
OG0000660	0	5	0	11	2	4	5	27
OG0000661	0	26	0	0	1	0	0	27
OG0000662	0	6	4	2	5	4	6	27
OG0000663	0	20	0	3	4	0	0	27
OG0000664	0	27	0	0	0	0	0	27
OG0000665	0	27	0	0	0	0	0	27
OG0000666	0	27	0	0	0	0	0	27
OG0000667	0	18	0	0	1	2	6	27
OG0000668	0	8	3	3	3	7	3	27
OG0000669	0	23	0	2	2	0	0	27
OG0000670	0	25	0	0	0	0	2	27
OG0000671	0	8	4	4	2	6	3	27
OG0000672	0	26	0	0	0	0	1	27
OG0000673	2	9	3	3	4	3	2	26
OG0000674	17	3	5	0	0	0	1	26
OG0000675	8	8	3	2	2	2	1	26
OG0000676	24	0	1	0	1	0	0	26
OG0000677	2	2	6	3	3	3	7	26
OG0000678	5	6	3	3	3	3	3	26
OG0000679	3	8	4	3	2	1	5	26
OG0000680	7	6	3	2	1	3	4	26
OG0000681	1	12	3	2	3	3	2	26
OG0000682	5	6	3	3	3	3	3	26
OG0000683	5	7	3	2	3	3	3	26
OG0000684	5	6	4	3	3	2	3	26
OG0000685	2	6	6	3	4	1	4	26
OG0000686	3	10	2	3	3	3	2	26
OG0000687	3	7	4	4	2	3	3	26
OG0000688	6	6	3	2	2	4	3	26
OG0000689	4	8	3	3	2	3	3	26
OG0000690	5	9	3	3	3	1	2	26
OG0000691	5	9	1	3	5	3	0	26
OG0000692	2	7	11	1	2	2	1	26
OG0000693	3	11	1	1	6	2	2	26
OG0000694	1	10	1	3	6	4	1	26
OG0000695	3	11	2	3	3	2	2	26
OG0000696	3	9	3	3	3	3	2	26
OG0000697	1	16	9	0	0	0	0	26
OG0000698	2	10	3	3	3	3	2	26
OG0000699	1	10	3	0	4	4	4	26
OG0000700	4	3	3	4	4	4	4	26
OG0000701	2	12	8	1	1	1	1	26
OG0000702	3	8	3	3	3	3	3	26
OG0000703	2	11	2	3	3	2	3	26
OG0000704	2	9	3	2	4	3	3	26
OG0000705	1	11	3	3	2	3	3	26
OG0000706	1	9	3	1	5	5	2	26
OG0000707	1	10	1	2	2	0	10	26
OG0000708	0	25	0	0	0	0	1	26
OG0000709	0	24	0	1	0	0	1	26
OG0000710	0	11	3	2	4	2	4	26
OG0000711	0	25	0	0	0	0	1	26
OG0000712	0	6	6	4	4	3	3	26
OG0000713	0	26	0	0	0	0	0	26
OG0000714	0	12	6	2	2	3	1	26
OG0000715	0	16	0	3	4	1	2	26
OG0000716	0	8	3	2	3	5	5	26
OG0000717	0	12	1	5	4	2	2	26
OG0000718	0	7	4	3	4	4	4	26
OG0000719	0	0	0	3	0	23	0	26
OG0000720	0	0	0	0	0	1	25	26
OG0000721	4	5	3	3	3	3	4	25
OG0000722	2	8	3	5	1	4	2	25
OG0000723	25	0	0	0	0	0	0	25
OG0000724	11	0	2	7	3	1	1	25
OG0000725	6	11	4	1	1	1	1	25
OG0000726	2	12	3	0	2	2	4	25
OG0000727	4	3	3	5	3	4	3	25
OG0000728	24	1	0	0	0	0	0	25
OG0000729	2	7	2	2	3	4	5	25
OG0000730	4	10	0	0	3	3	5	25
OG0000731	1	9	1	3	3	3	5	25
OG0000732	5	10	3	2	2	3	0	25
OG0000733	6	8	2	2	2	2	3	25
OG0000734	6	6	3	2	3	2	3	25
OG0000735	5	13	4	0	0	1	2	25
OG0000736	5	5	3	3	2	3	4	25
OG0000737	3	2	5	2	5	5	3	25
OG0000738	1	8	4	3	3	3	3	25
OG0000739	5	4	3	3	3	4	3	25
OG0000740	6	5	3	3	3	2	3	25
OG0000741	5	7	3	1	2	4	3	25
OG0000742	7	10	1	3	2	0	2	25
OG0000743	3	9	3	2	2	3	3	25
OG0000744	2	11	3	3	2	2	2	25
OG0000745	2	7	4	5	3	0	4	25
OG0000746	2	8	2	3	3	4	3	25
OG0000747	2	12	2	2	3	2	2	25
OG0000748	5	12	1	3	2	1	1	25
OG0000749	1	5	4	4	3	4	4	25
OG0000750	2	11	4	3	3	1	1	25
OG0000751	2	8	2	3	3	3	4	25
OG0000752	1	13	2	3	3	3	0	25
OG0000753	1	9	4	3	4	1	3	25
OG0000754	1	10	2	2	4	3	3	25
OG0000755	1	15	0	2	5	2	0	25
OG0000756	1	10	2	2	4	3	3	25
OG0000757	1	10	3	4	1	3	3	25
OG0000758	1	13	3	1	2	2	3	25
OG0000759	0	18	0	3	3	1	0	25
OG0000760	0	9	1	2	4	5	4	25
OG0000761	0	14	1	3	5	2	0	25
OG0000762	0	24	0	0	1	0	0	25
OG0000763	0	15	0	0	2	2	6	25
OG0000764	0	15	1	1	0	1	7	25
OG0000765	0	6	8	3	2	5	1	25
OG0000766	0	7	8	4	3	2	1	25
OG0000767	0	11	3	5	2	2	2	25
OG0000768	0	10	3	0	3	4	5	25
OG0000769	0	1	0	0	0	0	24	25
OG0000770	0	0	8	3	2	3	9	25
OG0000771	0	0	1	12	5	7	0	25
OG0000772	0	0	0	0	0	0	25	25
OG0000773	23	0	0	0	0	0	1	24
OG0000774	19	0	1	2	2	0	0	24
OG0000775	24	0	0	0	0	0	0	24
OG0000776	4	7	3	3	2	3	2	24
OG0000777	24	0	0	0	0	0	0	24
OG0000778	2	5	2	2	3	0	10	24
OG0000779	4	5	3	3	3	3	3	24
OG0000780	4	5	3	4	3	2	3	24
OG0000781	4	9	3	2	0	2	4	24
OG0000782	24	0	0	0	0	0	0	24
OG0000783	3	8	2	2	2	3	4	24
OG0000784	2	8	2	3	2	4	3	24
OG0000785	5	13	1	0	0	1	4	24
OG0000786	7	6	3	2	1	2	3	24
OG0000787	1	8	6	3	2	2	2	24
OG0000788	3	15	0	2	2	2	0	24
OG0000789	24	0	0	0	0	0	0	24
OG0000790	5	5	3	2	0	5	4	24
OG0000791	3	6	4	3	3	3	2	24
OG0000792	2	3	4	3	4	5	3	24
OG0000793	4	3	3	5	2	5	2	24
OG0000794	2	6	2	2	6	4	2	24
OG0000795	4	5	3	3	2	4	3	24
OG0000796	2	8	0	4	2	3	5	24
OG0000797	2	10	5	0	3	2	2	24
OG0000798	4	6	4	4	1	1	4	24
OG0000799	2	7	2	4	3	2	4	24
OG0000800	7	9	2	2	1	1	2	24
OG0000801	3	8	3	3	4	1	2	24
OG0000802	2	12	3	3	0	2	2	24
OG0000803	4	8	2	2	3	2	3	24
OG0000804	4	8	2	3	2	0	5	24
OG0000805	3	6	3	2	7	2	1	24
OG0000806	5	9	2	2	2	2	2	24
OG0000807	4	6	3	2	3	3	3	24
OG0000808	4	9	2	1	3	3	2	24
OG0000809	2	6	3	2	3	4	4	24
OG0000810	3	7	2	3	3	3	3	24
OG0000811	4	5	2	3	2	4	4	24
OG0000812	5	3	5	2	3	1	5	24
OG0000813	1	7	4	2	5	2	3	24
OG0000814	1	9	3	2	3	3	3	24
OG0000815	1	7	2	2	3	5	4	24
OG0000816	3	7	1	3	2	4	4	24
OG0000817	4	5	3	3	3	3	3	24
OG0000818	1	5	2	3	3	4	6	24
OG0000819	2	5	3	2	1	5	6	24
OG0000820	2	7	3	3	3	3	3	24
OG0000821	1	6	6	2	2	4	3	24
OG0000822	3	6	3	2	3	3	4	24
OG0000823	3	6	3	3	3	3	3	24
OG0000824	1	9	2	2	3	3	4	24
OG0000825	2	11	2	2	0	2	5	24
OG0000826	2	5	4	4	3	3	3	24
OG0000827	3	6	2	4	1	4	4	24
OG0000828	1	8	3	3	4	3	2	24
OG0000829	2	10	2	3	3	2	2	24
OG0000830	1	7	3	1	2	3	7	24
OG0000831	0	21	0	1	1	1	0	24
OG0000832	0	7	2	4	3	4	4	24
OG0000833	0	7	2	6	3	3	3	24
OG0000834	0	22	1	0	1	0	0	24
OG0000835	0	20	2	0	0	1	1	24
OG0000836	0	5	5	4	2	4	4	24
OG0000837	0	14	0	1	1	1	7	24
OG0000838	0	9	2	4	1	4	4	24
OG0000839	0	18	0	2	3	1	0	24
OG0000840	0	11	3	2	2	4	2	24
OG0000841	0	15	0	3	4	1	1	24
OG0000842	0	1	3	0	1	0	19	24
OG0000843	0	21	0	1	1	1	0	24
OG0000844	0	13	0	2	0	1	8	24
OG0000845	0	12	2	3	2	2	3	24
OG0000846	0	16	1	1	0	2	4	24
OG0000847	0	1	1	0	1	1	20	24
OG0000848	0	5	4	4	6	3	2	24
OG0000849	0	0	0	0	0	0	24	24
OG0000850	23	0	0	0	0	0	0	23
OG0000851	4	6	10	0	1	1	1	23
OG0000852	8	6	2	1	4	1	1	23
OG0000853	9	5	2	2	2	2	1	23
OG0000854	5	5	3	4	3	1	2	23
OG0000855	7	1	2	3	1	1	8	23
OG0000856	13	0	1	0	3	2	4	23
OG0000857	4	6	3	1	3	3	3	23
OG0000858	23	0	0	0	0	0	0	23
OG0000859	4	9	3	1	1	2	3	23
OG0000860	7	7	1	2	3	2	1	23
OG0000861	4	5	3	3	2	3	3	23
OG0000862	6	7	4	1	1	1	3	23
OG0000863	3	9	4	2	2	1	2	23
OG0000864	2	9	3	4	2	2	1	23
OG0000865	2	10	2	3	2	3	1	23
OG0000866	4	0	2	3	5	4	5	23
OG0000867	3	7	5	2	2	0	4	23
OG0000868	5	8	2	2	2	2	2	23
OG0000869	5	7	3	3	1	1	3	23
OG0000870	4	7	2	2	2	3	3	23
OG0000871	2	5	3	3	2	4	4	23
OG0000872	4	9	1	3	1	3	2	23
OG0000873	2	5	3	3	3	3	4	23
OG0000874	2	7	2	2	3	3	4	23
OG0000875	3	6	3	3	3	3	2	23
OG0000876	12	2	0	2	6	1	0	23
OG0000877	2	11	3	3	1	2	1	23
OG0000878	3	6	2	1	3	5	3	23
OG0000879	3	9	3	3	0	2	3	23
OG0000880	5	8	2	2	2	2	2	23
OG0000881	4	5	3	3	3	3	2	23
OG0000882	3	6	2	3	3	2	4	23
OG0000883	3	5	2	3	3	4	3	23
OG0000884	3	5	3	3	3	3	3	23
OG0000885	2	7	1	2	2	2	7	23
OG0000886	2	7	3	3	2	3	3	23
OG0000887	2	10	1	2	3	3	2	23
OG0000888	1	6	2	4	1	4	5	23
OG0000889	2	7	3	3	2	3	3	23
OG0000890	1	12	0	3	3	2	2	23
OG0000891	1	12	1	3	2	2	2	23
OG0000892	0	23	0	0	0	0	0	23
OG0000893	0	20	1	0	0	1	1	23
OG0000894	0	19	0	1	0	0	3	23
OG0000895	0	11	0	0	1	4	7	23
OG0000896	0	5	4	2	1	2	9	23
OG0000897	0	12	1	3	5	0	2	23
OG0000898	0	15	2	0	1	2	3	23
OG0000899	0	1	5	0	1	0	16	23
OG0000900	0	14	1	2	2	1	3	23
OG0000901	0	12	1	1	4	2	3	23
OG0000902	0	6	3	6	2	3	3	23
OG0000903	0	10	3	2	2	5	1	23
OG0000904	0	8	1	3	2	4	5	23
OG0000905	0	2	1	7	6	5	2	23
OG0000906	0	2	11	0	0	2	8	23
OG0000907	0	0	1	0	0	0	22	23
OG0000908	0	0	0	0	6	17	0	23
OG0000909	2	3	2	3	4	4	4	22
OG0000910	11	4	3	1	2	0	1	22
OG0000911	4	4	2	3	4	3	2	22
OG0000912	22	0	0	0	0	0	0	22
OG0000913	2	10	4	2	2	1	1	22
OG0000914	5	7	2	2	2	2	2	22
OG0000915	5	0	4	3	1	0	9	22
OG0000916	2	8	3	1	3	2	3	22
OG0000917	22	0	0	0	0	0	0	22
OG0000918	3	5	4	2	2	4	2	22
OG0000919	3	9	2	2	2	2	2	22
OG0000920	11	5	3	1	1	1	0	22
OG0000921	4	8	2	1	3	2	2	22
OG0000922	2	10	2	3	2	1	2	22
OG0000923	5	0	4	3	3	4	3	22
OG0000924	3	7	2	3	2	2	3	22
OG0000925	7	4	2	2	3	2	2	22
OG0000926	3	7	2	2	3	2	3	22
OG0000927	3	6	3	3	3	2	2	22
OG0000928	4	6	2	3	2	3	2	22
OG0000929	6	5	2	2	2	2	3	22
OG0000930	5	7	2	2	2	2	2	22
OG0000931	2	9	2	2	2	2	3	22
OG0000932	9	3	3	1	3	2	1	22
OG0000933	2	6	3	2	2	5	2	22
OG0000934	4	5	5	0	1	0	7	22
OG0000935	1	10	0	1	3	1	6	22
OG0000936	17	0	1	2	2	0	0	22
OG0000937	8	5	2	2	2	2	1	22
OG0000938	5	5	2	2	2	3	3	22
OG0000939	7	4	3	1	2	3	2	22
OG0000940	4	3	5	2	3	1	4	22
OG0000941	3	9	2	2	2	3	1	22
OG0000942	6	1	4	1	1	1	8	22
OG0000943	2	11	1	2	2	2	2	22
OG0000944	3	3	3	2	3	3	5	22
OG0000945	1	13	1	2	0	4	1	22
OG0000946	2	7	1	1	0	1	10	22
OG0000947	2	6	2	3	3	3	3	22
OG0000948	4	6	3	3	2	3	1	22
OG0000949	4	6	4	2	2	2	2	22
OG0000950	2	6	3	3	2	3	3	22
OG0000951	4	7	1	2	2	3	3	22
OG0000952	4	7	2	2	3	2	2	22
OG0000953	3	8	2	2	2	3	2	22
OG0000954	3	4	3	3	2	3	4	22
OG0000955	2	11	2	1	0	1	5	22
OG0000956	1	9	2	3	2	2	3	22
OG0000957	3	6	2	2	3	3	3	22
OG0000958	4	8	3	2	1	2	2	22
OG0000959	1	8	3	2	2	3	3	22
OG0000960	3	6	3	2	2	2	4	22
OG0000961	2	5	3	3	3	3	3	22
OG0000962	3	8	1	2	4	2	2	22
OG0000963	2	13	5	1	0	1	0	22
OG0000964	3	7	2	1	3	1	5	22
OG0000965	3	8	2	3	2	2	2	22
OG0000966	1	9	1	3	2	4	2	22
OG0000967	1	9	3	2	2	3	2	22
OG0000968	1	6	2	1	2	4	6	22
OG0000969	4	6	2	2	2	3	3	22
OG0000970	2	4	4	2	5	3	2	22
OG0000971	2	10	2	2	2	2	2	22
OG0000972	1	8	1	2	4	3	3	22
OG0000973	1	6	3	2	3	4	3	22
OG0000974	0	8	1	5	6	0	2	22
OG0000975	0	7	2	3	2	4	4	22
OG0000976	0	15	2	2	1	2	0	22
OG0000977	0	10	1	6	1	2	2	22
OG0000978	0	7	2	2	2	5	4	22
OG0000979	0	22	0	0	0	0	0	22
OG0000980	0	9	0	4	5	3	1	22
OG0000981	0	14	1	3	1	2	1	22
OG0000982	0	22	0	0	0	0	0	22
OG0000983	0	12	1	5	2	2	0	22
OG0000984	0	8	3	2	1	3	5	22
OG0000985	0	0	5	0	1	16	0	22
OG0000986	0	0	0	0	0	0	22	22
OG0000987	4	6	3	2	2	2	2	21
OG0000988	1	10	2	2	2	3	1	21
OG0000989	5	5	3	2	2	2	2	21
OG0000990	4	7	2	2	2	2	2	21
OG0000991	4	8	2	1	2	2	2	21
OG0000992	4	6	3	2	2	2	2	21
OG0000993	10	6	1	1	0	0	3	21
OG0000994	2	8	2	2	2	1	4	21
OG0000995	5	4	3	3	2	1	3	21
OG0000996	5	6	2	2	2	2	2	21
OG0000997	3	8	3	1	1	2	3	21
OG0000998	4	7	2	3	2	1	2	21
OG0000999	21	0	0	0	0	0	0	21
OG0001000	6	5	2	2	2	2	2	21
OG0001001	4	6	2	3	2	2	2	21
OG0001002	2	8	1	3	3	1	3	21
OG0001003	5	4	3	3	2	3	1	21
OG0001004	7	4	2	2	2	2	2	21
OG0001005	4	7	3	1	2	2	2	21
OG0001006	13	4	1	1	0	1	1	21
OG0001007	5	3	4	2	2	3	2	21
OG0001008	21	0	0	0	0	0	0	21
OG0001009	3	8	2	2	2	2	2	21
OG0001010	21	0	0	0	0	0	0	21
OG0001011	1	8	3	1	2	2	4	21
OG0001012	4	7	2	2	2	1	3	21
OG0001013	4	7	2	2	2	2	2	21
OG0001014	4	7	2	2	2	2	2	21
OG0001015	1	10	2	2	2	2	2	21
OG0001016	4	6	3	3	0	3	2	21
OG0001017	2	14	0	1	0	0	4	21
OG0001018	5	7	0	3	3	1	2	21
OG0001019	4	7	2	2	2	2	2	21
OG0001020	7	0	3	1	4	6	0	21
OG0001021	10	4	0	3	2	1	1	21
OG0001022	6	5	5	0	0	1	4	21
OG0001023	5	7	1	2	3	2	1	21
OG0001024	1	4	4	2	4	3	3	21
OG0001025	6	5	4	2	1	2	1	21
OG0001026	3	4	2	2	3	4	3	21
OG0001027	4	1	3	5	3	4	1	21
OG0001028	4	8	2	2	2	2	1	21
OG0001029	4	8	2	2	2	1	2	21
OG0001030	4	7	2	2	2	2	2	21
OG0001031	2	9	1	2	1	3	3	21
OG0001032	5	11	0	2	1	0	2	21
OG0001033	3	7	3	2	2	2	2	21
OG0001034	4	7	2	2	2	2	2	21
OG0001035	5	6	2	2	2	2	2	21
OG0001036	2	11	1	3	2	1	1	21
OG0001037	3	5	4	2	2	2	3	21
OG0001038	4	6	2	2	1	1	5	21
OG0001039	4	8	1	2	2	2	2	21
OG0001040	2	5	2	2	3	3	4	21
OG0001041	2	4	1	2	5	4	3	21
OG0001042	5	6	2	2	2	2	2	21
OG0001043	3	7	2	2	2	3	2	21
OG0001044	2	9	2	0	4	2	2	21
OG0001045	2	7	2	3	1	2	4	21
OG0001046	7	0	2	3	3	3	3	21
OG0001047	4	7	2	2	2	2	2	21
OG0001048	2	10	4	1	0	2	2	21
OG0001049	3	7	3	2	2	2	2	21
OG0001050	2	9	2	2	2	2	2	21
OG0001051	2	10	2	3	1	1	2	21
OG0001052	5	6	2	2	2	1	3	21
OG0001053	6	6	2	2	2	1	2	21
OG0001054	5	6	2	2	2	2	2	21
OG0001055	3	8	2	2	2	2	2	21
OG0001056	2	7	2	2	2	3	3	21
OG0001057	3	3	2	3	2	4	4	21
OG0001058	2	7	2	3	3	2	2	21
OG0001059	4	7	2	2	2	2	2	21
OG0001060	2	7	4	3	4	0	1	21
OG0001061	2	6	3	2	2	4	2	21
OG0001062	5	6	2	2	2	2	2	21
OG0001063	2	10	3	3	1	0	2	21
OG0001064	3	8	2	2	2	2	2	21
OG0001065	5	6	2	2	2	2	2	21
OG0001066	1	5	2	4	2	4	3	21
OG0001067	1	9	2	3	2	2	2	21
OG0001068	2	1	3	3	3	4	5	21
OG0001069	3	2	7	1	3	1	4	21
OG0001070	1	9	1	2	0	3	5	21
OG0001071	2	9	2	4	2	2	0	21
OG0001072	1	5	2	4	2	3	4	21
OG0001073	2	6	4	1	1	0	7	21
OG0001074	2	6	2	3	3	3	2	21
OG0001075	2	8	2	2	2	2	3	21
OG0001076	1	8	1	1	5	2	3	21
OG0001077	1	10	3	2	3	1	1	21
OG0001078	2	9	2	2	1	2	3	21
OG0001079	0	20	0	0	0	0	1	21
OG0001080	0	10	1	2	2	3	3	21
OG0001081	0	21	0	0	0	0	0	21
OG0001082	0	13	0	4	2	2	0	21
OG0001083	0	21	0	0	0	0	0	21
OG0001084	0	20	0	0	0	0	1	21
OG0001085	0	20	0	1	0	0	0	21
OG0001086	0	16	0	2	3	0	0	21
OG0001087	0	10	2	0	1	0	8	21
OG0001088	0	17	1	2	0	0	1	21
OG0001089	0	11	3	1	3	1	2	21
OG0001090	0	14	2	1	0	2	2	21
OG0001091	0	13	0	3	1	2	2	21
OG0001092	0	9	4	2	3	2	1	21
OG0001093	0	2	0	0	1	0	18	21
OG0001094	0	0	1	0	0	0	20	21
OG0001095	0	0	1	0	0	0	20	21
OG0001096	0	0	0	0	1	0	20	21
OG0001097	4	7	2	2	2	2	1	20
OG0001098	2	8	1	2	2	1	4	20
OG0001099	4	7	2	2	2	2	1	20
OG0001100	18	1	0	0	0	0	1	20
OG0001101	20	0	0	0	0	0	0	20
OG0001102	4	5	2	2	2	2	3	20
OG0001103	18	0	1	0	1	0	0	20
OG0001104	3	6	3	2	1	3	2	20
OG0001105	1	4	1	3	3	4	4	20
OG0001106	2	4	3	3	3	3	2	20
OG0001107	1	4	3	2	2	4	4	20
OG0001108	4	5	2	2	2	3	2	20
OG0001109	3	7	2	2	2	2	2	20
OG0001110	3	5	1	3	3	1	4	20
OG0001111	3	6	1	2	6	1	1	20
OG0001112	4	6	2	2	2	2	2	20
OG0001113	4	6	2	2	2	2	2	20
OG0001114	6	4	3	2	1	1	3	20
OG0001115	5	6	2	1	2	2	2	20
OG0001116	4	7	1	2	2	2	2	20
OG0001117	3	4	3	3	2	3	2	20
OG0001118	6	6	1	2	2	1	2	20
OG0001119	4	6	2	2	2	2	2	20
OG0001120	3	5	2	2	2	3	3	20
OG0001121	2	6	2	4	2	2	2	20
OG0001122	3	5	3	2	2	2	3	20
OG0001123	4	4	2	2	3	3	2	20
OG0001124	1	8	2	2	2	3	2	20
OG0001125	2	5	3	3	2	2	3	20
OG0001126	1	6	4	1	0	1	7	20
OG0001127	2	6	2	2	2	4	2	20
OG0001128	2	8	3	2	3	1	1	20
OG0001129	4	5	3	2	2	3	1	20
OG0001130	3	1	3	3	3	3	4	20
OG0001131	3	0	3	3	3	4	4	20
OG0001132	2	6	3	2	3	2	2	20
OG0001133	2	0	10	1	3	1	3	20
OG0001134	4	7	2	2	2	2	1	20
OG0001135	2	6	2	2	3	1	4	20
OG0001136	2	8	2	2	2	2	2	20
OG0001137	3	7	2	2	2	2	2	20
OG0001138	5	4	3	2	2	2	2	20
OG0001139	1	8	2	2	3	2	2	20
OG0001140	5	4	3	2	2	2	2	20
OG0001141	3	3	3	3	1	3	4	20
OG0001142	5	5	2	2	2	2	2	20
OG0001143	4	6	2	2	2	2	2	20
OG0001144	2	4	2	2	4	4	2	20
OG0001145	3	7	2	2	2	2	2	20
OG0001146	2	8	2	2	3	2	1	20
OG0001147	6	4	5	1	3	1	0	20
OG0001148	4	6	2	2	2	2	2	20
OG0001149	3	7	2	2	3	2	1	20
OG0001150	2	8	2	2	2	0	4	20
OG0001151	4	5	2	2	2	1	4	20
OG0001152	5	5	2	2	2	2	2	20
OG0001153	5	5	2	2	2	2	2	20
OG0001154	4	6	3	1	3	1	2	20
OG0001155	3	7	2	1	2	1	4	20
OG0001156	4	4	2	2	2	2	4	20
OG0001157	3	8	1	2	2	2	2	20
OG0001158	3	5	2	3	2	2	3	20
OG0001159	2	7	2	1	5	2	1	20
OG0001160	3	5	3	2	2	2	3	20
OG0001161	4	7	2	2	1	2	2	20
OG0001162	1	10	3	2	1	2	1	20
OG0001163	4	0	3	3	2	4	4	20
OG0001164	1	5	2	3	3	3	3	20
OG0001165	1	8	0	1	3	2	5	20
OG0001166	4	5	3	2	2	2	2	20
OG0001167	3	6	2	2	3	3	1	20
OG0001168	1	7	1	2	3	3	3	20
OG0001169	2	6	1	3	2	3	3	20
OG0001170	3	8	1	1	3	2	2	20
OG0001171	2	3	3	3	3	3	3	20
OG0001172	4	4	4	2	2	2	2	20
OG0001173	2	5	3	2	3	4	1	20
OG0001174	1	4	3	3	2	3	4	20
OG0001175	5	5	2	2	2	2	2	20
OG0001176	6	2	2	3	1	3	3	20
OG0001177	2	8	1	2	2	2	3	20
OG0001178	3	5	3	3	1	2	3	20
OG0001179	1	15	0	1	1	1	1	20
OG0001180	2	5	4	2	3	1	3	20
OG0001181	2	6	1	2	2	4	3	20
OG0001182	4	10	2	1	1	1	1	20
OG0001183	2	8	3	3	1	1	2	20
OG0001184	4	7	2	2	2	2	1	20
OG0001185	1	9	2	3	2	2	1	20
OG0001186	1	0	2	1	0	1	15	20
OG0001187	1	8	2	3	3	2	1	20
OG0001188	2	8	3	1	3	1	2	20
OG0001189	1	10	2	2	3	1	1	20
OG0001190	2	5	3	3	2	2	3	20
OG0001191	1	9	2	2	2	2	2	20
OG0001192	2	8	2	2	2	2	2	20
OG0001193	1	13	0	1	2	1	2	20
OG0001194	1	5	3	3	3	2	3	20
OG0001195	1	8	2	3	2	2	2	20
OG0001196	1	9	1	1	3	3	2	20
OG0001197	1	10	2	2	3	1	1	20
OG0001198	1	4	4	1	3	3	4	20
OG0001199	1	9	2	2	1	4	1	20
OG0001200	0	14	0	2	2	2	0	20
OG0001201	0	8	5	1	2	1	3	20
OG0001202	0	7	1	1	4	4	3	20
OG0001203	0	9	2	3	2	1	3	20
OG0001204	0	11	3	1	1	2	2	20
OG0001205	0	7	3	2	4	3	1	20
OG0001206	0	11	1	1	2	3	2	20
OG0001207	0	18	1	0	0	0	1	20
OG0001208	0	11	0	3	4	1	1	20
OG0001209	0	8	2	3	2	2	3	20
OG0001210	0	14	2	1	0	1	2	20
OG0001211	0	7	3	3	3	2	2	20
OG0001212	0	11	1	3	2	2	1	20
OG0001213	0	10	3	2	0	0	5	20
OG0001214	0	4	1	0	0	0	15	20
OG0001215	0	15	2	0	0	0	3	20
OG0001216	0	2	1	0	0	0	17	20
OG0001217	0	5	4	3	0	5	3	20
OG0001218	0	8	2	1	4	3	2	20
OG0001219	0	1	2	2	2	6	7	20
OG0001220	0	3	5	3	2	4	3	20
OG0001221	0	2	5	1	0	3	9	20
OG0001222	0	9	3	1	2	2	3	20
OG0001223	0	0	1	0	1	0	18	20
OG0001224	0	0	0	0	1	0	19	20
OG0001225	0	0	0	0	0	0	20	20
OG0001226	4	8	2	2	2	0	1	19
OG0001227	19	0	0	0	0	0	0	19
OG0001228	2	6	1	2	4	2	2	19
OG0001229	4	6	2	2	2	2	1	19
OG0001230	2	7	2	2	2	2	2	19
OG0001231	17	1	1	0	0	0	0	19
OG0001232	13	3	0	1	1	1	0	19
OG0001233	6	3	2	2	2	2	2	19
OG0001234	2	6	2	2	4	1	2	19
OG0001235	4	5	2	2	1	2	3	19
OG0001236	4	5	2	2	2	2	2	19
OG0001237	19	0	0	0	0	0	0	19
OG0001238	4	5	2	2	2	2	2	19
OG0001239	5	5	2	2	1	2	2	19
OG0001240	3	9	0	1	2	2	2	19
OG0001241	3	5	2	2	2	2	3	19
OG0001242	4	4	3	2	2	3	1	19
OG0001243	3	5	2	2	3	2	2	19
OG0001244	4	6	2	2	3	1	1	19
OG0001245	3	2	0	2	8	3	1	19
OG0001246	3	7	1	2	3	1	2	19
OG0001247	3	5	2	2	2	2	3	19
OG0001248	2	5	1	2	1	4	4	19
OG0001249	3	5	2	2	2	2	3	19
OG0001250	3	6	2	2	2	2	2	19
OG0001251	3	5	2	2	3	2	2	19
OG0001252	3	6	2	2	2	2	2	19
OG0001253	3	6	1	2	2	1	4	19
OG0001254	2	8	2	2	2	2	1	19
OG0001255	4	6	1	1	2	3	2	19
OG0001256	2	7	2	2	2	2	2	19
OG0001257	3	5	2	2	3	2	2	19
OG0001258	4	6	2	2	2	1	2	19
OG0001259	1	3	2	3	3	3	4	19
OG0001260	4	5	3	1	2	2	2	19
OG0001261	2	6	1	2	2	2	4	19
OG0001262	1	0	8	1	2	0	7	19
OG0001263	3	5	0	2	3	3	3	19
OG0001264	5	6	2	1	2	1	2	19
OG0001265	3	6	3	2	1	1	3	19
OG0001266	3	6	2	2	2	2	2	19
OG0001267	3	5	2	1	3	2	3	19
OG0001268	2	5	2	4	2	2	2	19
OG0001269	2	7	2	3	3	1	1	19
OG0001270	5	8	1	1	2	1	1	19
OG0001271	1	8	1	2	3	2	2	19
OG0001272	9	3	0	1	2	3	1	19
OG0001273	2	7	2	2	2	2	2	19
OG0001274	3	5	2	2	1	2	4	19
OG0001275	3	4	4	2	1	2	3	19
OG0001276	2	6	2	2	2	3	2	19
OG0001277	2	7	2	2	2	2	2	19
OG0001278	1	6	2	2	2	0	6	19
OG0001279	2	8	2	2	2	2	1	19
OG0001280	5	5	2	1	2	1	3	19
OG0001281	1	8	3	2	2	2	1	19
OG0001282	1	8	1	1	4	3	1	19
OG0001283	2	7	2	2	3	1	2	19
OG0001284	1	8	1	5	1	2	1	19
OG0001285	3	6	2	2	2	2	2	19
OG0001286	2	5	4	2	1	2	3	19
OG0001287	2	9	1	2	1	2	2	19
OG0001288	3	6	2	2	2	2	2	19
OG0001289	2	10	1	2	1	1	2	19
OG0001290	3	7	2	2	1	2	2	19
OG0001291	2	14	2	0	0	0	1	19
OG0001292	2	6	2	2	2	2	3	19
OG0001293	2	7	2	2	2	2	2	19
OG0001294	4	5	2	2	2	2	2	19
OG0001295	3	6	2	2	2	2	2	19
OG0001296	3	6	2	2	2	2	2	19
OG0001297	2	7	2	2	2	2	2	19
OG0001298	1	8	3	2	2	2	1	19
OG0001299	3	4	2	2	2	2	4	19
OG0001300	1	6	3	1	2	4	2	19
OG0001301	2	6	2	3	3	0	3	19
OG0001302	5	5	2	2	1	2	2	19
OG0001303	2	7	1	2	2	3	2	19
OG0001304	1	7	2	3	2	2	2	19
OG0001305	2	6	2	3	2	1	3	19
OG0001306	3	5	2	3	2	2	2	19
OG0001307	1	5	2	3	2	1	5	19
OG0001308	3	6	1	3	1	3	2	19
OG0001309	4	5	2	2	2	2	2	19
OG0001310	4	6	2	2	2	2	1	19
OG0001311	3	1	3	3	3	3	3	19
OG0001312	3	7	2	2	2	1	2	19
OG0001313	3	8	2	2	2	1	1	19
OG0001314	4	5	2	2	2	2	2	19
OG0001315	3	7	2	2	1	2	2	19
OG0001316	3	12	3	0	0	0	1	19
OG0001317	2	8	2	2	1	1	3	19
OG0001318	3	4	2	4	2	2	2	19
OG0001319	3	12	3	1	0	0	0	19
OG0001320	1	10	2	1	1	1	3	19
OG0001321	4	4	3	2	2	2	2	19
OG0001322	1	7	2	2	2	1	4	19
OG0001323	3	5	2	3	2	2	2	19
OG0001324	2	6	3	2	2	2	2	19
OG0001325	3	6	2	3	2	2	1	19
OG0001326	2	7	2	2	1	3	2	19
OG0001327	3	1	3	3	4	3	2	19
OG0001328	1	6	1	4	3	2	2	19
OG0001329	2	4	4	2	3	2	2	19
OG0001330	3	7	1	2	2	2	2	19
OG0001331	1	10	2	1	0	2	3	19
OG0001332	1	7	1	4	0	3	3	19
OG0001333	2	5	3	2	1	3	3	19
OG0001334	4	5	2	2	3	2	1	19
OG0001335	3	6	2	2	2	2	2	19
OG0001336	3	7	2	2	1	2	2	19
OG0001337	1	7	2	3	3	2	1	19
OG0001338	1	8	2	2	2	2	2	19
OG0001339	1	7	2	3	2	2	2	19
OG0001340	1	5	2	2	3	2	4	19
OG0001341	1	8	1	2	3	2	2	19
OG0001342	2	9	1	1	2	2	2	19
OG0001343	2	2	5	1	1	3	5	19
OG0001344	2	7	3	2	1	2	2	19
OG0001345	1	4	1	3	4	3	3	19
OG0001346	1	6	1	9	0	2	0	19
OG0001347	2	11	0	1	1	3	1	19
OG0001348	1	5	2	3	3	3	2	19
OG0001349	1	9	0	2	5	2	0	19
OG0001350	1	9	2	2	1	2	2	19
OG0001351	1	11	1	1	3	1	1	19
OG0001352	1	8	2	2	2	2	2	19
OG0001353	1	8	2	2	2	2	2	19
OG0001354	1	6	3	2	2	3	2	19
OG0001355	0	19	0	0	0	0	0	19
OG0001356	0	8	1	0	1	0	9	19
OG0001357	0	14	0	1	0	2	2	19
OG0001358	0	15	0	0	2	1	1	19
OG0001359	0	7	2	2	2	3	3	19
OG0001360	0	6	2	3	2	3	3	19
OG0001361	0	5	1	2	3	6	2	19
OG0001362	0	5	3	3	3	2	3	19
OG0001363	0	19	0	0	0	0	0	19
OG0001364	0	7	4	2	3	2	1	19
OG0001365	0	18	0	0	0	0	1	19
OG0001366	0	4	5	2	2	3	3	19
OG0001367	0	17	1	0	0	0	1	19
OG0001368	0	6	3	3	2	3	2	19
OG0001369	0	8	2	3	2	2	2	19
OG0001370	0	4	5	2	2	3	3	19
OG0001371	0	4	3	2	2	4	4	19
OG0001372	0	7	1	3	3	3	2	19
OG0001373	0	7	3	3	2	2	2	19
OG0001374	0	7	3	2	2	3	2	19
OG0001375	0	7	1	4	1	3	3	19
OG0001376	0	3	1	2	4	5	4	19
OG0001377	0	7	2	1	2	4	3	19
OG0001378	17	0	1	0	0	0	0	18
OG0001379	4	4	2	2	2	2	2	18
OG0001380	10	4	1	1	1	1	0	18
OG0001381	2	6	3	3	2	2	0	18
OG0001382	3	5	3	3	1	1	2	18
OG0001383	2	7	2	2	2	2	1	18
OG0001384	1	0	5	0	4	7	1	18
OG0001385	3	7	4	1	1	1	1	18
OG0001386	4	4	2	2	2	2	2	18
OG0001387	4	4	2	2	2	2	2	18
OG0001388	3	5	2	2	2	2	2	18
OG0001389	2	7	2	2	2	2	1	18
OG0001390	4	4	2	2	2	2	2	18
OG0001391	2	6	2	3	2	2	1	18
OG0001392	8	3	1	1	1	1	3	18
OG0001393	3	7	2	2	1	1	2	18
OG0001394	3	4	2	2	3	2	2	18
OG0001395	3	5	2	2	2	2	2	18
OG0001396	3	7	3	2	1	1	1	18
OG0001397	3	1	1	2	2	3	6	18
OG0001398	18	0	0	0	0	0	0	18
OG0001399	1	6	3	1	2	3	2	18
OG0001400	5	8	2	0	2	1	0	18
OG0001401	4	4	2	1	2	2	3	18
OG0001402	4	4	2	2	2	2	2	18
OG0001403	4	5	3	1	1	1	3	18
OG0001404	1	7	2	2	2	2	2	18
OG0001405	5	3	2	2	2	2	2	18
OG0001406	2	6	2	2	2	2	2	18
OG0001407	1	7	2	2	2	2	2	18
OG0001408	4	6	0	1	2	2	3	18
OG0001409	3	5	2	2	2	2	2	18
OG0001410	3	6	2	1	1	2	3	18
OG0001411	3	7	2	1	1	2	2	18
OG0001412	3	5	1	0	1	3	5	18
OG0001413	5	4	1	2	1	2	3	18
OG0001414	5	5	2	2	2	1	1	18
OG0001415	2	8	1	2	2	2	1	18
OG0001416	2	5	1	1	1	3	5	18
OG0001417	18	0	0	0	0	0	0	18
OG0001418	6	10	0	0	2	0	0	18
OG0001419	2	7	2	2	3	0	2	18
OG0001420	2	6	2	2	3	1	2	18
OG0001421	4	5	1	1	1	5	1	18
OG0001422	3	6	2	2	2	2	1	18
OG0001423	3	5	2	2	2	2	2	18
OG0001424	4	6	2	1	2	1	2	18
OG0001425	2	6	2	2	2	2	2	18
OG0001426	3	4	2	2	3	2	2	18
OG0001427	3	3	0	4	4	4	0	18
OG0001428	3	5	2	2	2	2	2	18
OG0001429	2	5	2	2	3	2	2	18
OG0001430	4	4	2	2	2	2	2	18
OG0001431	3	5	1	2	2	2	3	18
OG0001432	4	6	2	2	1	1	2	18
OG0001433	3	8	2	1	2	0	2	18
OG0001434	2	6	2	2	2	2	2	18
OG0001435	4	5	2	2	2	1	2	18
OG0001436	3	5	2	2	1	2	3	18
OG0001437	2	1	2	2	4	3	4	18
OG0001438	2	7	2	2	2	2	1	18
OG0001439	2	6	2	2	2	2	2	18
OG0001440	3	5	2	2	2	2	2	18
OG0001441	6	5	2	0	2	1	2	18
OG0001442	4	7	2	1	1	2	1	18
OG0001443	4	4	2	2	2	2	2	18
OG0001444	1	1	0	5	7	4	0	18
OG0001445	5	5	2	2	2	1	1	18
OG0001446	2	6	3	3	1	1	2	18
OG0001447	6	3	2	1	2	2	2	18
OG0001448	3	7	2	2	1	1	2	18
OG0001449	1	7	2	3	2	1	2	18
OG0001450	6	7	2	0	0	1	2	18
OG0001451	3	5	2	2	2	2	2	18
OG0001452	1	14	2	0	0	0	1	18
OG0001453	7	4	2	2	1	1	1	18
OG0001454	2	9	2	1	1	2	1	18
OG0001455	2	5	3	2	2	2	2	18
OG0001456	2	5	2	2	2	2	3	18
OG0001457	2	3	4	2	3	1	3	18
OG0001458	2	1	3	3	3	3	3	18
OG0001459	4	5	2	2	2	1	2	18
OG0001460	2	5	2	2	3	2	2	18
OG0001461	1	6	2	2	2	3	2	18
OG0001462	2	8	1	0	4	1	2	18
OG0001463	3	5	2	2	2	2	2	18
OG0001464	1	8	2	2	2	1	2	18
OG0001465	1	7	3	3	0	2	2	18
OG0001466	2	6	2	2	2	2	2	18
OG0001467	3	5	2	2	2	2	2	18
OG0001468	2	8	2	2	1	1	2	18
OG0001469	2	4	2	2	2	3	3	18
OG0001470	1	7	2	2	2	2	2	18
OG0001471	4	7	2	2	2	1	0	18
OG0001472	4	5	2	2	2	1	2	18
OG0001473	2	7	2	2	2	2	1	18
OG0001474	3	6	1	2	3	2	1	18
OG0001475	4	4	2	2	2	2	2	18
OG0001476	3	5	2	2	2	2	2	18
OG0001477	2	3	4	3	2	2	2	18
OG0001478	1	9	2	1	1	1	3	18
OG0001479	3	6	1	0	1	4	3	18
OG0001480	1	7	2	2	2	2	2	18
OG0001481	1	7	4	1	1	2	2	18
OG0001482	2	6	2	2	2	2	2	18
OG0001483	3	7	1	1	2	2	2	18
OG0001484	2	7	2	1	2	2	2	18
OG0001485	10	4	1	1	1	1	0	18
OG0001486	3	4	2	2	1	3	3	18
OG0001487	2	6	2	2	2	2	2	18
OG0001488	2	6	2	2	2	2	2	18
OG0001489	1	5	2	1	1	5	3	18
OG0001490	2	7	2	2	1	1	3	18
OG0001491	1	9	2	2	2	1	1	18
OG0001492	3	4	2	2	2	3	2	18
OG0001493	6	4	2	1	2	1	2	18
OG0001494	3	4	2	3	2	2	2	18
OG0001495	4	5	1	1	2	4	1	18
OG0001496	4	5	2	2	1	2	2	18
OG0001497	2	8	1	2	2	1	2	18
OG0001498	1	1	0	6	7	1	2	18
OG0001499	1	6	2	2	2	3	2	18
OG0001500	1	8	1	2	2	2	2	18
OG0001501	2	2	3	3	3	3	2	18
OG0001502	2	6	2	2	1	2	3	18
OG0001503	3	5	2	2	2	2	2	18
OG0001504	3	4	2	3	2	1	3	18
OG0001505	1	10	1	2	0	2	2	18
OG0001506	1	4	5	2	0	2	4	18
OG0001507	1	15	0	0	0	0	2	18
OG0001508	1	7	2	3	2	1	2	18
OG0001509	1	8	1	2	2	2	2	18
OG0001510	2	10	2	0	1	0	3	18
OG0001511	6	0	3	2	2	2	3	18
OG0001512	5	4	2	2	2	2	1	18
OG0001513	3	5	2	2	2	2	2	18
OG0001514	3	6	2	2	2	1	2	18
OG0001515	3	6	1	0	3	2	3	18
OG0001516	1	7	1	2	1	3	3	18
OG0001517	3	7	2	2	1	1	2	18
OG0001518	1	6	0	2	1	3	5	18
OG0001519	1	6	3	2	2	2	2	18
OG0001520	1	8	2	2	1	1	3	18
OG0001521	2	5	3	2	1	2	3	18
OG0001522	1	6	4	1	2	1	3	18
OG0001523	3	4	2	2	2	3	2	18
OG0001524	1	8	2	1	3	2	1	18
OG0001525	2	5	1	1	1	2	6	18
OG0001526	2	6	2	2	2	2	2	18
OG0001527	1	7	1	2	1	4	2	18
OG0001528	1	8	2	0	0	1	6	18
OG0001529	1	7	2	2	2	2	2	18
OG0001530	1	6	2	2	1	3	3	18
OG0001531	1	7	3	2	2	1	2	18
OG0001532	1	7	1	2	2	3	2	18
OG0001533	2	8	3	1	2	1	1	18
OG0001534	1	4	2	3	2	3	3	18
OG0001535	1	0	1	2	5	7	2	18
OG0001536	1	9	1	1	4	1	1	18
OG0001537	2	6	2	2	2	1	3	18
OG0001538	1	7	1	4	1	2	2	18
OG0001539	2	8	2	2	1	2	1	18
OG0001540	2	6	2	2	2	2	2	18
OG0001541	2	5	4	1	2	2	2	18
OG0001542	1	6	2	3	2	2	2	18
OG0001543	1	6	1	3	3	2	2	18
OG0001544	0	9	1	5	0	2	1	18
OG0001545	0	18	0	0	0	0	0	18
OG0001546	0	7	0	2	0	4	5	18
OG0001547	0	18	0	0	0	0	0	18
OG0001548	0	7	2	0	4	4	1	18
OG0001549	0	14	0	2	1	1	0	18
OG0001550	0	14	0	1	0	0	3	18
OG0001551	0	9	3	1	0	0	5	18
OG0001552	0	8	4	1	0	1	4	18
OG0001553	0	8	1	2	2	2	3	18
OG0001554	0	7	1	3	3	2	2	18
OG0001555	0	18	0	0	0	0	0	18
OG0001556	0	16	0	0	0	0	2	18
OG0001557	0	9	3	1	2	1	2	18
OG0001558	0	4	7	1	2	2	2	18
OG0001559	0	10	0	3	2	2	1	18
OG0001560	0	8	4	1	1	2	2	18
OG0001561	0	6	1	2	3	4	2	18
OG0001562	0	10	0	3	2	1	2	18
OG0001563	0	10	1	2	2	2	1	18
OG0001564	0	7	4	2	1	3	1	18
OG0001565	0	8	1	1	2	3	3	18
OG0001566	0	9	2	1	3	2	1	18
OG0001567	0	10	2	1	3	1	1	18
OG0001568	0	3	1	5	5	2	2	18
OG0001569	0	9	0	1	4	1	3	18
OG0001570	0	10	0	4	2	1	1	18
OG0001571	0	8	2	0	2	3	3	18
OG0001572	0	2	1	1	4	3	7	18
OG0001573	0	8	1	3	1	2	3	18
OG0001574	0	5	2	3	2	3	3	18
OG0001575	0	4	2	3	5	2	2	18
OG0001576	0	6	3	2	3	2	2	18
OG0001577	0	9	0	2	2	3	2	18
OG0001578	0	6	1	3	1	4	3	18
OG0001579	0	6	1	0	3	4	4	18
OG0001580	0	0	0	2	0	1	15	18
OG0001581	0	0	0	0	0	0	18	18
OG0001582	0	0	0	0	0	0	18	18
OG0001583	2	6	1	2	1	3	2	17
OG0001584	2	5	2	2	1	2	3	17
OG0001585	3	7	2	1	1	2	1	17
OG0001586	6	4	1	1	2	1	2	17
OG0001587	17	0	0	0	0	0	0	17
OG0001588	1	7	2	1	3	1	2	17
OG0001589	6	6	1	1	1	1	1	17
OG0001590	5	1	2	3	2	2	2	17
OG0001591	2	5	2	2	2	2	2	17
OG0001592	2	7	2	1	2	2	1	17
OG0001593	2	9	1	1	2	1	1	17
OG0001594	3	5	1	2	2	2	2	17
OG0001595	4	3	2	2	2	2	2	17
OG0001596	1	7	2	1	2	3	1	17
OG0001597	13	0	2	0	0	2	0	17
OG0001598	3	7	1	0	1	2	3	17
OG0001599	2	5	2	2	2	2	2	17
OG0001600	4	5	2	2	1	2	1	17
OG0001601	3	4	2	2	2	2	2	17
OG0001602	2	5	2	2	2	2	2	17
OG0001603	4	4	2	2	1	2	2	17
OG0001604	4	6	1	2	1	1	2	17
OG0001605	6	1	2	2	2	2	2	17
OG0001606	8	0	6	1	1	1	0	17
OG0001607	8	0	2	2	2	2	1	17
OG0001608	1	6	2	2	2	2	2	17
OG0001609	3	0	0	1	1	0	12	17
OG0001610	2	6	2	1	1	3	2	17
OG0001611	1	7	2	2	2	2	1	17
OG0001612	2	6	2	2	2	1	2	17
OG0001613	1	7	1	1	3	1	3	17
OG0001614	5	3	2	2	0	2	3	17
OG0001615	3	10	2	0	1	0	1	17
OG0001616	1	6	2	2	2	2	2	17
OG0001617	2	5	2	2	2	2	2	17
OG0001618	3	4	2	2	2	2	2	17
OG0001619	2	6	2	2	1	2	2	17
OG0001620	8	1	1	1	2	2	2	17
OG0001621	4	3	1	2	1	3	3	17
OG0001622	2	6	2	2	2	1	2	17
OG0001623	2	8	1	2	2	1	1	17
OG0001624	3	3	2	2	2	3	2	17
OG0001625	2	6	1	2	2	2	2	17
OG0001626	2	5	1	2	3	2	2	17
OG0001627	1	6	2	2	2	2	2	17
OG0001628	2	6	2	2	2	1	2	17
OG0001629	8	3	1	1	1	1	2	17
OG0001630	1	7	2	1	2	2	2	17
OG0001631	3	4	2	2	1	3	2	17
OG0001632	1	5	2	3	2	2	2	17
OG0001633	1	9	0	1	6	0	0	17
OG0001634	4	3	2	2	2	2	2	17
OG0001635	3	4	2	2	2	2	2	17
OG0001636	3	5	1	2	2	2	2	17
OG0001637	2	6	2	1	2	2	2	17
OG0001638	3	5	2	1	2	2	2	17
OG0001639	5	5	2	1	1	1	2	17
OG0001640	3	6	2	1	1	1	3	17
OG0001641	3	6	2	1	1	2	2	17
OG0001642	3	5	2	1	2	1	3	17
OG0001643	4	5	0	0	0	0	8	17
OG0001644	2	5	2	2	2	2	2	17
OG0001645	5	6	0	2	3	1	0	17
OG0001646	1	3	1	1	1	5	5	17
OG0001647	9	0	0	2	3	3	0	17
OG0001648	4	2	2	2	1	3	3	17
OG0001649	2	8	2	1	1	1	2	17
OG0001650	16	0	1	0	0	0	0	17
OG0001651	2	7	1	2	1	2	2	17
OG0001652	8	4	1	1	1	1	1	17
OG0001653	10	3	1	1	0	1	1	17
OG0001654	4	4	2	2	1	2	2	17
OG0001655	2	6	2	2	2	2	1	17
OG0001656	2	6	2	2	1	2	2	17
OG0001657	5	3	2	2	2	2	1	17
OG0001658	8	3	1	1	1	2	1	17
OG0001659	2	5	2	2	2	2	2	17
OG0001660	3	5	4	1	2	1	1	17
OG0001661	2	2	3	2	2	2	4	17
OG0001662	5	5	2	1	1	1	2	17
OG0001663	2	6	1	2	2	2	2	17
OG0001664	4	2	2	2	3	2	2	17
OG0001665	4	5	2	2	1	1	2	17
OG0001666	2	4	2	2	2	0	5	17
OG0001667	3	7	1	1	1	3	1	17
OG0001668	2	3	3	2	2	3	2	17
OG0001669	3	4	2	2	2	2	2	17
OG0001670	2	7	4	0	0	0	4	17
OG0001671	2	7	1	0	2	4	1	17
OG0001672	4	4	2	2	2	2	1	17
OG0001673	4	5	2	2	1	1	2	17
OG0001674	2	5	2	2	2	2	2	17
OG0001675	1	7	1	2	2	2	2	17
OG0001676	2	7	1	1	2	2	2	17
OG0001677	5	4	2	1	2	2	1	17
OG0001678	2	5	2	2	2	2	2	17
OG0001679	2	10	2	2	0	0	1	17
OG0001680	3	5	2	2	2	2	1	17
OG0001681	4	3	2	2	2	2	2	17
OG0001682	2	6	1	2	2	2	2	17
OG0001683	3	4	2	2	2	2	2	17
OG0001684	4	4	1	2	2	2	2	17
OG0001685	2	5	2	2	2	3	1	17
OG0001686	1	8	1	2	2	2	1	17
OG0001687	3	5	2	2	2	1	2	17
OG0001688	5	3	3	1	2	1	2	17
OG0001689	3	4	2	2	2	2	2	17
OG0001690	2	8	0	2	2	2	1	17
OG0001691	1	8	2	2	1	2	1	17
OG0001692	2	5	2	2	2	2	2	17
OG0001693	3	7	1	2	4	0	0	17
OG0001694	3	8	3	0	2	1	0	17
OG0001695	7	2	2	1	2	2	1	17
OG0001696	2	5	2	2	2	2	2	17
OG0001697	3	4	2	2	3	2	1	17
OG0001698	4	5	1	1	2	2	2	17
OG0001699	1	6	2	2	2	2	2	17
OG0001700	2	7	1	1	1	3	2	17
OG0001701	3	1	3	2	2	3	3	17
OG0001702	2	5	2	2	2	2	2	17
OG0001703	3	6	2	2	1	2	1	17
OG0001704	1	6	2	2	2	2	2	17
OG0001705	2	6	2	2	2	2	1	17
OG0001706	3	6	3	2	2	1	0	17
OG0001707	1	5	3	2	2	2	2	17
OG0001708	1	6	0	2	0	4	4	17
OG0001709	3	3	2	2	3	2	2	17
OG0001710	2	6	2	2	1	2	2	17
OG0001711	2	3	2	3	2	3	2	17
OG0001712	4	5	3	2	1	0	2	17
OG0001713	3	4	2	2	2	2	2	17
OG0001714	2	5	2	2	2	2	2	17
OG0001715	3	4	2	2	1	2	3	17
OG0001716	3	4	2	2	2	2	2	17
OG0001717	2	5	2	2	2	2	2	17
OG0001718	2	6	1	2	2	2	2	17
OG0001719	3	4	1	1	3	3	2	17
OG0001720	1	6	1	3	2	2	2	17
OG0001721	2	7	2	2	2	1	1	17
OG0001722	1	6	3	2	1	2	2	17
OG0001723	1	1	3	3	4	3	2	17
OG0001724	1	6	2	2	2	2	2	17
OG0001725	1	5	2	2	2	2	3	17
OG0001726	2	5	2	3	2	2	1	17
OG0001727	2	5	2	2	2	2	2	17
OG0001728	3	6	1	1	2	2	2	17
OG0001729	3	4	2	2	2	2	2	17
OG0001730	1	4	1	4	3	2	2	17
OG0001731	2	6	1	1	2	3	2	17
OG0001732	2	6	3	2	0	2	2	17
OG0001733	2	5	2	2	2	2	2	17
OG0001734	1	6	2	2	2	2	2	17
OG0001735	1	4	2	1	3	3	3	17
OG0001736	1	5	1	2	2	4	2	17
OG0001737	1	5	2	2	2	2	3	17
OG0001738	2	5	2	2	2	2	2	17
OG0001739	2	7	2	2	1	2	1	17
OG0001740	1	6	1	2	2	2	3	17
OG0001741	3	5	2	2	2	1	2	17
OG0001742	1	8	2	2	2	0	2	17
OG0001743	1	6	2	2	2	2	2	17
OG0001744	1	6	2	2	2	1	3	17
OG0001745	3	7	2	2	1	1	1	17
OG0001746	3	3	2	2	2	2	3	17
OG0001747	2	3	4	1	2	2	3	17
OG0001748	1	8	2	2	2	1	1	17
OG0001749	2	6	2	2	2	1	2	17
OG0001750	1	9	1	3	1	1	1	17
OG0001751	1	8	2	2	2	1	1	17
OG0001752	2	1	2	6	2	1	3	17
OG0001753	4	6	3	2	1	0	1	17
OG0001754	2	6	2	2	1	1	3	17
OG0001755	4	3	2	2	2	2	2	17
OG0001756	1	8	2	2	1	1	2	17
OG0001757	2	5	2	2	2	2	2	17
OG0001758	2	8	1	1	3	1	1	17
OG0001759	2	5	2	1	2	2	3	17
OG0001760	3	4	2	2	2	2	2	17
OG0001761	1	6	2	2	2	2	2	17
OG0001762	2	5	1	2	4	1	2	17
OG0001763	2	6	2	2	2	2	1	17
OG0001764	2	6	2	1	2	2	2	17
OG0001765	2	6	2	2	0	4	1	17
OG0001766	5	5	1	3	1	1	1	17
OG0001767	2	5	2	2	2	2	2	17
OG0001768	2	6	2	2	2	1	2	17
OG0001769	1	8	1	2	1	2	2	17
OG0001770	2	9	1	0	2	1	2	17
OG0001771	2	4	3	2	2	2	2	17
OG0001772	1	9	1	2	1	2	1	17
OG0001773	1	4	2	2	1	3	4	17
OG0001774	1	3	1	3	4	3	2	17
OG0001775	1	3	1	3	2	3	4	17
OG0001776	1	6	2	2	2	2	2	17
OG0001777	2	5	2	2	2	2	2	17
OG0001778	1	6	2	2	2	2	2	17
OG0001779	1	3	6	2	2	2	1	17
OG0001780	1	6	2	2	2	2	2	17
OG0001781	1	4	3	2	3	2	2	17
OG0001782	1	6	3	3	2	1	1	17
OG0001783	2	4	3	2	2	2	2	17
OG0001784	1	8	4	0	1	1	2	17
OG0001785	1	6	2	2	2	2	2	17
OG0001786	1	1	3	3	4	3	2	17
OG0001787	0	17	0	0	0	0	0	17
OG0001788	0	7	0	3	1	3	3	17
OG0001789	0	4	2	1	3	3	4	17
OG0001790	0	11	2	0	2	2	0	17
OG0001791	0	7	3	2	1	2	2	17
OG0001792	0	7	2	2	2	2	2	17
OG0001793	0	15	0	1	0	0	1	17
OG0001794	0	14	1	0	1	0	1	17
OG0001795	0	6	0	2	3	3	3	17
OG0001796	0	6	1	4	1	1	4	17
OG0001797	0	4	0	0	1	1	11	17
OG0001798	0	2	3	3	3	3	3	17
OG0001799	0	8	0	0	0	0	9	17
OG0001800	0	8	0	1	2	1	5	17
OG0001801	0	6	2	2	3	2	2	17
OG0001802	0	7	2	2	2	2	2	17
OG0001803	0	17	0	0	0	0	0	17
OG0001804	0	3	3	2	3	3	3	17
OG0001805	0	11	0	2	1	0	3	17
OG0001806	0	10	0	2	1	2	2	17
OG0001807	0	8	1	3	1	0	4	17
OG0001808	0	11	1	1	1	2	1	17
OG0001809	0	8	3	2	1	0	3	17
OG0001810	0	8	2	2	1	3	1	17
OG0001811	0	9	1	1	2	2	2	17
OG0001812	0	5	1	2	0	5	4	17
OG0001813	0	7	2	2	2	2	2	17
OG0001814	0	7	1	2	2	2	3	17
OG0001815	0	6	2	2	2	2	3	17
OG0001816	0	7	2	2	4	0	2	17
OG0001817	0	8	3	2	1	2	1	17
OG0001818	0	17	0	0	0	0	0	17
OG0001819	0	8	0	1	2	3	3	17
OG0001820	0	9	1	0	2	1	4	17
OG0001821	0	8	1	3	0	2	3	17
OG0001822	0	9	0	3	2	3	0	17
OG0001823	0	10	1	4	0	1	1	17
OG0001824	0	3	6	3	1	1	3	17
OG0001825	0	3	3	3	2	3	3	17
OG0001826	0	5	0	1	3	4	4	17
OG0001827	0	5	1	2	3	3	3	17
OG0001828	0	0	1	4	11	0	1	17
OG0001829	0	0	0	4	13	0	0	17
OG0001830	0	0	0	0	1	0	16	17
OG0001831	0	0	0	0	0	0	17	17
OG0001832	0	0	0	0	0	0	17	17
OG0001833	2	4	2	1	1	2	4	16
OG0001834	16	0	0	0	0	0	0	16
OG0001835	4	3	2	2	2	1	2	16
OG0001836	2	4	5	2	1	1	1	16
OG0001837	3	6	1	0	2	2	2	16
OG0001838	1	7	1	2	1	2	2	16
OG0001839	4	4	1	2	2	2	1	16
OG0001840	3	3	2	3	2	1	2	16
OG0001841	16	0	0	0	0	0	0	16
OG0001842	16	0	0	0	0	0	0	16
OG0001843	3	6	2	1	1	1	2	16
OG0001844	3	7	1	1	2	1	1	16
OG0001845	10	2	1	1	1	0	1	16
OG0001846	4	4	1	2	1	2	2	16
OG0001847	2	7	2	1	2	1	1	16
OG0001848	5	5	1	1	1	1	2	16
OG0001849	8	3	1	1	1	1	1	16
OG0001850	6	4	1	1	0	2	2	16
OG0001851	10	0	1	0	0	0	5	16
OG0001852	6	5	1	1	1	1	1	16
OG0001853	5	0	0	7	2	2	0	16
OG0001854	4	4	2	1	1	2	2	16
OG0001855	4	6	1	1	1	1	2	16
OG0001856	5	2	5	0	0	0	4	16
OG0001857	6	5	1	0	2	1	1	16
OG0001858	11	4	0	0	0	0	1	16
OG0001859	2	7	1	2	1	2	1	16
OG0001860	4	3	2	1	2	2	2	16
OG0001861	2	5	1	2	2	2	2	16
OG0001862	2	8	3	1	1	0	1	16
OG0001863	2	4	2	2	2	2	2	16
OG0001864	2	5	2	2	2	2	1	16
OG0001865	5	2	2	2	4	1	0	16
OG0001866	15	1	0	0	0	0	0	16
OG0001867	2	5	2	2	1	2	2	16
OG0001868	3	4	2	2	2	2	1	16
OG0001869	2	6	1	2	1	2	2	16
OG0001870	2	5	1	2	2	2	2	16
OG0001871	1	4	2	2	3	2	2	16
OG0001872	2	4	1	1	2	3	3	16
OG0001873	3	5	2	1	2	1	2	16
OG0001874	2	6	1	1	2	1	3	16
OG0001875	1	5	2	2	2	2	2	16
OG0001876	4	2	2	2	1	2	3	16
OG0001877	2	5	1	2	2	2	2	16
OG0001878	4	2	2	3	2	2	1	16
OG0001879	4	3	3	2	2	2	0	16
OG0001880	1	7	3	1	0	0	4	16
OG0001881	2	4	2	2	2	2	2	16
OG0001882	3	4	2	1	2	2	2	16
OG0001883	1	6	1	2	2	2	2	16
OG0001884	5	4	1	0	2	2	2	16
OG0001885	4	3	2	2	1	2	2	16
OG0001886	6	5	1	1	1	1	1	16
OG0001887	2	5	2	1	2	2	2	16
OG0001888	1	6	2	2	2	1	2	16
OG0001889	2	5	2	2	2	2	1	16
OG0001890	2	6	2	2	2	1	1	16
OG0001891	1	7	1	2	2	2	1	16
OG0001892	2	4	3	2	2	2	1	16
OG0001893	3	3	2	1	2	4	1	16
OG0001894	3	7	4	0	1	1	0	16
OG0001895	4	3	1	2	3	1	2	16
OG0001896	1	5	3	2	2	2	1	16
OG0001897	2	6	2	0	5	0	1	16
OG0001898	16	0	0	0	0	0	0	16
OG0001899	3	4	3	2	2	1	1	16
OG0001900	3	3	2	2	2	2	2	16
OG0001901	3	3	2	2	2	2	2	16
OG0001902	2	4	2	1	2	2	3	16
OG0001903	3	10	1	1	0	0	1	16
OG0001904	3	6	2	0	1	2	2	16
OG0001905	2	4	2	2	3	1	2	16
OG0001906	2	5	1	2	3	2	1	16
OG0001907	2	4	4	2	2	0	2	16
OG0001908	1	4	4	2	2	0	3	16
OG0001909	2	6	2	1	2	1	2	16
OG0001910	2	6	2	2	1	2	1	16
OG0001911	1	8	0	2	2	2	1	16
OG0001912	1	5	2	2	2	2	2	16
OG0001913	1	5	2	2	2	2	2	16
OG0001914	4	2	2	2	2	2	2	16
OG0001915	2	4	1	3	2	2	2	16
OG0001916	5	4	1	1	1	1	3	16
OG0001917	2	11	0	2	1	0	0	16
OG0001918	3	5	3	0	2	1	2	16
OG0001919	2	4	2	3	1	1	3	16
OG0001920	1	7	1	3	4	0	0	16
OG0001921	2	4	8	1	0	1	0	16
OG0001922	1	5	2	2	2	2	2	16
OG0001923	2	2	2	2	3	2	3	16
OG0001924	2	4	2	2	2	2	2	16
OG0001925	1	6	2	2	1	2	2	16
OG0001926	9	2	1	1	1	1	1	16
OG0001927	2	4	2	2	2	2	2	16
OG0001928	6	5	1	1	1	1	1	16
OG0001929	4	5	2	2	1	2	0	16
OG0001930	2	4	2	2	2	2	2	16
OG0001931	3	6	0	1	1	2	3	16
OG0001932	2	9	2	2	0	0	1	16
OG0001933	2	3	3	3	0	3	2	16
OG0001934	1	7	2	2	2	1	1	16
OG0001935	3	1	3	3	2	2	2	16
OG0001936	1	6	2	2	2	1	2	16
OG0001937	4	4	3	1	2	1	1	16
OG0001938	1	5	2	2	2	2	2	16
OG0001939	2	9	2	1	1	0	1	16
OG0001940	2	5	2	2	1	2	2	16
OG0001941	2	6	1	2	1	2	2	16
OG0001942	1	8	1	1	1	1	3	16
OG0001943	1	4	2	3	2	2	2	16
OG0001944	2	6	3	2	1	1	1	16
OG0001945	2	4	3	1	2	2	2	16
OG0001946	2	4	2	2	2	2	2	16
OG0001947	1	7	2	1	2	1	2	16
OG0001948	2	3	4	2	2	2	1	16
OG0001949	3	6	1	0	1	1	4	16
OG0001950	2	5	2	1	2	2	2	16
OG0001951	4	6	2	1	1	1	1	16
OG0001952	2	4	2	2	2	2	2	16
OG0001953	2	3	3	2	1	3	2	16
OG0001954	3	5	0	3	2	2	1	16
OG0001955	1	6	2	1	2	2	2	16
OG0001956	7	6	1	0	1	1	0	16
OG0001957	3	6	1	1	3	1	1	16
OG0001958	1	14	0	0	1	0	0	16
OG0001959	1	6	1	2	2	2	2	16
OG0001960	2	6	2	1	1	2	2	16
OG0001961	4	4	2	2	1	1	2	16
OG0001962	2	6	1	2	2	1	2	16
OG0001963	2	2	3	2	2	2	3	16
OG0001964	3	6	2	1	1	1	2	16
OG0001965	1	5	2	2	2	2	2	16
OG0001966	1	4	2	1	1	2	5	16
OG0001967	1	13	0	0	1	0	1	16
OG0001968	2	5	2	3	1	1	2	16
OG0001969	3	4	3	1	2	2	1	16
OG0001970	2	4	2	2	2	2	2	16
OG0001971	2	4	2	2	2	2	2	16
OG0001972	2	6	3	1	2	1	1	16
OG0001973	1	5	3	2	1	2	2	16
OG0001974	2	5	1	2	2	2	2	16
OG0001975	3	4	2	2	2	2	1	16
OG0001976	1	6	2	1	2	2	2	16
OG0001977	2	5	2	2	2	1	2	16
OG0001978	2	3	2	2	2	2	3	16
OG0001979	3	5	2	1	2	1	2	16
OG0001980	1	6	2	1	2	2	2	16
OG0001981	1	6	2	2	1	1	3	16
OG0001982	2	7	2	1	2	1	1	16
OG0001983	3	3	5	1	2	1	1	16
OG0001984	1	6	2	2	2	2	1	16
OG0001985	2	2	2	4	2	2	2	16
OG0001986	3	4	2	2	2	1	2	16
OG0001987	1	5	2	1	2	3	2	16
OG0001988	1	5	0	2	7	1	0	16
OG0001989	4	0	2	2	2	2	4	16
OG0001990	1	6	2	2	2	2	1	16
OG0001991	2	7	2	2	1	1	1	16
OG0001992	2	8	2	1	1	1	1	16
OG0001993	1	5	2	2	2	2	2	16
OG0001994	2	4	2	2	2	2	2	16
OG0001995	1	6	2	1	4	1	1	16
OG0001996	1	6	2	2	2	1	2	16
OG0001997	1	6	1	2	1	2	3	16
OG0001998	3	5	2	2	2	1	1	16
OG0001999	1	7	1	2	1	2	2	16
OG0002000	2	7	3	1	1	1	1	16
OG0002001	2	4	3	2	1	2	2	16
OG0002002	1	1	0	4	5	4	1	16
OG0002003	1	5	2	2	2	2	2	16
OG0002004	1	4	3	2	3	2	1	16
OG0002005	3	4	2	2	2	2	1	16
OG0002006	1	6	2	0	1	3	3	16
OG0002007	2	7	1	2	2	1	1	16
OG0002008	2	4	2	2	2	2	2	16
OG0002009	1	3	3	3	1	2	3	16
OG0002010	2	8	2	1	1	1	1	16
OG0002011	1	5	2	2	2	2	2	16
OG0002012	1	7	2	1	3	2	0	16
OG0002013	1	6	2	2	2	2	1	16
OG0002014	2	6	2	1	1	2	2	16
OG0002015	2	7	1	2	2	1	1	16
OG0002016	1	7	1	2	2	1	2	16
OG0002017	2	4	2	2	2	2	2	16
OG0002018	1	5	2	1	2	3	2	16
OG0002019	2	5	2	2	2	2	1	16
OG0002020	1	6	1	2	1	2	3	16
OG0002021	2	6	2	2	0	1	3	16
OG0002022	1	7	2	2	1	2	1	16
OG0002023	0	9	2	1	1	1	2	16
OG0002024	0	15	0	0	0	0	1	16
OG0002025	0	5	2	1	2	2	4	16
OG0002026	0	8	1	2	1	2	2	16
OG0002027	0	6	2	3	3	0	2	16
OG0002028	0	8	0	2	2	2	2	16
OG0002029	0	16	0	0	0	0	0	16
OG0002030	0	7	2	2	1	3	1	16
OG0002031	0	8	0	1	3	0	4	16
OG0002032	0	15	0	0	0	0	1	16
OG0002033	0	3	3	1	2	3	4	16
OG0002034	0	8	2	2	2	1	1	16
OG0002035	0	4	3	2	3	2	2	16
OG0002036	0	14	0	0	0	1	1	16
OG0002037	0	10	0	2	2	1	1	16
OG0002038	0	16	0	0	0	0	0	16
OG0002039	0	2	6	0	1	3	4	16
OG0002040	0	6	1	3	0	2	4	16
OG0002041	0	5	3	1	1	2	4	16
OG0002042	0	9	0	2	3	1	1	16
OG0002043	0	5	1	1	1	4	4	16
OG0002044	0	3	0	3	2	5	3	16
OG0002045	0	16	0	0	0	0	0	16
OG0002046	0	16	0	0	0	0	0	16
OG0002047	0	5	1	3	0	4	3	16
OG0002048	0	4	2	3	2	3	2	16
OG0002049	0	12	1	0	0	2	1	16
OG0002050	0	2	3	2	3	3	3	16
OG0002051	0	9	0	3	3	0	1	16
OG0002052	0	9	0	1	1	2	3	16
OG0002053	0	9	1	1	1	2	2	16
OG0002054	0	6	1	1	0	0	8	16
OG0002055	0	7	2	2	1	1	3	16
OG0002056	0	8	2	0	1	2	3	16
OG0002057	0	6	3	1	4	1	1	16
OG0002058	0	6	2	2	2	2	2	16
OG0002059	0	6	2	2	2	2	2	16
OG0002060	0	7	1	2	2	1	3	16
OG0002061	0	2	8	1	1	3	1	16
OG0002062	0	7	2	2	2	2	1	16
OG0002063	0	7	2	2	2	1	2	16
OG0002064	0	9	0	1	1	3	2	16
OG0002065	0	7	2	1	2	3	1	16
OG0002066	0	14	2	0	0	0	0	16
OG0002067	0	1	0	0	0	0	15	16
OG0002068	0	0	1	0	0	0	15	16
OG0002069	0	0	0	0	0	0	16	16
OG0002070	0	0	0	0	0	0	16	16
OG0002071	0	0	0	0	0	0	16	16
OG0002072	0	0	0	0	0	0	16	16
OG0002073	4	4	2	1	1	1	2	15
OG0002074	2	7	2	1	0	2	1	15
OG0002075	1	5	1	2	2	1	3	15
OG0002076	3	6	2	2	0	0	2	15
OG0002077	2	5	2	1	2	2	1	15
OG0002078	2	4	1	2	1	3	2	15
OG0002079	7	4	0	1	1	0	2	15
OG0002080	15	0	0	0	0	0	0	15
OG0002081	2	3	2	2	2	2	2	15
OG0002082	2	3	2	2	2	2	2	15
OG0002083	2	5	0	1	2	2	3	15
OG0002084	4	4	2	1	1	1	2	15
OG0002085	15	0	0	0	0	0	0	15
OG0002086	15	0	0	0	0	0	0	15
OG0002087	4	3	2	2	1	2	1	15
OG0002088	2	3	2	2	2	2	2	15
OG0002089	6	4	1	1	1	1	1	15
OG0002090	2	7	1	2	1	1	1	15
OG0002091	6	4	1	1	1	1	1	15
OG0002092	14	0	0	0	1	0	0	15
OG0002093	15	0	0	0	0	0	0	15
OG0002094	15	0	0	0	0	0	0	15
OG0002095	2	4	2	2	1	2	2	15
OG0002096	3	5	1	0	2	1	3	15
OG0002097	1	5	1	1	2	3	2	15
OG0002098	15	0	0	0	0	0	0	15
OG0002099	2	4	2	2	2	1	2	15
OG0002100	3	5	0	2	2	2	1	15
OG0002101	2	8	1	1	1	1	1	15
OG0002102	3	5	1	1	1	1	3	15
OG0002103	4	1	6	1	1	1	1	15
OG0002104	4	0	4	3	1	1	2	15
OG0002105	3	9	0	2	0	0	1	15
OG0002106	5	4	2	0	1	1	2	15
OG0002107	2	4	3	2	0	2	2	15
OG0002108	2	3	2	2	2	2	2	15
OG0002109	4	2	2	1	2	2	2	15
OG0002110	3	3	2	2	1	2	2	15
OG0002111	3	7	1	1	1	1	1	15
OG0002112	2	4	2	1	2	2	2	15
OG0002113	3	3	2	2	1	2	2	15
OG0002114	3	5	1	1	3	0	2	15
OG0002115	5	1	2	0	0	3	4	15
OG0002116	3	6	2	1	1	1	1	15
OG0002117	9	1	1	1	1	1	1	15
OG0002118	6	4	1	1	1	1	1	15
OG0002119	2	4	2	2	1	2	2	15
OG0002120	2	3	2	1	3	2	2	15
OG0002121	3	6	2	0	1	1	2	15
OG0002122	4	2	2	2	1	2	2	15
OG0002123	2	5	1	2	0	2	3	15
OG0002124	1	4	2	2	2	2	2	15
OG0002125	2	4	2	2	1	2	2	15
OG0002126	2	6	2	2	0	2	1	15
OG0002127	4	1	2	2	2	2	2	15
OG0002128	2	3	2	2	2	2	2	15
OG0002129	3	4	1	2	1	2	2	15
OG0002130	4	2	3	1	1	2	2	15
OG0002131	2	6	1	1	1	2	2	15
OG0002132	1	5	1	3	1	2	2	15
OG0002133	6	4	1	1	1	1	1	15
OG0002134	2	5	1	1	2	2	2	15
OG0002135	6	4	1	1	1	0	2	15
OG0002136	2	5	2	1	2	1	2	15
OG0002137	1	7	1	2	1	2	1	15
OG0002138	1	5	2	2	2	1	2	15
OG0002139	4	7	1	1	1	0	1	15
OG0002140	4	5	1	1	1	1	2	15
OG0002141	7	5	2	1	0	0	0	15
OG0002142	3	6	1	1	1	2	1	15
OG0002143	1	5	0	2	1	5	1	15
OG0002144	3	5	2	2	1	1	1	15
OG0002145	2	4	4	1	1	1	2	15
OG0002146	4	4	2	1	1	1	2	15
OG0002147	5	4	2	1	1	1	1	15
OG0002148	3	4	1	1	1	4	1	15
OG0002149	2	3	2	1	1	3	3	15
OG0002150	9	4	1	0	0	0	1	15
OG0002151	6	4	1	1	1	1	1	15
OG0002152	6	4	1	1	1	1	1	15
OG0002153	2	4	1	1	2	4	1	15
OG0002154	1	7	1	2	0	2	2	15
OG0002155	1	7	1	2	2	1	1	15
OG0002156	1	4	2	2	2	2	2	15
OG0002157	4	4	1	3	2	0	1	15
OG0002158	15	0	0	0	0	0	0	15
OG0002159	8	2	1	1	1	1	1	15
OG0002160	2	6	1	2	2	1	1	15
OG0002161	3	4	2	2	2	0	2	15
OG0002162	4	4	2	1	1	1	2	15
OG0002163	2	8	1	1	1	1	1	15
OG0002164	2	4	2	1	2	2	2	15
OG0002165	2	2	2	2	2	2	3	15
OG0002166	3	4	0	2	2	2	2	15
OG0002167	5	3	2	1	1	2	1	15
OG0002168	3	7	1	0	2	1	1	15
OG0002169	2	3	2	1	2	2	3	15
OG0002170	2	5	1	2	0	2	3	15
OG0002171	4	2	2	2	2	1	2	15
OG0002172	2	4	2	4	2	0	1	15
OG0002173	9	4	1	0	0	0	1	15
OG0002174	3	7	2	1	1	1	0	15
OG0002175	6	1	3	1	1	1	2	15
OG0002176	1	4	2	2	2	2	2	15
OG0002177	4	5	2	1	0	1	2	15
OG0002178	3	3	1	1	2	2	3	15
OG0002179	4	3	2	2	1	1	2	15
OG0002180	2	3	2	2	2	2	2	15
OG0002181	2	4	2	2	2	1	2	15
OG0002182	4	5	1	1	2	1	1	15
OG0002183	2	5	2	2	2	1	1	15
OG0002184	2	5	2	1	1	2	2	15
OG0002185	3	6	2	1	1	2	0	15
OG0002186	2	5	2	1	1	2	2	15
OG0002187	2	4	2	2	2	1	2	15
OG0002188	2	6	1	2	2	1	1	15
OG0002189	2	4	1	3	1	0	4	15
OG0002190	1	7	1	1	1	1	3	15
OG0002191	4	4	2	1	1	2	1	15
OG0002192	1	12	1	0	0	0	1	15
OG0002193	1	6	1	3	2	1	1	15
OG0002194	3	3	2	2	1	2	2	15
OG0002195	1	12	0	1	1	0	0	15
OG0002196	3	6	2	1	1	1	1	15
OG0002197	3	4	3	1	1	2	1	15
OG0002198	1	7	3	1	0	0	3	15
OG0002199	3	5	1	1	1	2	2	15
OG0002200	5	4	1	1	1	1	2	15
OG0002201	2	7	2	2	0	0	2	15
OG0002202	1	5	2	2	2	2	1	15
OG0002203	5	3	0	1	2	2	2	15
OG0002204	4	6	1	1	1	1	1	15
OG0002205	1	4	1	1	1	4	3	15
OG0002206	2	3	2	2	2	2	2	15
OG0002207	2	6	1	2	2	1	1	15
OG0002208	2	5	1	1	1	2	3	15
OG0002209	3	4	2	1	2	1	2	15
OG0002210	2	0	6	2	2	1	2	15
OG0002211	4	6	1	0	1	1	2	15
OG0002212	1	5	1	4	1	2	1	15
OG0002213	1	3	2	3	2	2	2	15
OG0002214	4	3	2	1	1	1	3	15
OG0002215	2	7	1	2	1	1	1	15
OG0002216	1	8	1	2	1	1	1	15
OG0002217	3	2	1	3	2	2	2	15
OG0002218	3	4	2	1	2	1	2	15
OG0002219	2	7	1	1	2	1	1	15
OG0002220	6	3	1	1	1	2	1	15
OG0002221	3	6	2	1	1	1	1	15
OG0002222	5	2	1	1	2	2	2	15
OG0002223	3	3	2	2	1	2	2	15
OG0002224	1	7	1	1	2	1	2	15
OG0002225	4	1	3	2	2	1	2	15
OG0002226	2	6	2	1	2	1	1	15
OG0002227	4	4	2	2	1	1	1	15
OG0002228	5	2	2	3	1	1	1	15
OG0002229	2	4	1	2	2	1	3	15
OG0002230	2	5	1	2	2	1	2	15
OG0002231	3	4	3	1	1	1	2	15
OG0002232	3	6	1	2	1	1	1	15
OG0002233	1	7	1	2	1	1	2	15
OG0002234	2	5	2	2	1	2	1	15
OG0002235	3	6	1	1	1	2	1	15
OG0002236	1	8	1	1	2	1	1	15
OG0002237	2	5	4	1	1	1	1	15
OG0002238	1	7	1	1	1	2	2	15
OG0002239	1	4	2	2	2	2	2	15
OG0002240	2	4	2	2	2	2	1	15
OG0002241	3	3	2	2	1	2	2	15
OG0002242	2	7	1	2	1	1	1	15
OG0002243	1	7	3	1	1	1	1	15
OG0002244	2	4	2	2	2	2	1	15
OG0002245	3	3	1	1	3	2	2	15
OG0002246	2	6	1	2	2	1	1	15
OG0002247	1	4	1	2	3	2	2	15
OG0002248	1	8	1	2	1	2	0	15
OG0002249	1	7	2	2	1	1	1	15
OG0002250	1	2	4	1	2	2	3	15
OG0002251	2	5	2	2	2	1	1	15
OG0002252	2	7	1	2	1	2	0	15
OG0002253	3	3	2	1	2	2	2	15
OG0002254	2	4	2	2	2	2	1	15
OG0002255	2	4	2	2	2	1	2	15
OG0002256	2	4	2	2	2	2	1	15
OG0002257	4	0	2	3	2	2	2	15
OG0002258	2	8	2	0	0	0	3	15
OG0002259	2	4	1	3	1	2	2	15
OG0002260	2	5	2	1	1	2	2	15
OG0002261	1	4	2	2	2	2	2	15
OG0002262	2	7	2	2	1	0	1	15
OG0002263	2	4	2	2	2	2	1	15
OG0002264	1	5	1	1	3	2	2	15
OG0002265	2	3	2	2	2	2	2	15
OG0002266	1	6	1	2	2	1	2	15
OG0002267	2	3	2	2	2	2	2	15
OG0002268	3	2	2	2	2	2	2	15
OG0002269	1	4	2	1	2	2	3	15
OG0002270	2	6	1	1	3	1	1	15
OG0002271	2	3	0	1	1	8	0	15
OG0002272	1	4	2	2	2	2	2	15
OG0002273	1	2	2	2	2	2	4	15
OG0002274	2	5	2	2	1	1	2	15
OG0002275	1	4	2	2	2	2	2	15
OG0002276	2	5	2	2	2	1	1	15
OG0002277	1	7	1	1	1	1	3	15
OG0002278	2	6	1	3	1	1	1	15
OG0002279	1	3	3	2	2	2	2	15
OG0002280	1	6	2	2	2	1	1	15
OG0002281	1	4	2	2	1	1	4	15
OG0002282	1	7	2	1	2	0	2	15
OG0002283	2	5	1	2	1	2	2	15
OG0002284	2	4	2	2	1	2	2	15
OG0002285	1	6	2	2	0	2	2	15
OG0002286	1	9	2	1	1	0	1	15
OG0002287	1	4	1	1	2	2	4	15
OG0002288	1	6	1	1	2	2	2	15
OG0002289	1	6	2	2	1	1	2	15
OG0002290	1	5	1	2	2	1	3	15
OG0002291	1	3	0	0	1	3	7	15
OG0002292	1	4	2	2	2	2	2	15
OG0002293	1	7	2	1	1	2	1	15
OG0002294	1	4	3	2	2	1	2	15
OG0002295	2	1	10	0	1	1	0	15
OG0002296	1	7	1	3	1	1	1	15
OG0002297	1	5	2	2	2	1	2	15
OG0002298	1	6	1	2	1	2	2	15
OG0002299	1	6	1	2	1	3	1	15
OG0002300	1	5	3	2	1	1	2	15
OG0002301	0	5	2	2	2	2	2	15
OG0002302	0	9	1	1	1	1	2	15
OG0002303	0	14	0	0	0	0	1	15
OG0002304	0	10	0	1	2	1	1	15
OG0002305	0	15	0	0	0	0	0	15
OG0002306	0	7	1	2	2	1	2	15
OG0002307	0	7	1	2	2	2	1	15
OG0002308	0	14	0	1	0	0	0	15
OG0002309	0	7	2	1	2	1	2	15
OG0002310	0	7	2	2	2	1	1	15
OG0002311	0	4	3	3	1	3	1	15
OG0002312	0	5	2	3	1	1	3	15
OG0002313	0	14	0	0	0	0	1	15
OG0002314	0	5	1	2	4	1	2	15
OG0002315	0	8	0	1	3	2	1	15
OG0002316	0	5	3	4	0	1	2	15
OG0002317	0	8	2	2	1	1	1	15
OG0002318	0	14	0	0	0	0	1	15
OG0002319	0	11	0	0	0	0	4	15
OG0002320	0	5	3	1	2	2	2	15
OG0002321	0	14	0	0	0	0	1	15
OG0002322	0	8	0	2	2	2	1	15
OG0002323	0	4	1	1	3	3	3	15
OG0002324	0	6	1	1	0	4	3	15
OG0002325	0	8	0	5	1	1	0	15
OG0002326	0	6	1	2	1	2	3	15
OG0002327	0	5	2	2	2	2	2	15
OG0002328	0	2	0	0	0	0	13	15
OG0002329	0	5	2	2	2	2	2	15
OG0002330	0	4	3	0	2	3	3	15
OG0002331	0	5	1	1	2	3	3	15
OG0002332	0	6	2	2	2	2	1	15
OG0002333	0	4	2	1	1	1	6	15
OG0002334	0	4	2	2	2	2	3	15
OG0002335	0	5	2	2	2	2	2	15
OG0002336	0	4	2	2	5	1	1	15
OG0002337	0	3	2	2	2	2	4	15
OG0002338	0	1	0	0	0	0	14	15
OG0002339	0	3	0	0	1	4	7	15
OG0002340	0	0	0	0	0	1	14	15
OG0002341	0	0	0	0	0	0	15	15
OG0002342	0	0	0	0	0	0	15	15
OG0002343	14	0	0	0	0	0	0	14
OG0002344	2	4	1	2	2	2	1	14
OG0002345	4	7	1	0	0	0	2	14
OG0002346	3	7	1	1	0	1	1	14
OG0002347	3	4	1	2	2	1	1	14
OG0002348	6	3	1	1	1	1	1	14
OG0002349	4	1	2	2	3	1	1	14
OG0002350	5	4	1	1	1	1	1	14
OG0002351	4	5	1	1	1	0	2	14
OG0002352	2	2	3	1	2	2	2	14
OG0002353	2	4	1	0	0	0	7	14
OG0002354	6	4	1	1	1	1	0	14
OG0002355	2	5	3	2	2	0	0	14
OG0002356	2	7	1	1	1	1	1	14
OG0002357	2	2	2	2	2	2	2	14
OG0002358	4	2	2	2	1	1	2	14
OG0002359	2	5	2	1	1	1	2	14
OG0002360	13	0	0	0	0	0	1	14
OG0002361	6	3	1	1	1	1	1	14
OG0002362	2	4	2	1	1	2	2	14
OG0002363	14	0	0	0	0	0	0	14
OG0002364	5	3	1	1	1	2	1	14
OG0002365	13	1	0	0	0	0	0	14
OG0002366	4	2	2	1	1	2	2	14
OG0002367	5	3	2	1	1	1	1	14
OG0002368	2	5	1	1	2	1	2	14
OG0002369	6	3	1	1	1	1	1	14
OG0002370	5	4	2	1	1	1	0	14
OG0002371	3	5	2	1	1	1	1	14
OG0002372	14	0	0	0	0	0	0	14
OG0002373	2	5	1	2	1	2	1	14
OG0002374	5	4	1	1	1	1	1	14
OG0002375	2	6	1	1	2	1	1	14
OG0002376	7	2	1	1	1	1	1	14
OG0002377	4	0	2	2	2	2	2	14
OG0002378	2	3	2	2	1	2	2	14
OG0002379	2	8	1	1	0	1	1	14
OG0002380	13	1	0	0	0	0	0	14
OG0002381	5	4	1	1	1	1	1	14
OG0002382	5	4	1	1	1	1	1	14
OG0002383	3	4	1	1	1	2	2	14
OG0002384	2	5	2	1	2	1	1	14
OG0002385	3	5	1	1	2	1	1	14
OG0002386	2	6	1	2	1	1	1	14
OG0002387	3	5	1	1	2	1	1	14
OG0002388	5	4	1	1	1	1	1	14
OG0002389	2	4	1	1	2	1	3	14
OG0002390	3	5	2	1	1	1	1	14
OG0002391	3	10	1	0	0	0	0	14
OG0002392	14	0	0	0	0	0	0	14
OG0002393	1	3	2	2	2	2	2	14
OG0002394	1	6	1	1	2	2	1	14
OG0002395	2	6	1	1	2	1	1	14
OG0002396	1	1	1	3	2	3	3	14
OG0002397	14	0	0	0	0	0	0	14
OG0002398	3	3	2	1	1	2	2	14
OG0002399	1	2	2	0	4	4	1	14
OG0002400	2	2	2	1	1	2	4	14
OG0002401	3	3	1	1	2	2	2	14
OG0002402	14	0	0	0	0	0	0	14
OG0002403	2	6	2	1	1	1	1	14
OG0002404	2	5	1	2	1	1	2	14
OG0002405	2	7	1	1	1	1	1	14
OG0002406	2	5	3	1	1	1	1	14
OG0002407	2	0	2	1	3	2	4	14
OG0002408	2	6	1	1	1	1	2	14
OG0002409	1	4	1	1	1	3	3	14
OG0002410	2	3	1	2	0	2	4	14
OG0002411	3	5	2	1	0	1	2	14
OG0002412	2	6	1	2	0	2	1	14
OG0002413	1	3	3	2	2	2	1	14
OG0002414	6	3	1	1	1	1	1	14
OG0002415	14	0	0	0	0	0	0	14
OG0002416	1	1	3	3	3	3	0	14
OG0002417	2	4	2	1	2	2	1	14
OG0002418	1	4	2	2	3	1	1	14
OG0002419	4	1	2	2	2	1	2	14
OG0002420	7	2	1	1	1	1	1	14
OG0002421	7	2	1	1	1	1	1	14
OG0002422	3	3	1	1	0	4	2	14
OG0002423	3	4	1	1	2	1	2	14
OG0002424	3	6	0	0	1	2	2	14
OG0002425	5	4	1	1	1	1	1	14
OG0002426	3	3	1	2	1	2	2	14
OG0002427	5	4	1	1	1	1	1	14
OG0002428	2	4	2	1	1	2	2	14
OG0002429	2	3	2	2	2	1	2	14
OG0002430	5	1	1	1	0	3	3	14
OG0002431	5	4	1	1	1	1	1	14
OG0002432	3	1	2	2	2	2	2	14
OG0002433	5	4	1	1	1	1	1	14
OG0002434	2	4	2	2	2	1	1	14
OG0002435	1	4	2	2	1	2	2	14
OG0002436	3	4	1	1	2	2	1	14
OG0002437	3	7	1	0	2	0	1	14
OG0002438	4	7	1	0	0	0	2	14
OG0002439	2	4	1	1	1	3	2	14
OG0002440	1	6	0	0	2	2	3	14
OG0002441	1	5	1	2	1	2	2	14
OG0002442	2	4	2	2	2	1	1	14
OG0002443	5	2	1	1	2	1	2	14
OG0002444	1	7	1	2	1	1	1	14
OG0002445	2	4	1	1	1	3	2	14
OG0002446	1	8	1	2	1	1	0	14
OG0002447	8	2	0	0	1	2	1	14
OG0002448	3	2	1	1	1	1	5	14
OG0002449	1	6	2	2	1	1	1	14
OG0002450	4	5	1	1	1	1	1	14
OG0002451	2	6	1	1	1	1	2	14
OG0002452	2	6	1	2	1	1	1	14
OG0002453	3	4	1	1	1	2	2	14
OG0002454	3	5	1	1	1	2	1	14
OG0002455	2	4	1	2	2	1	2	14
OG0002456	3	5	1	2	1	1	1	14
OG0002457	2	6	1	1	1	1	2	14
OG0002458	3	6	1	1	1	1	1	14
OG0002459	1	8	1	2	1	1	0	14
OG0002460	3	3	2	2	1	2	1	14
OG0002461	3	5	1	1	1	2	1	14
OG0002462	4	1	2	1	3	2	1	14
OG0002463	4	5	1	1	1	1	1	14
OG0002464	2	4	1	2	2	1	2	14
OG0002465	1	6	1	1	1	2	2	14
OG0002466	1	6	1	1	1	2	2	14
OG0002467	1	4	1	1	2	0	5	14
OG0002468	2	2	2	2	2	2	2	14
OG0002469	2	6	1	1	2	1	1	14
OG0002470	2	4	2	2	1	1	2	14
OG0002471	2	5	1	1	1	2	2	14
OG0002472	3	3	2	2	2	1	1	14
OG0002473	3	5	1	1	1	1	2	14
OG0002474	1	3	2	2	2	2	2	14
OG0002475	2	4	2	2	1	1	2	14
OG0002476	1	7	1	1	2	2	0	14
OG0002477	5	4	1	1	1	1	1	14
OG0002478	4	5	1	1	1	1	1	14
OG0002479	2	5	1	1	3	1	1	14
OG0002480	2	4	2	2	2	0	2	14
OG0002481	2	6	2	1	1	0	2	14
OG0002482	2	5	1	1	1	3	1	14
OG0002483	3	5	1	1	1	1	2	14
OG0002484	3	4	1	1	3	1	1	14
OG0002485	3	7	2	1	0	0	1	14
OG0002486	4	2	2	1	2	2	1	14
OG0002487	4	2	2	2	2	1	1	14
OG0002488	3	2	2	2	1	2	2	14
OG0002489	4	5	1	1	1	1	1	14
OG0002490	3	6	1	1	1	0	2	14
OG0002491	2	7	1	1	1	1	1	14
OG0002492	1	5	2	1	2	2	1	14
OG0002493	2	5	1	1	1	1	3	14
OG0002494	3	5	2	1	1	1	1	14
OG0002495	2	6	2	1	1	1	1	14
OG0002496	2	6	2	2	1	0	1	14
OG0002497	1	2	2	2	2	2	3	14
OG0002498	3	6	1	1	1	1	1	14
OG0002499	4	4	1	1	1	2	1	14
OG0002500	2	5	1	1	2	1	2	14
OG0002501	6	3	1	1	1	1	1	14
OG0002502	2	7	1	1	1	1	1	14
OG0002503	2	3	2	1	2	2	2	14
OG0002504	5	3	1	1	1	2	1	14
OG0002505	5	4	1	1	1	1	1	14
OG0002506	1	6	2	2	1	1	1	14
OG0002507	1	4	2	1	1	2	3	14
OG0002508	1	5	2	1	1	3	1	14
OG0002509	1	6	2	1	1	1	2	14
OG0002510	2	2	2	2	2	2	2	14
OG0002511	2	8	1	0	1	0	2	14
OG0002512	2	4	2	2	1	2	1	14
OG0002513	4	5	1	1	1	1	1	14
OG0002514	1	8	1	1	1	0	2	14
OG0002515	4	5	1	1	1	0	2	14
OG0002516	6	2	1	1	2	1	1	14
OG0002517	2	10	1	0	0	0	1	14
OG0002518	1	7	1	2	1	1	1	14
OG0002519	5	2	7	0	0	0	0	14
OG0002520	1	7	2	1	1	1	1	14
OG0002521	3	4	2	2	1	1	1	14
OG0002522	3	5	1	1	1	1	2	14
OG0002523	2	6	1	1	1	2	1	14
OG0002524	1	4	2	3	0	2	2	14
OG0002525	1	8	1	1	1	1	1	14
OG0002526	5	4	1	1	1	1	1	14
OG0002527	2	6	1	1	2	1	1	14
OG0002528	4	4	2	1	1	1	1	14
OG0002529	3	3	1	1	2	2	2	14
OG0002530	4	2	2	1	1	2	2	14
OG0002531	3	4	1	1	1	2	2	14
OG0002532	5	4	1	1	1	1	1	14
OG0002533	1	5	2	1	4	0	1	14
OG0002534	4	4	1	1	2	1	1	14
OG0002535	3	4	1	1	1	2	2	14
OG0002536	1	5	1	1	2	2	2	14
OG0002537	2	4	1	1	1	3	2	14
OG0002538	3	0	4	1	0	0	6	14
OG0002539	3	5	1	1	1	1	2	14
OG0002540	3	4	2	1	1	1	2	14
OG0002541	3	5	1	1	1	2	1	14
OG0002542	3	6	1	1	2	0	1	14
OG0002543	2	6	1	2	1	1	1	14
OG0002544	7	3	1	1	1	0	1	14
OG0002545	2	2	2	2	2	2	2	14
OG0002546	2	5	1	1	1	2	2	14
OG0002547	1	7	2	0	2	0	2	14
OG0002548	3	1	2	2	2	2	2	14
OG0002549	2	3	2	1	2	2	2	14
OG0002550	2	1	1	1	1	4	4	14
OG0002551	2	1	2	2	2	2	3	14
OG0002552	1	4	1	1	1	3	3	14
OG0002553	2	0	2	0	0	1	9	14
OG0002554	2	5	1	1	2	2	1	14
OG0002555	1	7	1	1	2	1	1	14
OG0002556	2	4	2	2	2	1	1	14
OG0002557	4	1	2	2	2	2	1	14
OG0002558	2	7	1	1	1	1	1	14
OG0002559	1	3	1	1	3	2	3	14
OG0002560	2	4	1	1	3	2	1	14
OG0002561	2	2	1	2	4	1	2	14
OG0002562	3	3	2	1	2	1	2	14
OG0002563	1	5	3	1	1	1	2	14
OG0002564	2	3	2	2	2	2	1	14
OG0002565	2	5	3	1	1	1	1	14
OG0002566	1	6	1	2	1	1	2	14
OG0002567	2	4	1	2	1	2	2	14
OG0002568	3	6	1	1	1	1	1	14
OG0002569	2	5	2	1	1	1	2	14
OG0002570	1	2	1	2	2	4	2	14
OG0002571	1	6	1	3	1	1	1	14
OG0002572	1	5	2	2	2	1	1	14
OG0002573	1	2	2	1	2	3	3	14
OG0002574	1	7	1	2	1	1	1	14
OG0002575	5	4	1	1	1	1	1	14
OG0002576	2	4	1	4	1	1	1	14
OG0002577	1	4	2	2	2	2	1	14
OG0002578	2	2	1	2	2	2	3	14
OG0002579	1	6	2	2	1	1	1	14
OG0002580	1	4	1	2	2	2	2	14
OG0002581	2	5	1	2	2	1	1	14
OG0002582	1	4	2	2	2	1	2	14
OG0002583	1	7	0	1	3	1	1	14
OG0002584	1	5	2	1	1	2	2	14
OG0002585	1	3	3	2	2	1	2	14
OG0002586	1	6	2	1	2	1	1	14
OG0002587	1	7	1	1	2	1	1	14
OG0002588	1	4	2	2	1	1	3	14
OG0002589	2	6	1	1	2	1	1	14
OG0002590	1	5	2	2	2	1	1	14
OG0002591	1	6	1	3	2	0	1	14
OG0002592	2	4	1	2	1	2	2	14
OG0002593	2	7	1	1	1	1	1	14
OG0002594	1	3	2	1	1	3	3	14
OG0002595	2	4	1	1	2	2	2	14
OG0002596	2	4	1	1	1	2	3	14
OG0002597	1	3	3	1	2	2	2	14
OG0002598	1	13	0	0	0	0	0	14
OG0002599	1	5	1	1	1	3	2	14
OG0002600	1	5	2	2	2	1	1	14
OG0002601	2	5	2	1	1	1	2	14
OG0002602	1	6	2	1	2	1	1	14
OG0002603	1	6	1	2	2	1	1	14
OG0002604	1	3	2	2	2	2	2	14
OG0002605	1	4	2	2	2	2	1	14
OG0002606	1	5	2	2	1	1	2	14
OG0002607	2	6	1	1	2	1	1	14
OG0002608	1	6	1	1	1	3	1	14
OG0002609	2	0	2	2	4	2	2	14
OG0002610	1	5	2	2	0	2	2	14
OG0002611	2	3	2	2	1	2	2	14
OG0002612	1	4	1	1	2	2	3	14
OG0002613	1	4	1	1	3	2	2	14
OG0002614	3	5	1	2	1	1	1	14
OG0002615	1	6	1	2	1	2	1	14
OG0002616	1	4	2	2	1	2	2	14
OG0002617	1	5	0	2	1	3	2	14
OG0002618	1	5	1	2	1	2	2	14
OG0002619	1	2	2	2	1	3	3	14
OG0002620	1	4	1	2	2	2	2	14
OG0002621	2	4	2	2	0	2	2	14
OG0002622	1	3	1	2	1	3	3	14
OG0002623	1	3	1	1	2	2	4	14
OG0002624	1	6	2	2	1	1	1	14
OG0002625	2	5	2	2	1	1	1	14
OG0002626	2	4	2	1	2	1	2	14
OG0002627	1	3	6	1	0	2	1	14
OG0002628	0	14	0	0	0	0	0	14
OG0002629	0	6	0	1	2	3	2	14
OG0002630	0	5	1	3	2	3	0	14
OG0002631	0	10	4	0	0	0	0	14
OG0002632	0	13	1	0	0	0	0	14
OG0002633	0	14	0	0	0	0	0	14
OG0002634	0	5	4	1	1	2	1	14
OG0002635	0	14	0	0	0	0	0	14
OG0002636	0	8	2	1	1	1	1	14
OG0002637	0	6	5	1	0	2	0	14
OG0002638	0	14	0	0	0	0	0	14
OG0002639	0	11	0	1	0	0	2	14
OG0002640	0	6	0	2	1	3	2	14
OG0002641	0	8	1	1	1	2	1	14
OG0002642	0	4	2	2	2	1	3	14
OG0002643	0	4	3	1	3	1	2	14
OG0002644	0	7	1	2	2	2	0	14
OG0002645	0	6	1	2	1	2	2	14
OG0002646	0	10	0	1	0	0	3	14
OG0002647	0	2	4	0	0	2	6	14
OG0002648	0	7	1	1	3	1	1	14
OG0002649	0	12	0	1	0	0	1	14
OG0002650	0	9	1	2	1	1	0	14
OG0002651	0	9	0	1	1	0	3	14
OG0002652	0	7	1	2	2	2	0	14
OG0002653	0	6	1	1	2	2	2	14
OG0002654	0	9	1	2	1	1	0	14
OG0002655	0	3	1	1	1	4	4	14
OG0002656	0	13	0	0	1	0	0	14
OG0002657	0	11	0	0	2	1	0	14
OG0002658	0	4	2	1	3	2	2	14
OG0002659	0	6	0	0	3	1	4	14
OG0002660	0	7	1	3	1	1	1	14
OG0002661	0	8	2	2	1	0	1	14
OG0002662	0	6	1	1	2	2	2	14
OG0002663	0	7	1	2	1	2	1	14
OG0002664	0	2	2	3	3	3	1	14
OG0002665	0	9	1	1	0	1	2	14
OG0002666	0	8	0	1	2	2	1	14
OG0002667	0	10	0	1	1	1	1	14
OG0002668	0	5	2	2	1	3	1	14
OG0002669	0	6	2	2	1	1	2	14
OG0002670	0	4	3	1	2	2	2	14
OG0002671	0	5	2	2	1	2	2	14
OG0002672	0	7	2	1	2	1	1	14
OG0002673	0	11	1	1	0	0	1	14
OG0002674	0	5	2	1	2	2	2	14
OG0002675	0	6	1	0	1	1	5	14
OG0002676	0	3	2	3	1	2	3	14
OG0002677	0	14	0	0	0	0	0	14
OG0002678	0	6	6	0	1	1	0	14
OG0002679	0	5	1	6	1	0	1	14
OG0002680	0	4	0	1	1	1	7	14
OG0002681	0	5	0	0	0	4	5	14
OG0002682	0	10	0	1	2	1	0	14
OG0002683	0	5	3	1	2	1	2	14
OG0002684	0	6	2	1	4	1	0	14
OG0002685	0	5	1	2	3	1	2	14
OG0002686	0	7	1	2	3	1	0	14
OG0002687	0	14	0	0	0	0	0	14
OG0002688	0	2	3	2	3	2	2	14
OG0002689	0	8	0	2	2	1	1	14
OG0002690	0	5	4	3	0	1	1	14
OG0002691	0	5	1	4	1	1	2	14
OG0002692	0	6	1	2	1	2	2	14
OG0002693	0	4	3	2	1	2	2	14
OG0002694	0	3	3	2	2	2	2	14
OG0002695	0	3	2	2	1	3	3	14
OG0002696	0	5	2	1	3	2	1	14
OG0002697	0	7	1	2	1	2	1	14
OG0002698	0	3	2	0	1	1	7	14
OG0002699	0	5	2	0	3	0	4	14
OG0002700	0	5	2	1	2	2	2	14
OG0002701	0	3	1	0	3	3	4	14
OG0002702	0	0	4	1	0	0	9	14
OG0002703	0	0	0	1	2	5	6	14
OG0002704	0	0	0	0	0	1	13	14
OG0002705	0	0	0	0	0	0	14	14
OG0002706	0	0	0	0	0	0	14	14
OG0002707	4	4	1	1	1	1	1	13
OG0002708	4	1	3	0	0	1	4	13
OG0002709	4	4	1	1	1	1	1	13
OG0002710	2	6	1	1	1	1	1	13
OG0002711	2	5	2	1	1	1	1	13
OG0002712	4	3	1	1	1	1	2	13
OG0002713	2	4	2	1	1	1	2	13
OG0002714	2	6	1	1	2	1	0	13
OG0002715	2	3	2	2	1	1	2	13
OG0002716	1	3	2	1	2	2	2	13
OG0002717	13	0	0	0	0	0	0	13
OG0002718	2	5	1	1	1	2	1	13
OG0002719	4	0	2	2	2	3	0	13
OG0002720	2	5	1	1	1	1	2	13
OG0002721	4	4	1	1	1	1	1	13
OG0002722	4	6	0	0	1	0	2	13
OG0002723	2	3	1	1	2	2	2	13
OG0002724	3	3	2	1	1	1	2	13
OG0002725	2	6	1	1	1	1	1	13
OG0002726	2	1	2	2	2	2	2	13
OG0002727	2	4	1	1	2	1	2	13
OG0002728	3	4	1	1	1	1	2	13
OG0002729	3	3	1	2	2	1	1	13
OG0002730	2	5	1	1	1	1	2	13
OG0002731	3	1	1	1	2	4	1	13
OG0002732	13	0	0	0	0	0	0	13
OG0002733	5	3	1	1	1	1	1	13
OG0002734	1	5	2	1	1	2	1	13
OG0002735	3	4	2	1	1	1	1	13
OG0002736	1	5	1	1	2	2	1	13
OG0002737	2	2	1	2	2	2	2	13
OG0002738	5	4	1	1	0	1	1	13
OG0002739	4	4	1	1	1	1	1	13
OG0002740	9	0	2	0	0	1	1	13
OG0002741	6	3	2	0	0	1	1	13
OG0002742	3	4	1	1	2	1	1	13
OG0002743	3	5	1	1	1	1	1	13
OG0002744	2	5	2	1	1	1	1	13
OG0002745	1	3	2	1	2	2	2	13
OG0002746	13	0	0	0	0	0	0	13
OG0002747	2	4	2	2	0	2	1	13
OG0002748	4	4	1	1	1	1	1	13
OG0002749	3	4	1	1	1	2	1	13
OG0002750	2	5	1	1	2	1	1	13
OG0002751	13	0	0	0	0	0	0	13
OG0002752	2	5	1	1	1	1	2	13
OG0002753	2	6	1	2	1	1	0	13
OG0002754	13	0	0	0	0	0	0	13
OG0002755	2	6	1	1	1	1	1	13
OG0002756	1	7	1	1	1	1	1	13
OG0002757	5	3	1	1	0	2	1	13
OG0002758	13	0	0	0	0	0	0	13
OG0002759	2	3	3	1	0	0	4	13
OG0002760	4	3	1	1	1	1	2	13
OG0002761	3	3	1	3	1	1	1	13
OG0002762	2	6	1	1	1	1	1	13
OG0002763	4	7	1	0	0	0	1	13
OG0002764	7	0	2	1	1	1	1	13
OG0002765	4	4	1	1	1	1	1	13
OG0002766	4	4	1	1	1	1	1	13
OG0002767	3	4	1	1	2	1	1	13
OG0002768	5	0	0	1	1	1	5	13
OG0002769	4	4	1	1	1	1	1	13
OG0002770	2	4	2	1	2	1	1	13
OG0002771	2	2	2	2	2	1	2	13
OG0002772	2	6	1	1	1	1	1	13
OG0002773	13	0	0	0	0	0	0	13
OG0002774	2	4	2	1	1	2	1	13
OG0002775	2	5	1	1	2	1	1	13
OG0002776	1	3	2	2	2	1	2	13
OG0002777	6	2	1	1	1	1	1	13
OG0002778	2	6	1	1	1	1	1	13
OG0002779	3	5	1	1	1	1	1	13
OG0002780	2	5	1	1	2	1	1	13
OG0002781	2	4	1	1	1	1	3	13
OG0002782	4	4	1	1	1	1	1	13
OG0002783	2	6	1	1	1	1	1	13
OG0002784	2	4	1	1	1	2	2	13
OG0002785	6	1	2	1	0	0	3	13
OG0002786	2	2	2	2	2	2	1	13
OG0002787	4	4	1	1	1	1	1	13
OG0002788	3	5	1	1	1	1	1	13
OG0002789	3	5	1	1	1	1	1	13
OG0002790	2	5	1	1	2	1	1	13
OG0002791	3	4	1	1	1	2	1	13
OG0002792	2	1	2	2	2	2	2	13
OG0002793	13	0	0	0	0	0	0	13
OG0002794	13	0	0	0	0	0	0	13
OG0002795	5	3	1	1	1	1	1	13
OG0002796	1	3	2	2	1	2	2	13
OG0002797	2	6	1	1	1	1	1	13
OG0002798	2	5	1	1	1	1	2	13
OG0002799	3	3	1	2	1	1	2	13
OG0002800	4	3	1	2	1	1	1	13
OG0002801	4	4	1	1	1	1	1	13
OG0002802	2	5	1	2	1	1	1	13
OG0002803	5	3	1	1	1	1	1	13
OG0002804	4	4	1	1	1	1	1	13
OG0002805	6	2	1	1	1	1	1	13
OG0002806	3	5	1	1	1	1	1	13
OG0002807	2	6	1	1	1	1	1	13
OG0002808	4	3	1	1	1	1	2	13
OG0002809	2	5	1	1	1	1	2	13
OG0002810	2	1	3	2	3	2	0	13
OG0002811	3	5	1	1	1	1	1	13
OG0002812	2	5	1	1	1	2	1	13
OG0002813	2	4	1	1	1	1	3	13
OG0002814	2	1	1	2	2	3	2	13
OG0002815	3	4	1	1	1	1	2	13
OG0002816	1	4	1	2	2	1	2	13
OG0002817	2	4	1	1	1	2	2	13
OG0002818	2	6	1	1	1	1	1	13
OG0002819	2	3	2	2	1	2	1	13
OG0002820	3	4	1	1	1	1	2	13
OG0002821	4	3	1	1	1	1	2	13
OG0002822	2	6	1	1	1	1	1	13
OG0002823	2	5	1	2	1	1	1	13
OG0002824	2	5	1	1	1	1	2	13
OG0002825	3	6	1	1	1	1	0	13
OG0002826	2	3	2	1	1	2	2	13
OG0002827	4	4	1	1	1	1	1	13
OG0002828	2	3	2	1	2	2	1	13
OG0002829	2	3	1	2	2	1	2	13
OG0002830	1	0	0	2	2	3	5	13
OG0002831	4	4	1	1	1	1	1	13
OG0002832	13	0	0	0	0	0	0	13
OG0002833	2	5	1	2	1	1	1	13
OG0002834	4	4	1	1	1	1	1	13
OG0002835	2	3	1	2	2	1	2	13
OG0002836	4	3	1	1	1	2	1	13
OG0002837	3	3	1	1	1	2	2	13
OG0002838	4	5	0	1	1	2	0	13
OG0002839	4	3	1	1	1	1	2	13
OG0002840	3	3	1	2	1	1	2	13
OG0002841	2	6	1	1	1	1	1	13
OG0002842	4	4	1	1	1	1	1	13
OG0002843	4	4	1	1	1	1	1	13
OG0002844	4	3	2	1	1	1	1	13
OG0002845	2	6	1	1	2	0	1	13
OG0002846	2	1	1	3	1	2	3	13
OG0002847	4	4	1	1	1	1	1	13
OG0002848	6	2	1	1	1	1	1	13
OG0002849	2	0	1	1	3	4	2	13
OG0002850	3	3	1	1	1	2	2	13
OG0002851	1	6	1	1	1	2	1	13
OG0002852	2	6	2	1	1	1	0	13
OG0002853	1	5	1	1	2	2	1	13
OG0002854	9	4	0	0	0	0	0	13
OG0002855	1	4	2	2	2	0	2	13
OG0002856	3	5	1	1	1	1	1	13
OG0002857	1	3	2	2	2	2	1	13
OG0002858	3	5	1	1	1	1	1	13
OG0002859	2	6	1	1	1	1	1	13
OG0002860	2	4	1	3	1	1	1	13
OG0002861	5	3	1	1	1	1	1	13
OG0002862	2	6	1	1	1	1	1	13
OG0002863	2	5	1	2	1	1	1	13
OG0002864	4	3	1	1	0	2	2	13
OG0002865	2	4	1	2	1	2	1	13
OG0002866	1	6	1	1	1	1	2	13
OG0002867	4	4	1	1	1	1	1	13
OG0002868	1	3	3	1	1	2	2	13
OG0002869	2	4	1	1	1	2	2	13
OG0002870	2	6	1	2	1	0	1	13
OG0002871	5	3	1	1	1	1	1	13
OG0002872	3	4	1	1	2	1	1	13
OG0002873	2	4	1	1	3	1	1	13
OG0002874	2	5	1	1	1	2	1	13
OG0002875	2	5	1	1	2	0	2	13
OG0002876	2	3	2	2	2	1	1	13
OG0002877	3	4	1	1	1	1	2	13
OG0002878	2	5	2	1	1	1	1	13
OG0002879	3	5	1	1	1	1	1	13
OG0002880	3	4	1	2	1	1	1	13
OG0002881	2	4	1	1	2	2	1	13
OG0002882	4	4	1	1	1	1	1	13
OG0002883	4	3	1	2	1	1	1	13
OG0002884	3	4	1	1	1	1	2	13
OG0002885	4	4	1	1	1	1	1	13
OG0002886	2	4	2	2	1	1	1	13
OG0002887	2	7	1	1	1	0	1	13
OG0002888	1	7	1	1	1	1	1	13
OG0002889	2	4	2	1	1	2	1	13
OG0002890	5	5	1	1	1	0	0	13
OG0002891	2	4	1	2	1	1	2	13
OG0002892	2	6	1	1	1	1	1	13
OG0002893	4	4	1	1	1	1	1	13
OG0002894	2	4	1	1	2	2	1	13
OG0002895	3	5	1	1	1	1	1	13
OG0002896	2	5	2	0	2	2	0	13
OG0002897	2	6	1	1	1	1	1	13
OG0002898	2	3	1	2	2	1	2	13
OG0002899	2	5	1	1	1	2	1	13
OG0002900	4	3	2	1	1	1	1	13
OG0002901	3	5	1	1	1	1	1	13
OG0002902	3	4	3	0	1	1	1	13
OG0002903	6	2	1	1	1	1	1	13
OG0002904	4	2	1	1	1	1	3	13
OG0002905	3	0	5	2	1	2	0	13
OG0002906	1	5	1	1	1	2	2	13
OG0002907	2	7	2	1	0	0	1	13
OG0002908	3	4	1	1	1	1	2	13
OG0002909	1	7	1	1	1	1	1	13
OG0002910	2	5	1	1	1	2	1	13
OG0002911	2	5	1	1	1	1	2	13
OG0002912	3	4	1	1	1	2	1	13
OG0002913	2	6	1	1	1	1	1	13
OG0002914	1	2	3	2	1	2	2	13
OG0002915	2	5	1	1	2	1	1	13
OG0002916	1	6	1	2	1	1	1	13
OG0002917	4	4	1	1	1	1	1	13
OG0002918	4	4	1	1	1	1	1	13
OG0002919	5	3	1	1	1	1	1	13
OG0002920	3	5	1	1	1	1	1	13
OG0002921	2	4	1	1	1	3	1	13
OG0002922	2	6	1	1	1	1	1	13
OG0002923	2	5	1	1	2	1	1	13
OG0002924	4	0	2	3	2	2	0	13
OG0002925	1	10	1	0	0	0	1	13
OG0002926	1	4	1	2	1	2	2	13
OG0002927	2	8	0	0	2	0	1	13
OG0002928	5	2	1	1	1	2	1	13
OG0002929	1	3	2	1	2	2	2	13
OG0002930	4	4	1	1	1	1	1	13
OG0002931	3	2	2	1	2	1	2	13
OG0002932	2	5	1	1	1	1	2	13
OG0002933	2	6	1	1	1	1	1	13
OG0002934	1	7	1	1	1	1	1	13
OG0002935	3	2	1	1	2	2	2	13
OG0002936	3	3	1	1	1	2	2	13
OG0002937	2	5	1	1	1	1	2	13
OG0002938	1	4	2	2	2	1	1	13
OG0002939	2	2	2	1	2	2	2	13
OG0002940	2	5	1	1	2	1	1	13
OG0002941	3	2	1	2	2	2	1	13
OG0002942	2	5	1	1	1	1	2	13
OG0002943	5	3	1	1	1	1	1	13
OG0002944	1	5	1	2	2	1	1	13
OG0002945	2	3	2	1	2	2	1	13
OG0002946	9	0	0	0	1	2	1	13
OG0002947	4	4	1	1	1	1	1	13
OG0002948	1	0	10	0	0	0	2	13
OG0002949	2	5	1	1	2	1	1	13
OG0002950	3	4	1	1	1	1	2	13
OG0002951	2	6	1	1	1	1	1	13
OG0002952	1	5	1	1	1	2	2	13
OG0002953	2	4	1	1	3	1	1	13
OG0002954	3	4	1	1	1	2	1	13
OG0002955	3	4	2	1	1	1	1	13
OG0002956	3	5	1	1	1	1	1	13
OG0002957	2	5	1	1	2	1	1	13
OG0002958	2	2	2	2	1	2	2	13
OG0002959	2	4	1	1	1	2	2	13
OG0002960	2	0	2	2	2	3	2	13
OG0002961	3	5	1	1	1	1	1	13
OG0002962	2	5	1	1	1	1	2	13
OG0002963	2	3	2	1	2	1	2	13
OG0002964	3	4	1	2	1	1	1	13
OG0002965	1	7	1	1	1	1	1	13
OG0002966	2	4	1	1	1	2	2	13
OG0002967	4	5	2	1	1	0	0	13
OG0002968	4	4	1	1	1	1	1	13
OG0002969	2	4	2	1	1	1	2	13
OG0002970	1	4	2	1	2	1	2	13
OG0002971	4	4	1	1	1	1	1	13
OG0002972	3	5	1	1	1	1	1	13
OG0002973	5	3	2	1	0	0	2	13
OG0002974	3	3	1	1	1	2	2	13
OG0002975	5	3	1	1	1	1	1	13
OG0002976	1	6	1	2	1	1	1	13
OG0002977	2	6	1	1	1	1	1	13
OG0002978	2	5	2	1	1	1	1	13
OG0002979	1	6	1	0	3	1	1	13
OG0002980	3	5	1	1	1	1	1	13
OG0002981	2	5	2	1	1	1	1	13
OG0002982	2	3	1	4	1	1	1	13
OG0002983	2	4	1	1	0	1	4	13
OG0002984	3	2	1	1	2	2	2	13
OG0002985	3	5	1	1	1	1	1	13
OG0002986	1	5	2	2	1	1	1	13
OG0002987	3	3	1	1	1	2	2	13
OG0002988	3	4	1	1	2	1	1	13
OG0002989	4	4	1	1	1	1	1	13
OG0002990	2	6	1	1	1	1	1	13
OG0002991	1	7	1	1	1	1	1	13
OG0002992	4	3	1	1	1	2	1	13
OG0002993	2	4	2	1	0	1	3	13
OG0002994	3	5	1	1	1	1	1	13
OG0002995	3	5	1	1	1	1	1	13
OG0002996	2	5	2	1	1	1	1	13
OG0002997	3	5	1	1	1	1	1	13
OG0002998	2	8	1	1	1	0	0	13
OG0002999	4	2	2	1	1	1	2	13
OG0003000	5	3	1	1	1	1	1	13
OG0003001	2	6	1	2	1	1	0	13
OG0003002	3	5	1	1	1	1	1	13
OG0003003	2	7	1	1	1	0	1	13
OG0003004	3	5	1	1	1	1	1	13
OG0003005	2	4	1	2	1	1	2	13
OG0003006	3	4	1	1	2	1	1	13
OG0003007	1	4	1	1	1	3	2	13
OG0003008	2	5	1	1	1	1	2	13
OG0003009	2	1	2	2	2	2	2	13
OG0003010	3	5	1	1	1	1	1	13
OG0003011	1	4	1	3	1	2	1	13
OG0003012	2	5	1	1	2	1	1	13
OG0003013	2	5	1	1	1	1	2	13
OG0003014	1	6	1	2	1	1	1	13
OG0003015	2	6	1	1	1	1	1	13
OG0003016	2	4	3	1	1	1	1	13
OG0003017	2	4	2	2	1	1	1	13
OG0003018	3	5	2	2	0	1	0	13
OG0003019	3	4	2	1	1	1	1	13
OG0003020	2	5	1	1	1	2	1	13
OG0003021	3	5	1	1	1	1	1	13
OG0003022	1	4	1	1	2	2	2	13
OG0003023	3	8	0	1	1	0	0	13
OG0003024	3	3	1	1	1	1	3	13
OG0003025	2	6	1	1	1	1	1	13
OG0003026	3	5	1	1	1	1	1	13
OG0003027	2	5	1	1	2	1	1	13
OG0003028	6	3	1	0	1	1	1	13
OG0003029	2	6	1	1	1	1	1	13
OG0003030	2	6	1	1	1	1	1	13
OG0003031	2	6	1	1	1	1	1	13
OG0003032	2	5	1	1	1	2	1	13
OG0003033	3	5	1	1	1	1	1	13
OG0003034	2	4	1	3	1	1	1	13
OG0003035	2	4	1	1	1	2	2	13
OG0003036	3	5	1	1	1	1	1	13
OG0003037	3	2	1	1	1	4	1	13
OG0003038	3	3	1	1	1	2	2	13
OG0003039	2	2	2	2	2	2	1	13
OG0003040	2	4	1	2	2	1	1	13
OG0003041	3	4	2	1	1	1	1	13
OG0003042	3	5	1	1	1	1	1	13
OG0003043	2	5	1	1	1	2	1	13
OG0003044	1	5	3	1	1	1	1	13
OG0003045	2	5	1	1	1	2	1	13
OG0003046	5	3	1	1	1	1	1	13
OG0003047	2	5	1	1	1	1	2	13
OG0003048	1	6	1	1	2	1	1	13
OG0003049	2	5	1	3	1	1	0	13
OG0003050	4	4	1	1	1	1	1	13
OG0003051	2	7	1	0	1	1	1	13
OG0003052	2	4	2	2	1	1	1	13
OG0003053	2	3	2	2	1	1	2	13
OG0003054	5	0	1	2	2	1	2	13
OG0003055	4	4	1	1	1	1	1	13
OG0003056	2	6	1	1	1	1	1	13
OG0003057	2	5	1	1	1	1	2	13
OG0003058	2	3	1	1	2	2	2	13
OG0003059	2	4	1	1	2	2	1	13
OG0003060	2	4	1	1	1	1	3	13
OG0003061	2	6	1	1	1	1	1	13
OG0003062	3	2	2	1	2	1	2	13
OG0003063	1	4	1	1	2	2	2	13
OG0003064	1	5	2	1	1	2	1	13
OG0003065	2	5	1	1	2	1	1	13
OG0003066	1	2	2	2	2	2	2	13
OG0003067	2	6	1	1	1	1	1	13
OG0003068	3	5	1	1	1	1	1	13
OG0003069	3	2	2	1	1	2	2	13
OG0003070	2	5	1	1	1	1	2	13
OG0003071	1	3	2	2	1	2	2	13
OG0003072	4	4	1	1	1	1	1	13
OG0003073	2	6	1	1	1	1	1	13
OG0003074	2	4	1	1	1	2	2	13
OG0003075	2	5	2	1	1	1	1	13
OG0003076	3	4	1	1	1	1	2	13
OG0003077	2	3	1	2	2	1	2	13
OG0003078	2	3	2	2	1	2	1	13
OG0003079	1	2	5	0	0	0	5	13
OG0003080	2	4	1	1	1	1	3	13
OG0003081	2	6	1	1	1	1	1	13
OG0003082	2	5	1	2	1	1	1	13
OG0003083	2	3	1	1	2	2	2	13
OG0003084	2	4	2	2	1	1	1	13
OG0003085	1	4	1	1	1	3	2	13
OG0003086	1	4	3	1	1	1	2	13
OG0003087	3	5	1	1	1	1	1	13
OG0003088	2	2	2	2	2	2	1	13
OG0003089	3	4	1	1	1	1	2	13
OG0003090	2	6	1	1	1	1	1	13
OG0003091	3	5	1	1	1	1	1	13
OG0003092	2	5	2	1	1	1	1	13
OG0003093	3	6	1	1	1	1	0	13
OG0003094	1	6	1	2	2	0	1	13
OG0003095	1	3	1	2	2	2	2	13
OG0003096	3	5	1	1	1	1	1	13
OG0003097	2	4	2	1	1	2	1	13
OG0003098	2	5	2	1	1	1	1	13
OG0003099	2	5	1	2	1	1	1	13
OG0003100	2	5	1	1	2	1	1	13
OG0003101	2	4	1	1	2	1	2	13
OG0003102	3	4	1	1	1	1	2	13
OG0003103	2	5	2	1	1	1	1	13
OG0003104	2	4	2	1	2	1	1	13
OG0003105	2	5	1	1	0	1	3	13
OG0003106	2	4	2	1	2	1	1	13
OG0003107	2	5	2	1	1	1	1	13
OG0003108	2	3	1	2	2	2	1	13
OG0003109	1	6	1	1	2	1	1	13
OG0003110	1	3	2	2	2	2	1	13
OG0003111	3	4	1	1	2	1	1	13
OG0003112	1	6	2	0	2	1	1	13
OG0003113	1	4	2	1	2	2	1	13
OG0003114	2	5	3	0	3	0	0	13
OG0003115	2	4	2	1	1	1	2	13
OG0003116	2	6	1	1	1	1	1	13
OG0003117	1	6	1	1	2	1	1	13
OG0003118	1	3	1	2	2	2	2	13
OG0003119	2	5	1	1	2	1	1	13
OG0003120	1	4	2	2	2	1	1	13
OG0003121	2	5	1	2	1	1	1	13
OG0003122	2	5	1	1	2	1	1	13
OG0003123	1	9	2	1	0	0	0	13
OG0003124	1	3	1	2	2	2	2	13
OG0003125	2	6	1	1	1	1	1	13
OG0003126	1	3	2	2	1	2	2	13
OG0003127	1	6	1	1	1	1	2	13
OG0003128	1	5	0	1	2	1	3	13
OG0003129	2	2	2	2	2	1	2	13
OG0003130	3	3	2	1	1	1	2	13
OG0003131	1	6	1	2	1	1	1	13
OG0003132	1	7	1	1	1	1	1	13
OG0003133	1	3	1	3	1	2	2	13
OG0003134	1	4	2	3	1	1	1	13
OG0003135	2	3	1	1	1	1	4	13
OG0003136	1	4	2	1	2	2	1	13
OG0003137	1	10	1	0	0	0	1	13
OG0003138	1	4	3	3	0	0	2	13
OG0003139	2	4	1	1	1	1	3	13
OG0003140	1	6	1	1	1	1	2	13
OG0003141	1	6	1	1	2	1	1	13
OG0003142	1	6	2	1	1	1	1	13
OG0003143	1	3	2	2	1	2	2	13
OG0003144	2	4	1	1	1	2	2	13
OG0003145	2	2	5	1	1	1	1	13
OG0003146	1	6	1	2	1	1	1	13
OG0003147	1	6	1	1	2	1	1	13
OG0003148	2	2	1	2	3	1	2	13
OG0003149	1	4	2	2	1	1	2	13
OG0003150	2	3	3	1	1	1	2	13
OG0003151	1	4	1	1	2	2	2	13
OG0003152	1	6	1	1	2	1	1	13
OG0003153	1	11	0	0	0	1	0	13
OG0003154	1	6	1	1	1	1	2	13
OG0003155	1	6	1	1	1	0	3	13
OG0003156	1	6	1	2	1	1	1	13
OG0003157	1	3	2	2	1	2	2	13
OG0003158	2	3	1	1	4	1	1	13
OG0003159	1	3	2	1	1	1	4	13
OG0003160	1	5	3	2	1	0	1	13
OG0003161	2	6	1	1	1	1	1	13
OG0003162	1	3	2	2	1	2	2	13
OG0003163	2	4	2	1	2	1	1	13
OG0003164	1	6	1	1	1	1	2	13
OG0003165	1	4	2	2	1	1	2	13
OG0003166	1	4	2	0	1	0	5	13
OG0003167	1	6	1	1	2	1	1	13
OG0003168	1	5	2	2	1	1	1	13
OG0003169	1	4	1	1	2	2	2	13
OG0003170	1	6	1	1	2	1	1	13
OG0003171	0	9	0	3	0	0	1	13
OG0003172	0	5	1	0	4	1	2	13
OG0003173	0	13	0	0	0	0	0	13
OG0003174	0	5	1	1	2	1	3	13
OG0003175	0	9	1	1	1	1	0	13
OG0003176	0	6	0	1	1	2	3	13
OG0003177	0	5	1	1	0	2	4	13
OG0003178	0	13	0	0	0	0	0	13
OG0003179	0	7	0	3	1	1	1	13
OG0003180	0	8	1	1	3	0	0	13
OG0003181	0	13	0	0	0	0	0	13
OG0003182	0	13	0	0	0	0	0	13
OG0003183	0	4	1	2	4	1	1	13
OG0003184	0	1	0	1	0	0	11	13
OG0003185	0	6	2	0	0	0	5	13
OG0003186	0	12	0	0	1	0	0	13
OG0003187	0	8	1	0	2	1	1	13
OG0003188	0	11	1	0	0	0	1	13
OG0003189	0	7	0	1	0	2	3	13
OG0003190	0	3	1	1	1	2	5	13
OG0003191	0	4	2	1	2	2	2	13
OG0003192	0	8	2	0	0	0	3	13
OG0003193	0	13	0	0	0	0	0	13
OG0003194	0	4	1	1	2	2	3	13
OG0003195	0	6	1	0	1	1	4	13
OG0003196	0	13	0	0	0	0	0	13
OG0003197	0	6	1	1	2	2	1	13
OG0003198	0	6	1	2	1	2	1	13
OG0003199	0	6	0	2	0	3	2	13
OG0003200	0	4	1	1	1	2	4	13
OG0003201	0	3	0	3	1	2	4	13
OG0003202	0	7	1	2	1	1	1	13
OG0003203	0	6	2	1	2	1	1	13
OG0003204	0	7	0	3	1	1	1	13
OG0003205	0	5	0	0	0	4	4	13
OG0003206	0	13	0	0	0	0	0	13
OG0003207	0	3	2	2	2	2	2	13
OG0003208	0	5	2	2	1	1	2	13
OG0003209	0	8	0	1	1	1	2	13
OG0003210	0	5	1	2	2	0	3	13
OG0003211	0	4	4	1	1	1	2	13
OG0003212	0	5	1	2	2	2	1	13
OG0003213	0	3	2	2	2	2	2	13
OG0003214	0	5	0	1	5	1	1	13
OG0003215	0	6	1	1	1	3	1	13
OG0003216	0	7	2	2	0	1	1	13
OG0003217	0	8	2	3	0	0	0	13
OG0003218	0	7	1	3	0	1	1	13
OG0003219	0	5	2	2	2	1	1	13
OG0003220	0	6	1	3	1	1	1	13
OG0003221	0	2	1	0	2	0	8	13
OG0003222	0	4	1	1	1	2	4	13
OG0003223	0	11	0	1	1	0	0	13
OG0003224	0	5	3	1	2	1	1	13
OG0003225	0	6	0	1	2	2	2	13
OG0003226	0	5	2	2	2	1	1	13
OG0003227	0	8	0	2	1	1	1	13
OG0003228	0	5	1	2	2	1	2	13
OG0003229	0	5	1	1	4	0	2	13
OG0003230	0	9	1	1	1	0	1	13
OG0003231	0	7	1	2	1	1	1	13
OG0003232	0	5	1	2	2	2	1	13
OG0003233	0	6	2	1	2	1	1	13
OG0003234	0	8	0	2	1	1	1	13
OG0003235	0	6	1	1	2	1	2	13
OG0003236	0	5	0	1	1	3	3	13
OG0003237	0	5	2	1	2	0	3	13
OG0003238	0	3	2	2	2	3	1	13
OG0003239	0	4	1	2	2	2	2	13
OG0003240	0	4	3	2	2	1	1	13
OG0003241	0	5	2	2	1	1	2	13
OG0003242	0	3	5	2	1	1	1	13
OG0003243	0	4	1	2	2	3	1	13
OG0003244	0	6	1	2	1	1	2	13
OG0003245	0	7	0	3	3	0	0	13
OG0003246	0	2	2	1	0	2	6	13
OG0003247	0	4	2	1	0	4	2	13
OG0003248	0	2	0	3	0	8	0	13
OG0003249	0	1	1	0	2	0	9	13
OG0003250	0	3	2	2	2	1	3	13
OG0003251	0	5	2	2	1	2	1	13
OG0003252	0	3	2	2	2	2	2	13
OG0003253	0	2	1	0	2	5	3	13
OG0003254	0	0	1	0	0	0	12	13
OG0003255	0	0	1	0	0	2	10	13
OG0003256	0	0	0	1	0	3	9	13
OG0003257	0	0	0	0	0	0	13	13
OG0003258	4	3	1	1	1	1	1	12
OG0003259	2	5	1	1	1	1	1	12
OG0003260	3	3	2	1	1	1	1	12
OG0003261	7	0	1	1	1	1	1	12
OG0003262	1	4	1	2	2	1	1	12
OG0003263	3	4	1	1	1	1	1	12
OG0003264	6	2	2	0	0	1	1	12
OG0003265	4	3	1	1	1	1	1	12
OG0003266	3	4	1	1	1	1	1	12
OG0003267	2	5	1	1	1	1	1	12
OG0003268	2	4	2	1	1	1	1	12
OG0003269	2	4	2	1	1	1	1	12
OG0003270	2	5	1	1	1	1	1	12
OG0003271	2	4	1	1	1	1	2	12
OG0003272	2	5	1	1	1	1	1	12
OG0003273	4	3	1	1	1	1	1	12
OG0003274	3	4	1	1	1	1	1	12
OG0003275	3	5	1	1	1	0	1	12
OG0003276	2	4	1	1	1	1	2	12
OG0003277	5	2	1	1	1	1	1	12
OG0003278	5	3	1	1	1	1	0	12
OG0003279	2	5	1	1	1	1	1	12
OG0003280	12	0	0	0	0	0	0	12
OG0003281	12	0	0	0	0	0	0	12
OG0003282	2	1	2	2	1	2	2	12
OG0003283	2	4	1	1	1	2	1	12
OG0003284	4	3	1	1	2	1	0	12
OG0003285	3	4	1	1	1	1	1	12
OG0003286	3	2	2	1	2	1	1	12
OG0003287	1	4	2	2	2	0	1	12
OG0003288	2	5	1	1	1	1	1	12
OG0003289	2	4	2	1	1	1	1	12
OG0003290	3	4	1	1	1	1	1	12
OG0003291	1	2	1	4	0	2	2	12
OG0003292	2	2	1	1	2	2	2	12
OG0003293	2	2	2	2	2	1	1	12
OG0003294	2	5	1	1	1	1	1	12
OG0003295	1	5	1	1	1	1	2	12
OG0003296	2	4	2	1	1	1	1	12
OG0003297	1	6	1	1	1	1	1	12
OG0003298	2	3	2	1	1	2	1	12
OG0003299	2	4	2	1	1	1	1	12
OG0003300	2	5	1	1	1	1	1	12
OG0003301	2	5	1	1	1	1	1	12
OG0003302	1	4	1	2	1	1	2	12
OG0003303	1	7	2	1	0	0	1	12
OG0003304	11	0	0	0	0	0	1	12
OG0003305	2	4	1	1	1	2	1	12
OG0003306	2	4	1	1	1	1	2	12
OG0003307	2	4	1	1	2	1	1	12
OG0003308	3	5	1	1	0	1	1	12
OG0003309	4	3	1	1	1	1	1	12
OG0003310	3	2	2	1	1	1	2	12
OG0003311	2	3	2	1	2	1	1	12
OG0003312	3	4	1	1	1	1	1	12
OG0003313	6	2	1	1	0	1	1	12
OG0003314	2	5	1	1	1	1	1	12
OG0003315	12	0	0	0	0	0	0	12
OG0003316	3	4	1	1	1	1	1	12
OG0003317	4	6	1	0	0	0	1	12
OG0003318	2	5	1	1	1	1	1	12
OG0003319	6	4	1	1	0	0	0	12
OG0003320	2	4	2	1	1	1	1	12
OG0003321	2	5	1	1	1	1	1	12
OG0003322	4	4	1	0	1	1	1	12
OG0003323	4	7	0	1	0	0	0	12
OG0003324	1	3	1	1	2	2	2	12
OG0003325	2	1	2	1	2	2	2	12
OG0003326	4	4	1	1	1	0	1	12
OG0003327	1	5	0	2	2	1	1	12
OG0003328	2	3	1	1	1	1	3	12
OG0003329	2	5	1	1	1	1	1	12
OG0003330	3	4	1	1	1	2	0	12
OG0003331	2	4	1	2	1	1	1	12
OG0003332	2	5	1	1	1	1	1	12
OG0003333	2	3	1	1	2	1	2	12
OG0003334	3	3	1	2	1	1	1	12
OG0003335	3	6	1	0	1	0	1	12
OG0003336	2	4	1	1	1	1	2	12
OG0003337	2	5	1	1	1	1	1	12
OG0003338	2	4	1	1	2	1	1	12
OG0003339	3	4	1	1	1	1	1	12
OG0003340	2	5	1	1	1	1	1	12
OG0003341	3	4	1	1	1	1	1	12
OG0003342	2	4	1	2	1	1	1	12
OG0003343	2	2	2	1	2	1	2	12
OG0003344	12	0	0	0	0	0	0	12
OG0003345	1	6	0	2	1	1	1	12
OG0003346	3	4	1	1	1	1	1	12
OG0003347	2	3	1	1	2	1	2	12
OG0003348	2	5	1	1	1	1	1	12
OG0003349	3	4	1	1	1	1	1	12
OG0003350	3	5	0	1	1	1	1	12
OG0003351	4	1	1	1	1	2	2	12
OG0003352	3	4	1	1	1	1	1	12
OG0003353	3	4	1	1	1	1	1	12
OG0003354	4	3	1	1	1	1	1	12
OG0003355	2	4	1	1	1	2	1	12
OG0003356	2	3	1	2	1	2	1	12
OG0003357	2	5	1	1	1	1	1	12
OG0003358	4	3	1	1	1	1	1	12
OG0003359	1	5	2	1	1	1	1	12
OG0003360	2	5	1	1	1	1	1	12
OG0003361	3	4	1	1	1	1	1	12
OG0003362	2	5	1	1	1	1	1	12
OG0003363	2	3	2	2	1	1	1	12
OG0003364	3	4	1	1	1	1	1	12
OG0003365	3	4	1	1	1	1	1	12
OG0003366	2	4	1	1	1	2	1	12
OG0003367	5	2	1	1	1	1	1	12
OG0003368	2	4	1	1	1	1	2	12
OG0003369	2	4	2	1	1	1	1	12
OG0003370	2	2	4	1	1	1	1	12
OG0003371	10	0	2	0	0	0	0	12
OG0003372	2	4	1	1	1	2	1	12
OG0003373	2	5	1	1	1	1	1	12
OG0003374	4	3	1	1	1	1	1	12
OG0003375	2	5	1	1	1	1	1	12
OG0003376	2	5	1	1	1	1	1	12
OG0003377	2	5	1	1	1	1	1	12
OG0003378	3	4	1	1	1	1	1	12
OG0003379	2	5	1	1	1	1	1	12
OG0003380	3	4	1	1	1	1	1	12
OG0003381	3	4	1	1	1	1	1	12
OG0003382	12	0	0	0	0	0	0	12
OG0003383	2	2	2	2	1	1	2	12
OG0003384	3	4	1	1	1	1	1	12
OG0003385	2	4	1	1	1	1	2	12
OG0003386	4	2	1	1	1	2	1	12
OG0003387	4	3	1	1	1	1	1	12
OG0003388	2	5	1	1	1	1	1	12
OG0003389	2	5	1	1	1	1	1	12
OG0003390	2	5	1	1	1	1	1	12
OG0003391	3	4	1	1	1	1	1	12
OG0003392	3	4	1	1	1	1	1	12
OG0003393	4	3	1	1	1	1	1	12
OG0003394	2	3	1	1	1	2	2	12
OG0003395	2	4	2	1	1	1	1	12
OG0003396	2	4	1	1	1	2	1	12
OG0003397	1	10	1	0	0	0	0	12
OG0003398	2	5	1	1	1	1	1	12
OG0003399	2	4	1	2	1	1	1	12
OG0003400	2	4	1	1	1	1	2	12
OG0003401	2	5	1	1	1	1	1	12
OG0003402	3	4	1	1	1	1	1	12
OG0003403	1	5	1	1	1	1	2	12
OG0003404	1	4	1	1	2	1	2	12
OG0003405	4	5	2	0	0	0	1	12
OG0003406	2	5	1	1	1	1	1	12
OG0003407	2	5	1	1	1	1	1	12
OG0003408	1	4	1	0	2	2	2	12
OG0003409	2	3	1	1	1	2	2	12
OG0003410	4	3	1	1	1	1	1	12
OG0003411	3	4	1	1	1	1	1	12
OG0003412	12	0	0	0	0	0	0	12
OG0003413	3	4	1	1	1	1	1	12
OG0003414	2	4	1	1	1	1	2	12
OG0003415	1	5	1	0	1	1	3	12
OG0003416	3	3	1	2	1	1	1	12
OG0003417	3	4	1	1	1	1	1	12
OG0003418	1	3	2	2	2	1	1	12
OG0003419	4	3	1	1	1	1	1	12
OG0003420	2	5	1	1	1	1	1	12
OG0003421	2	5	1	1	1	1	1	12
OG0003422	2	5	1	1	1	1	1	12
OG0003423	2	5	1	1	1	1	1	12
OG0003424	2	5	1	1	1	1	1	12
OG0003425	3	4	1	1	1	1	1	12
OG0003426	3	4	1	1	1	1	1	12
OG0003427	4	2	2	1	1	1	1	12
OG0003428	2	5	1	1	1	1	1	12
OG0003429	2	5	1	1	1	1	1	12
OG0003430	2	5	1	1	1	1	1	12
OG0003431	3	4	1	1	1	1	1	12
OG0003432	3	4	1	1	1	1	1	12
OG0003433	7	3	0	0	0	0	2	12
OG0003434	2	5	1	1	1	1	1	12
OG0003435	2	2	1	1	2	2	2	12
OG0003436	4	3	1	1	1	1	1	12
OG0003437	2	4	1	1	1	1	2	12
OG0003438	3	4	1	1	1	1	1	12
OG0003439	2	4	1	1	1	1	2	12
OG0003440	2	3	1	1	1	1	3	12
OG0003441	3	2	2	1	1	2	1	12
OG0003442	4	2	1	1	1	2	1	12
OG0003443	2	5	1	1	1	0	2	12
OG0003444	2	5	1	1	1	1	1	12
OG0003445	2	4	1	2	1	1	1	12
OG0003446	2	5	1	1	1	1	1	12
OG0003447	2	3	1	1	1	2	2	12
OG0003448	5	2	1	1	1	1	1	12
OG0003449	2	6	2	1	0	0	1	12
OG0003450	2	5	1	1	1	1	1	12
OG0003451	2	4	1	2	1	1	1	12
OG0003452	2	5	1	1	1	1	1	12
OG0003453	3	4	1	1	1	1	1	12
OG0003454	3	4	1	1	1	1	1	12
OG0003455	3	4	1	1	1	1	1	12
OG0003456	3	4	1	1	1	1	1	12
OG0003457	1	5	1	2	1	1	1	12
OG0003458	2	4	1	1	1	1	2	12
OG0003459	2	3	1	2	2	1	1	12
OG0003460	4	4	1	0	1	1	1	12
OG0003461	3	3	2	1	1	0	2	12
OG0003462	12	0	0	0	0	0	0	12
OG0003463	3	4	1	1	1	1	1	12
OG0003464	2	5	1	1	1	1	1	12
OG0003465	3	4	1	1	1	1	1	12
OG0003466	2	4	2	1	1	1	1	12
OG0003467	3	3	1	1	1	2	1	12
OG0003468	2	4	1	1	1	2	1	12
OG0003469	1	2	2	2	2	2	1	12
OG0003470	2	4	2	1	1	1	1	12
OG0003471	2	4	1	2	1	1	1	12
OG0003472	3	4	1	1	1	1	1	12
OG0003473	2	3	2	1	1	1	2	12
OG0003474	1	2	1	1	3	2	2	12
OG0003475	3	3	1	1	1	2	1	12
OG0003476	2	5	1	1	1	1	1	12
OG0003477	12	0	0	0	0	0	0	12
OG0003478	2	5	1	1	1	1	1	12
OG0003479	2	5	1	1	1	1	1	12
OG0003480	2	5	1	1	1	1	1	12
OG0003481	2	3	2	2	1	1	1	12
OG0003482	3	4	1	1	1	1	1	12
OG0003483	1	3	1	3	1	0	3	12
OG0003484	3	3	1	1	1	1	2	12
OG0003485	3	4	1	1	1	1	1	12
OG0003486	1	6	1	1	1	1	1	12
OG0003487	3	4	1	1	1	1	1	12
OG0003488	2	3	1	3	1	1	1	12
OG0003489	3	3	1	1	1	2	1	12
OG0003490	2	5	1	1	1	1	1	12
OG0003491	2	5	1	1	1	1	1	12
OG0003492	1	3	1	2	1	2	2	12
OG0003493	1	3	1	2	2	2	1	12
OG0003494	2	4	1	1	1	1	2	12
OG0003495	4	3	1	1	1	1	1	12
OG0003496	2	5	1	1	1	1	1	12
OG0003497	5	2	1	1	1	1	1	12
OG0003498	2	3	3	1	1	1	1	12
OG0003499	3	5	1	0	1	1	1	12
OG0003500	2	4	1	1	1	1	2	12
OG0003501	3	4	1	1	1	1	1	12
OG0003502	3	3	1	1	2	1	1	12
OG0003503	4	3	1	1	1	1	1	12
OG0003504	2	5	1	1	1	1	1	12
OG0003505	3	4	1	1	1	1	1	12
OG0003506	2	5	1	1	1	1	1	12
OG0003507	1	6	1	1	1	1	1	12
OG0003508	2	4	1	1	1	1	2	12
OG0003509	3	3	1	2	1	1	1	12
OG0003510	5	4	0	0	3	0	0	12
OG0003511	2	4	1	1	1	1	2	12
OG0003512	3	6	1	1	1	0	0	12
OG0003513	2	5	1	1	1	1	1	12
OG0003514	3	3	1	1	1	1	2	12
OG0003515	2	5	1	1	1	1	1	12
OG0003516	2	5	1	1	1	1	1	12
OG0003517	2	5	1	1	1	1	1	12
OG0003518	2	5	1	1	1	1	1	12
OG0003519	3	3	1	1	0	2	2	12
OG0003520	1	3	2	3	1	1	1	12
OG0003521	3	4	1	1	1	1	1	12
OG0003522	1	4	2	1	1	1	2	12
OG0003523	2	5	1	1	1	1	1	12
OG0003524	2	3	2	1	1	1	2	12
OG0003525	4	3	1	1	1	1	1	12
OG0003526	2	4	2	1	1	1	1	12
OG0003527	2	6	1	1	1	1	0	12
OG0003528	2	3	2	1	2	1	1	12
OG0003529	2	4	1	1	1	2	1	12
OG0003530	2	5	1	1	2	0	1	12
OG0003531	2	4	1	1	1	1	2	12
OG0003532	2	5	1	1	1	1	1	12
OG0003533	3	3	1	1	1	2	1	12
OG0003534	3	4	1	1	1	1	1	12
OG0003535	3	3	1	1	1	1	2	12
OG0003536	2	4	1	2	1	1	1	12
OG0003537	1	4	4	1	1	1	0	12
OG0003538	3	4	1	1	1	1	1	12
OG0003539	2	5	1	1	1	1	1	12
OG0003540	4	3	1	1	1	1	1	12
OG0003541	2	5	1	1	1	1	1	12
OG0003542	3	4	1	1	1	1	1	12
OG0003543	2	4	1	1	1	1	2	12
OG0003544	4	3	1	1	1	1	1	12
OG0003545	5	2	1	1	1	1	1	12
OG0003546	3	4	1	1	1	1	1	12
OG0003547	2	5	1	1	1	1	1	12
OG0003548	4	3	1	1	1	1	1	12
OG0003549	2	5	1	1	1	1	1	12
OG0003550	3	3	1	1	1	2	1	12
OG0003551	2	2	2	2	2	1	1	12
OG0003552	2	4	1	2	1	1	1	12
OG0003553	2	5	1	2	1	1	0	12
OG0003554	3	4	1	1	1	1	1	12
OG0003555	6	1	1	1	1	1	1	12
OG0003556	2	4	1	1	1	2	1	12
OG0003557	3	4	1	1	1	1	1	12
OG0003558	2	5	1	1	1	1	1	12
OG0003559	4	4	1	1	1	1	0	12
OG0003560	3	4	1	1	1	1	1	12
OG0003561	2	4	2	1	1	1	1	12
OG0003562	5	1	2	1	2	0	1	12
OG0003563	2	5	1	1	1	1	1	12
OG0003564	2	5	1	1	1	1	1	12
OG0003565	2	5	1	1	1	1	1	12
OG0003566	4	3	1	1	1	1	1	12
OG0003567	2	5	1	1	1	1	1	12
OG0003568	4	3	1	1	1	1	1	12
OG0003569	2	5	1	1	1	1	1	12
OG0003570	2	3	3	1	1	1	1	12
OG0003571	2	5	1	1	1	1	1	12
OG0003572	1	2	2	2	1	2	2	12
OG0003573	3	4	1	1	1	1	1	12
OG0003574	2	1	1	2	3	0	3	12
OG0003575	2	5	1	1	1	1	1	12
OG0003576	2	5	1	1	1	1	1	12
OG0003577	2	4	1	2	1	1	1	12
OG0003578	2	4	1	1	2	1	1	12
OG0003579	2	4	1	1	1	1	2	12
OG0003580	2	5	1	1	1	1	1	12
OG0003581	2	4	1	1	1	1	2	12
OG0003582	2	3	1	1	1	1	3	12
OG0003583	2	3	1	1	2	1	2	12
OG0003584	3	3	1	1	1	1	2	12
OG0003585	2	5	1	1	1	1	1	12
OG0003586	4	3	1	1	1	1	1	12
OG0003587	4	3	1	1	1	1	1	12
OG0003588	2	4	1	2	1	1	1	12
OG0003589	4	3	1	1	1	1	1	12
OG0003590	3	4	1	1	1	1	1	12
OG0003591	3	2	2	1	1	2	1	12
OG0003592	2	5	1	1	1	1	1	12
OG0003593	3	3	1	1	1	2	1	12
OG0003594	2	3	3	1	1	1	1	12
OG0003595	2	5	1	1	1	1	1	12
OG0003596	3	4	1	1	1	1	1	12
OG0003597	2	4	1	1	1	1	2	12
OG0003598	2	3	1	1	2	1	2	12
OG0003599	2	5	1	1	1	1	1	12
OG0003600	2	4	1	1	1	2	1	12
OG0003601	1	6	5	0	0	0	0	12
OG0003602	2	5	1	1	1	1	1	12
OG0003603	3	4	1	1	1	1	1	12
OG0003604	1	5	2	1	1	0	2	12
OG0003605	2	4	1	1	1	2	1	12
OG0003606	2	3	1	1	1	1	3	12
OG0003607	2	5	1	1	1	1	1	12
OG0003608	2	5	1	1	1	1	1	12
OG0003609	1	4	1	2	1	2	1	12
OG0003610	2	0	2	1	2	2	3	12
OG0003611	3	4	1	1	1	1	1	12
OG0003612	3	3	1	1	1	1	2	12
OG0003613	2	5	1	1	1	1	1	12
OG0003614	2	4	2	1	1	1	1	12
OG0003615	2	5	1	1	1	1	1	12
OG0003616	3	5	1	0	1	1	1	12
OG0003617	1	6	0	0	1	0	4	12
OG0003618	3	4	1	1	1	1	1	12
OG0003619	12	0	0	0	0	0	0	12
OG0003620	2	3	1	2	1	2	1	12
OG0003621	2	5	1	1	1	1	1	12
OG0003622	4	3	1	1	1	1	1	12
OG0003623	2	5	1	1	1	1	1	12
OG0003624	2	5	1	1	1	1	1	12
OG0003625	3	4	1	1	1	1	1	12
OG0003626	3	4	3	0	1	0	1	12
OG0003627	2	4	1	1	1	1	2	12
OG0003628	4	3	1	1	1	1	1	12
OG0003629	4	3	1	1	1	1	1	12
OG0003630	2	4	1	1	1	1	2	12
OG0003631	2	5	1	1	1	1	1	12
OG0003632	3	4	1	1	1	1	1	12
OG0003633	3	4	1	1	1	1	1	12
OG0003634	3	3	2	1	1	1	1	12
OG0003635	2	5	1	1	1	1	1	12
OG0003636	2	5	1	1	1	1	1	12
OG0003637	2	5	1	1	1	1	1	12
OG0003638	2	4	2	1	1	1	1	12
OG0003639	2	4	1	1	2	1	1	12
OG0003640	1	5	1	1	1	1	2	12
OG0003641	2	4	1	1	2	1	1	12
OG0003642	2	5	1	1	1	1	1	12
OG0003643	3	4	1	1	1	1	1	12
OG0003644	1	6	1	1	1	1	1	12
OG0003645	3	4	1	1	1	1	1	12
OG0003646	2	5	1	1	1	1	1	12
OG0003647	2	5	1	1	1	1	1	12
OG0003648	2	4	1	1	1	1	2	12
OG0003649	2	6	1	1	0	0	2	12
OG0003650	3	4	1	1	1	1	1	12
OG0003651	3	4	1	1	1	1	1	12
OG0003652	2	2	2	2	2	1	1	12
OG0003653	2	3	1	1	1	1	3	12
OG0003654	3	4	1	1	1	1	1	12
OG0003655	1	6	1	1	1	1	1	12
OG0003656	4	3	1	1	1	1	1	12
OG0003657	2	5	1	1	1	1	1	12
OG0003658	2	5	1	1	1	1	1	12
OG0003659	2	6	1	1	1	1	0	12
OG0003660	1	4	1	2	1	2	1	12
OG0003661	4	3	1	0	2	1	1	12
OG0003662	3	4	1	1	1	1	1	12
OG0003663	1	5	1	1	1	1	2	12
OG0003664	5	3	1	0	1	1	1	12
OG0003665	2	5	1	1	1	1	1	12
OG0003666	2	2	2	1	2	1	2	12
OG0003667	3	3	2	0	2	1	1	12
OG0003668	2	5	1	1	1	1	1	12
OG0003669	2	4	2	1	1	1	1	12
OG0003670	3	4	1	1	1	1	1	12
OG0003671	3	4	1	1	1	1	1	12
OG0003672	2	5	1	1	1	1	1	12
OG0003673	2	4	0	1	1	0	4	12
OG0003674	1	5	1	2	1	1	1	12
OG0003675	2	5	1	1	1	1	1	12
OG0003676	2	4	1	1	2	1	1	12
OG0003677	2	5	1	1	1	1	1	12
OG0003678	3	4	1	1	1	1	1	12
OG0003679	2	5	1	1	1	1	1	12
OG0003680	2	4	1	1	1	2	1	12
OG0003681	3	4	1	1	1	1	1	12
OG0003682	2	5	1	1	1	1	1	12
OG0003683	3	3	1	1	1	2	1	12
OG0003684	2	4	2	1	1	1	1	12
OG0003685	1	6	1	1	1	1	1	12
OG0003686	2	4	2	1	1	1	1	12
OG0003687	2	4	1	1	1	2	1	12
OG0003688	2	4	1	1	1	1	2	12
OG0003689	3	3	1	1	1	1	2	12
OG0003690	4	3	1	1	1	1	1	12
OG0003691	3	4	1	1	1	1	1	12
OG0003692	2	5	1	1	1	1	1	12
OG0003693	1	5	2	1	1	1	1	12
OG0003694	4	2	1	1	1	1	2	12
OG0003695	2	3	1	1	3	1	1	12
OG0003696	2	4	1	1	1	1	2	12
OG0003697	2	4	1	1	1	1	2	12
OG0003698	2	3	2	2	0	1	2	12
OG0003699	3	3	1	1	1	2	1	12
OG0003700	2	5	1	1	1	1	1	12
OG0003701	2	5	1	1	1	1	1	12
OG0003702	1	6	1	1	1	1	1	12
OG0003703	2	0	2	2	1	2	3	12
OG0003704	2	5	1	1	1	1	1	12
OG0003705	3	3	1	1	1	1	2	12
OG0003706	3	4	1	1	1	1	1	12
OG0003707	2	5	1	1	1	1	1	12
OG0003708	3	4	1	1	1	1	1	12
OG0003709	1	4	2	1	2	1	1	12
OG0003710	2	5	1	1	1	1	1	12
OG0003711	4	3	1	1	1	1	1	12
OG0003712	1	7	1	1	1	1	0	12
OG0003713	3	4	1	1	1	1	1	12
OG0003714	2	4	1	2	1	1	1	12
OG0003715	3	0	2	2	2	2	1	12
OG0003716	3	4	1	1	1	1	1	12
OG0003717	4	3	1	1	1	1	1	12
OG0003718	2	4	1	1	2	1	1	12
OG0003719	2	4	2	1	1	1	1	12
OG0003720	2	5	1	1	1	1	1	12
OG0003721	3	3	2	1	1	1	1	12
OG0003722	2	5	1	1	1	1	1	12
OG0003723	3	4	1	1	1	1	1	12
OG0003724	2	5	1	1	1	1	1	12
OG0003725	2	4	1	1	1	1	2	12
OG0003726	2	5	1	1	1	1	1	12
OG0003727	4	3	1	1	1	1	1	12
OG0003728	2	5	1	1	1	0	2	12
OG0003729	3	4	1	1	1	1	1	12
OG0003730	1	4	1	1	2	1	2	12
OG0003731	1	4	3	1	1	1	1	12
OG0003732	2	4	1	2	1	1	1	12
OG0003733	3	4	1	1	1	1	1	12
OG0003734	2	5	1	1	1	1	1	12
OG0003735	3	4	1	1	1	1	1	12
OG0003736	2	4	1	1	1	2	1	12
OG0003737	2	5	1	1	1	1	1	12
OG0003738	2	1	2	2	2	2	1	12
OG0003739	2	4	2	1	1	1	1	12
OG0003740	2	5	1	1	1	1	1	12
OG0003741	2	5	1	1	1	1	1	12
OG0003742	2	5	1	1	1	1	1	12
OG0003743	3	2	1	1	1	1	3	12
OG0003744	2	5	1	1	1	1	1	12
OG0003745	2	4	1	1	1	1	2	12
OG0003746	2	4	1	1	1	1	2	12
OG0003747	3	4	1	1	1	1	1	12
OG0003748	2	5	1	1	1	1	1	12
OG0003749	1	3	3	2	1	1	1	12
OG0003750	2	6	1	1	1	1	0	12
OG0003751	2	2	1	1	3	1	2	12
OG0003752	2	4	1	1	1	1	2	12
OG0003753	3	4	1	1	1	0	2	12
OG0003754	2	5	1	1	1	1	1	12
OG0003755	1	5	1	1	1	2	1	12
OG0003756	2	5	1	1	2	0	1	12
OG0003757	3	4	1	1	1	1	1	12
OG0003758	2	4	1	1	2	1	1	12
OG0003759	2	5	1	1	1	1	1	12
OG0003760	2	5	1	1	1	1	1	12
OG0003761	2	5	1	1	1	1	1	12
OG0003762	2	2	1	0	2	2	3	12
OG0003763	1	4	2	2	1	1	1	12
OG0003764	1	4	1	1	1	1	3	12
OG0003765	3	3	2	0	1	1	2	12
OG0003766	3	5	1	1	1	0	1	12
OG0003767	3	3	1	1	2	1	1	12
OG0003768	2	3	1	1	1	1	3	12
OG0003769	2	4	1	1	1	1	2	12
OG0003770	2	4	1	1	1	1	2	12
OG0003771	2	5	1	1	1	1	1	12
OG0003772	2	2	1	1	2	2	2	12
OG0003773	3	4	1	1	1	1	1	12
OG0003774	3	4	1	1	1	1	1	12
OG0003775	2	4	1	1	1	2	1	12
OG0003776	4	3	1	1	1	1	1	12
OG0003777	4	3	1	1	1	1	1	12
OG0003778	2	4	1	1	2	1	1	12
OG0003779	2	5	1	1	1	1	1	12
OG0003780	2	4	1	1	1	1	2	12
OG0003781	2	5	1	1	1	1	1	12
OG0003782	4	3	1	1	1	1	1	12
OG0003783	1	5	1	1	2	1	1	12
OG0003784	3	1	1	1	1	1	4	12
OG0003785	2	5	1	1	1	1	1	12
OG0003786	3	4	1	1	1	1	1	12
OG0003787	3	7	0	0	0	1	1	12
OG0003788	2	6	1	1	1	1	0	12
OG0003789	2	4	1	1	1	2	1	12
OG0003790	2	4	1	1	1	2	1	12
OG0003791	2	5	1	1	1	1	1	12
OG0003792	2	3	3	1	1	1	1	12
OG0003793	2	5	1	1	1	1	1	12
OG0003794	2	5	1	1	1	1	1	12
OG0003795	4	3	1	1	1	1	1	12
OG0003796	2	4	1	1	1	2	1	12
OG0003797	2	4	1	1	2	1	1	12
OG0003798	2	5	1	1	1	1	1	12
OG0003799	2	4	1	1	1	1	2	12
OG0003800	3	4	1	1	1	1	1	12
OG0003801	1	3	1	1	2	3	1	12
OG0003802	2	4	1	1	2	1	1	12
OG0003803	3	4	1	1	1	1	1	12
OG0003804	1	5	1	1	1	1	2	12
OG0003805	3	4	1	1	1	1	1	12
OG0003806	1	5	1	2	1	1	1	12
OG0003807	2	5	1	1	1	1	1	12
OG0003808	2	4	1	1	1	2	1	12
OG0003809	2	4	2	1	1	1	1	12
OG0003810	3	4	1	1	1	1	1	12
OG0003811	2	5	1	1	1	1	1	12
OG0003812	2	4	1	1	1	2	1	12
OG0003813	3	4	1	1	1	1	1	12
OG0003814	3	4	1	1	1	1	1	12
OG0003815	2	3	1	1	1	2	2	12
OG0003816	2	5	1	1	1	1	1	12
OG0003817	2	5	1	1	1	1	1	12
OG0003818	2	5	1	1	1	1	1	12
OG0003819	3	3	1	1	1	1	2	12
OG0003820	4	3	1	1	1	1	1	12
OG0003821	3	4	1	1	1	1	1	12
OG0003822	4	3	1	1	1	1	1	12
OG0003823	3	4	1	1	1	1	1	12
OG0003824	2	3	1	1	1	1	3	12
OG0003825	1	5	1	1	1	1	2	12
OG0003826	2	4	1	1	1	2	1	12
OG0003827	2	5	1	1	1	1	1	12
OG0003828	2	5	1	1	1	1	1	12
OG0003829	2	4	2	1	1	1	1	12
OG0003830	2	5	1	1	1	1	1	12
OG0003831	2	4	1	1	1	2	1	12
OG0003832	2	4	1	1	1	1	2	12
OG0003833	1	7	1	1	1	0	1	12
OG0003834	3	4	1	1	1	1	1	12
OG0003835	2	5	1	1	1	1	1	12
OG0003836	3	4	1	1	1	1	1	12
OG0003837	2	4	1	1	1	1	2	12
OG0003838	2	5	1	1	1	1	1	12
OG0003839	2	5	1	1	1	1	1	12
OG0003840	3	4	1	1	1	1	1	12
OG0003841	2	5	1	1	1	1	1	12
OG0003842	2	4	1	1	1	2	1	12
OG0003843	2	0	0	0	0	2	8	12
OG0003844	4	3	1	1	1	1	1	12
OG0003845	1	4	1	1	1	1	3	12
OG0003846	2	3	1	1	1	1	3	12
OG0003847	3	3	1	1	1	2	1	12
OG0003848	1	4	1	2	1	1	2	12
OG0003849	4	3	2	1	1	0	1	12
OG0003850	2	5	1	1	1	1	1	12
OG0003851	1	2	1	1	1	2	4	12
OG0003852	2	5	1	1	1	1	1	12
OG0003853	3	4	1	1	1	1	1	12
OG0003854	1	1	2	2	2	2	2	12
OG0003855	1	4	1	2	1	2	1	12
OG0003856	2	4	1	1	1	2	1	12
OG0003857	2	5	1	1	1	1	1	12
OG0003858	3	3	1	1	1	2	1	12
OG0003859	2	3	1	1	1	0	4	12
OG0003860	4	3	1	1	1	1	1	12
OG0003861	2	4	1	1	1	1	2	12
OG0003862	2	5	1	1	1	1	1	12
OG0003863	2	5	1	1	1	1	1	12
OG0003864	1	2	2	2	2	2	1	12
OG0003865	3	3	1	1	1	1	2	12
OG0003866	1	2	2	1	2	2	2	12
OG0003867	4	3	1	1	1	1	1	12
OG0003868	2	5	1	1	1	1	1	12
OG0003869	1	5	1	2	1	1	1	12
OG0003870	2	5	1	1	1	1	1	12
OG0003871	2	4	1	1	1	2	1	12
OG0003872	2	5	1	1	1	1	1	12
OG0003873	1	5	1	1	1	2	1	12
OG0003874	2	5	1	1	1	1	1	12
OG0003875	2	5	1	1	1	1	1	12
OG0003876	4	3	1	1	1	1	1	12
OG0003877	2	4	1	1	1	2	1	12
OG0003878	2	6	1	1	1	0	1	12
OG0003879	2	5	1	1	1	1	1	12
OG0003880	2	4	1	1	1	1	2	12
OG0003881	2	5	1	1	1	1	1	12
OG0003882	4	3	1	1	1	1	1	12
OG0003883	2	4	2	1	1	1	1	12
OG0003884	2	5	1	1	1	1	1	12
OG0003885	2	4	1	1	1	1	2	12
OG0003886	3	4	1	1	1	1	1	12
OG0003887	2	4	2	1	1	1	1	12
OG0003888	1	5	1	1	1	2	1	12
OG0003889	3	3	1	2	1	1	1	12
OG0003890	1	4	1	0	2	2	2	12
OG0003891	2	4	1	1	1	1	2	12
OG0003892	2	5	1	1	1	1	1	12
OG0003893	1	4	1	4	1	1	0	12
OG0003894	5	4	1	1	0	0	1	12
OG0003895	2	2	1	1	2	2	2	12
OG0003896	4	3	1	1	1	1	1	12
OG0003897	2	5	1	1	1	1	1	12
OG0003898	3	4	1	1	1	1	1	12
OG0003899	2	5	1	1	1	1	1	12
OG0003900	4	3	1	1	1	1	1	12
OG0003901	2	5	1	1	2	1	0	12
OG0003902	2	5	1	1	1	1	1	12
OG0003903	2	5	1	1	1	1	1	12
OG0003904	2	3	2	1	1	1	2	12
OG0003905	2	4	1	1	2	1	1	12
OG0003906	2	4	1	2	1	1	1	12
OG0003907	3	4	1	1	1	1	1	12
OG0003908	3	4	1	1	1	1	1	12
OG0003909	2	5	1	1	1	1	1	12
OG0003910	2	5	1	1	1	1	1	12
OG0003911	1	6	2	1	1	0	1	12
OG0003912	2	4	1	1	1	1	2	12
OG0003913	2	4	1	1	1	2	1	12
OG0003914	2	4	1	1	1	2	1	12
OG0003915	2	5	1	1	1	1	1	12
OG0003916	1	3	2	2	0	2	2	12
OG0003917	1	4	2	1	1	1	2	12
OG0003918	1	6	1	1	1	1	1	12
OG0003919	2	4	1	1	1	2	1	12
OG0003920	1	5	1	2	1	1	1	12
OG0003921	2	3	1	1	2	1	2	12
OG0003922	2	4	2	1	1	1	1	12
OG0003923	3	4	1	1	1	1	1	12
OG0003924	2	4	2	1	1	1	1	12
OG0003925	2	5	1	1	1	1	1	12
OG0003926	2	5	1	1	1	1	1	12
OG0003927	2	4	1	1	0	2	2	12
OG0003928	2	5	1	1	1	1	1	12
OG0003929	3	4	1	1	1	1	1	12
OG0003930	2	5	1	1	1	1	1	12
OG0003931	2	5	1	1	1	1	1	12
OG0003932	1	3	1	2	1	2	2	12
OG0003933	1	6	1	1	1	1	1	12
OG0003934	3	3	1	1	1	1	2	12
OG0003935	2	5	1	1	1	1	1	12
OG0003936	2	5	1	1	1	1	1	12
OG0003937	2	5	1	1	1	1	1	12
OG0003938	3	3	1	1	1	1	2	12
OG0003939	4	3	1	1	1	1	1	12
OG0003940	2	5	1	1	1	1	1	12
OG0003941	3	4	1	1	1	1	1	12
OG0003942	3	4	2	1	0	0	2	12
OG0003943	4	3	1	1	1	1	1	12
OG0003944	3	3	1	1	1	1	2	12
OG0003945	2	4	0	0	2	2	2	12
OG0003946	2	5	1	1	1	1	1	12
OG0003947	1	4	1	2	1	1	2	12
OG0003948	2	4	2	1	1	1	1	12
OG0003949	2	4	1	1	1	1	2	12
OG0003950	2	4	1	1	2	1	1	12
OG0003951	1	2	2	2	2	1	2	12
OG0003952	1	6	1	1	1	1	1	12
OG0003953	1	5	2	0	1	1	2	12
OG0003954	2	5	1	1	1	1	1	12
OG0003955	2	5	1	1	0	1	2	12
OG0003956	2	3	2	1	1	1	2	12
OG0003957	1	3	1	1	2	1	3	12
OG0003958	2	4	1	1	1	1	2	12
OG0003959	4	3	1	1	1	1	1	12
OG0003960	2	4	1	1	1	1	2	12
OG0003961	1	4	1	1	1	2	2	12
OG0003962	2	5	1	1	1	0	2	12
OG0003963	3	4	1	1	1	1	1	12
OG0003964	2	6	1	1	1	0	1	12
OG0003965	1	6	1	0	1	2	1	12
OG0003966	2	4	2	1	1	1	1	12
OG0003967	2	4	2	1	1	1	1	12
OG0003968	2	5	1	1	1	1	1	12
OG0003969	2	5	1	2	0	1	1	12
OG0003970	2	4	1	1	1	2	1	12
OG0003971	2	3	1	1	1	1	3	12
OG0003972	1	2	2	2	1	2	2	12
OG0003973	2	1	4	2	0	0	3	12
OG0003974	2	5	1	1	1	1	1	12
OG0003975	2	4	1	1	2	1	1	12
OG0003976	1	6	1	1	1	1	1	12
OG0003977	1	5	2	1	1	1	1	12
OG0003978	2	5	1	1	1	1	1	12
OG0003979	2	4	1	1	1	2	1	12
OG0003980	2	5	1	1	1	1	1	12
OG0003981	3	4	1	1	1	1	1	12
OG0003982	3	4	1	1	1	1	1	12
OG0003983	4	3	1	1	1	1	1	12
OG0003984	1	5	1	1	1	1	2	12
OG0003985	2	3	1	1	1	1	3	12
OG0003986	3	3	2	1	1	1	1	12
OG0003987	2	7	1	1	0	0	1	12
OG0003988	2	4	1	1	2	1	1	12
OG0003989	4	2	2	1	1	1	1	12
OG0003990	3	4	1	1	1	1	1	12
OG0003991	1	4	1	1	1	2	2	12
OG0003992	1	6	1	1	1	1	1	12
OG0003993	4	3	1	1	1	1	1	12
OG0003994	2	5	1	1	1	1	1	12
OG0003995	3	2	1	1	3	1	1	12
OG0003996	2	5	1	1	1	1	1	12
OG0003997	3	4	1	1	1	1	1	12
OG0003998	1	6	1	1	1	1	1	12
OG0003999	1	5	2	2	0	1	1	12
OG0004000	2	5	1	1	1	1	1	12
OG0004001	2	5	1	1	1	1	1	12
OG0004002	2	4	1	1	2	1	1	12
OG0004003	2	5	1	1	1	1	1	12
OG0004004	2	1	2	2	1	2	2	12
OG0004005	1	3	1	2	1	2	2	12
OG0004006	2	5	1	1	1	1	1	12
OG0004007	2	4	1	1	1	1	2	12
OG0004008	2	4	1	1	1	2	1	12
OG0004009	2	4	1	1	2	1	1	12
OG0004010	2	4	1	2	1	1	1	12
OG0004011	2	6	1	1	1	1	0	12
OG0004012	5	2	1	1	1	1	1	12
OG0004013	2	4	2	1	1	1	1	12
OG0004014	1	4	1	1	1	2	2	12
OG0004015	2	6	1	1	1	0	1	12
OG0004016	3	4	1	1	1	1	1	12
OG0004017	2	4	1	1	2	2	0	12
OG0004018	2	4	2	1	1	1	1	12
OG0004019	2	5	1	1	1	1	1	12
OG0004020	5	1	2	1	1	1	1	12
OG0004021	2	3	1	1	1	2	2	12
OG0004022	2	4	1	1	1	2	1	12
OG0004023	2	5	1	1	1	1	1	12
OG0004024	3	4	1	1	1	1	1	12
OG0004025	2	5	1	1	1	1	1	12
OG0004026	1	4	1	1	1	2	2	12
OG0004027	2	7	1	1	0	0	1	12
OG0004028	2	4	2	1	1	1	1	12
OG0004029	1	6	1	1	1	1	1	12
OG0004030	3	3	1	1	1	1	2	12
OG0004031	1	5	1	1	1	2	1	12
OG0004032	3	4	1	1	1	1	1	12
OG0004033	2	3	1	1	1	2	2	12
OG0004034	3	4	1	1	1	1	1	12
OG0004035	2	4	1	1	1	1	2	12
OG0004036	2	4	1	1	1	2	1	12
OG0004037	2	4	1	1	2	1	1	12
OG0004038	2	5	1	1	1	1	1	12
OG0004039	2	5	1	1	1	1	1	12
OG0004040	2	4	1	1	1	2	1	12
OG0004041	1	6	1	1	1	1	1	12
OG0004042	2	3	1	1	1	1	3	12
OG0004043	2	4	1	1	1	1	2	12
OG0004044	2	3	3	1	1	1	1	12
OG0004045	2	2	1	2	2	1	2	12
OG0004046	1	5	0	2	2	2	0	12
OG0004047	2	4	2	1	1	1	1	12
OG0004048	2	4	1	1	1	1	2	12
OG0004049	2	4	1	1	2	1	1	12
OG0004050	3	3	1	1	1	1	2	12
OG0004051	3	2	1	3	1	0	2	12
OG0004052	2	5	1	1	1	1	1	12
OG0004053	1	1	1	3	1	1	4	12
OG0004054	2	5	1	1	1	1	1	12
OG0004055	2	5	1	1	1	1	1	12
OG0004056	2	5	1	1	1	1	1	12
OG0004057	2	4	1	1	1	2	1	12
OG0004058	3	4	1	1	1	1	1	12
OG0004059	2	5	1	1	1	1	1	12
OG0004060	2	4	1	2	1	1	1	12
OG0004061	3	3	2	1	1	1	1	12
OG0004062	2	5	1	1	1	1	1	12
OG0004063	2	4	1	1	1	1	2	12
OG0004064	2	4	1	2	1	1	1	12
OG0004065	3	4	1	1	1	1	1	12
OG0004066	2	4	1	2	1	1	1	12
OG0004067	2	5	1	1	1	1	1	12
OG0004068	1	7	2	0	0	0	2	12
OG0004069	2	4	2	1	1	1	1	12
OG0004070	2	4	1	1	1	1	2	12
OG0004071	2	3	3	1	1	1	1	12
OG0004072	3	6	1	1	1	0	0	12
OG0004073	1	6	1	1	1	1	1	12
OG0004074	2	4	3	1	1	1	0	12
OG0004075	2	4	1	2	1	1	1	12
OG0004076	1	5	1	1	1	1	2	12
OG0004077	2	4	1	1	1	1	2	12
OG0004078	2	5	1	1	1	1	1	12
OG0004079	2	5	1	1	1	1	1	12
OG0004080	2	4	1	1	1	1	2	12
OG0004081	2	5	1	1	1	1	1	12
OG0004082	1	2	1	1	2	3	2	12
OG0004083	2	3	2	1	1	2	1	12
OG0004084	1	4	1	1	1	1	3	12
OG0004085	2	4	1	1	1	0	3	12
OG0004086	2	2	3	1	2	1	1	12
OG0004087	2	4	1	1	1	1	2	12
OG0004088	2	4	1	1	1	1	2	12
OG0004089	2	5	1	1	1	1	1	12
OG0004090	1	0	6	0	0	1	4	12
OG0004091	2	4	1	1	1	1	2	12
OG0004092	1	4	1	1	1	2	2	12
OG0004093	2	5	1	1	1	1	1	12
OG0004094	1	4	1	1	1	2	2	12
OG0004095	2	4	2	1	1	1	1	12
OG0004096	2	5	1	1	1	1	1	12
OG0004097	1	5	2	1	0	2	1	12
OG0004098	1	1	5	1	1	1	2	12
OG0004099	2	4	1	1	1	2	1	12
OG0004100	2	5	1	1	1	1	1	12
OG0004101	1	5	2	1	1	1	1	12
OG0004102	1	6	0	1	2	2	0	12
OG0004103	2	5	1	1	1	1	1	12
OG0004104	2	5	1	1	1	1	1	12
OG0004105	2	5	1	1	0	2	1	12
OG0004106	2	4	2	1	1	1	1	12
OG0004107	1	5	1	1	1	1	2	12
OG0004108	2	3	1	2	1	2	1	12
OG0004109	2	5	1	1	1	1	1	12
OG0004110	2	5	1	1	1	1	1	12
OG0004111	2	5	1	1	1	1	1	12
OG0004112	1	5	1	1	1	1	2	12
OG0004113	1	5	1	1	1	2	1	12
OG0004114	2	4	1	1	1	2	1	12
OG0004115	2	4	1	1	1	1	2	12
OG0004116	2	5	1	1	1	1	1	12
OG0004117	1	5	5	0	0	0	1	12
OG0004118	2	3	1	1	2	1	2	12
OG0004119	2	5	1	1	1	1	1	12
OG0004120	1	5	1	1	1	1	2	12
OG0004121	2	4	1	1	1	1	2	12
OG0004122	2	4	2	1	1	1	1	12
OG0004123	1	7	0	2	2	0	0	12
OG0004124	1	6	1	1	1	1	1	12
OG0004125	4	3	1	1	1	1	1	12
OG0004126	3	4	1	1	1	1	1	12
OG0004127	2	4	1	1	1	1	2	12
OG0004128	1	5	2	1	0	2	1	12
OG0004129	2	4	1	1	1	1	2	12
OG0004130	2	5	1	1	1	1	1	12
OG0004131	3	3	2	1	1	1	1	12
OG0004132	3	4	1	1	1	1	1	12
OG0004133	1	5	1	2	1	1	1	12
OG0004134	2	4	2	1	1	1	1	12
OG0004135	1	3	1	3	1	1	2	12
OG0004136	2	4	1	1	1	1	2	12
OG0004137	2	4	1	1	1	1	2	12
OG0004138	2	4	1	2	1	1	1	12
OG0004139	1	5	1	1	1	1	2	12
OG0004140	1	3	2	2	1	2	1	12
OG0004141	1	4	2	1	1	1	2	12
OG0004142	2	4	2	1	1	1	1	12
OG0004143	2	5	1	1	1	1	1	12
OG0004144	2	5	1	1	1	1	1	12
OG0004145	2	5	1	1	1	1	1	12
OG0004146	2	5	1	1	1	1	1	12
OG0004147	2	5	1	1	1	1	1	12
OG0004148	1	6	1	1	1	1	1	12
OG0004149	3	4	1	1	1	1	1	12
OG0004150	1	2	1	1	1	4	2	12
OG0004151	2	5	1	1	1	1	1	12
OG0004152	1	5	1	3	0	0	2	12
OG0004153	1	5	2	1	0	1	2	12
OG0004154	3	4	1	1	1	1	1	12
OG0004155	1	5	1	2	1	1	1	12
OG0004156	2	4	1	1	1	1	2	12
OG0004157	1	6	1	1	1	1	1	12
OG0004158	1	5	1	1	2	1	1	12
OG0004159	2	4	1	1	1	2	1	12
OG0004160	2	4	1	1	1	2	1	12
OG0004161	1	5	1	1	1	2	1	12
OG0004162	2	4	1	1	1	2	1	12
OG0004163	2	5	1	1	1	1	1	12
OG0004164	2	5	1	1	1	1	1	12
OG0004165	1	5	1	1	1	2	1	12
OG0004166	2	5	1	1	1	1	1	12
OG0004167	2	4	1	2	1	1	1	12
OG0004168	1	4	1	1	2	2	1	12
OG0004169	1	7	1	1	1	1	0	12
OG0004170	2	5	1	1	1	1	1	12
OG0004171	2	5	1	1	1	1	1	12
OG0004172	1	6	1	1	1	1	1	12
OG0004173	2	5	1	1	1	1	1	12
OG0004174	1	6	1	1	1	1	1	12
OG0004175	2	5	1	1	1	0	2	12
OG0004176	1	5	1	1	1	2	1	12
OG0004177	2	4	1	1	1	2	1	12
OG0004178	2	5	1	1	1	1	1	12
OG0004179	1	6	1	1	1	1	1	12
OG0004180	1	6	1	1	1	1	1	12
OG0004181	1	2	1	2	3	1	2	12
OG0004182	1	4	1	1	1	1	3	12
OG0004183	2	4	2	1	1	1	1	12
OG0004184	4	3	1	1	1	1	1	12
OG0004185	1	6	2	1	1	1	0	12
OG0004186	1	6	1	1	0	2	1	12
OG0004187	1	5	1	1	2	1	1	12
OG0004188	2	5	1	1	1	1	1	12
OG0004189	2	4	1	1	1	1	2	12
OG0004190	1	3	2	2	1	1	2	12
OG0004191	2	4	1	1	1	1	2	12
OG0004192	1	4	1	1	1	2	2	12
OG0004193	1	5	1	1	1	1	2	12
OG0004194	2	5	1	1	1	1	1	12
OG0004195	1	5	2	1	1	1	1	12
OG0004196	1	4	2	0	2	2	1	12
OG0004197	2	5	1	1	1	1	1	12
OG0004198	2	5	1	1	1	1	1	12
OG0004199	3	4	1	1	1	1	1	12
OG0004200	1	3	3	1	1	2	1	12
OG0004201	1	3	2	1	1	1	3	12
OG0004202	1	0	2	1	1	7	0	12
OG0004203	1	6	1	1	1	1	1	12
OG0004204	1	6	1	1	1	1	1	12
OG0004205	1	5	1	1	2	1	1	12
OG0004206	1	2	2	2	2	1	2	12
OG0004207	1	5	1	1	1	1	2	12
OG0004208	1	3	1	1	1	3	2	12
OG0004209	2	5	1	1	1	1	1	12
OG0004210	1	6	1	1	1	1	1	12
OG0004211	1	4	1	1	2	1	2	12
OG0004212	1	3	2	2	1	1	2	12
OG0004213	0	12	0	0	0	0	0	12
OG0004214	0	6	2	1	1	1	1	12
OG0004215	0	4	0	1	3	1	3	12
OG0004216	0	3	0	2	2	2	3	12
OG0004217	0	12	0	0	0	0	0	12
OG0004218	0	4	1	1	2	2	2	12
OG0004219	0	3	0	0	1	2	6	12
OG0004220	0	11	0	1	0	0	0	12
OG0004221	0	12	0	0	0	0	0	12
OG0004222	0	6	1	3	0	1	1	12
OG0004223	0	6	1	2	1	1	1	12
OG0004224	0	12	0	0	0	0	0	12
OG0004225	0	6	0	1	1	2	2	12
OG0004226	0	9	1	1	1	0	0	12
OG0004227	0	6	0	2	3	0	1	12
OG0004228	0	6	0	1	2	2	1	12
OG0004229	0	4	1	2	2	1	2	12
OG0004230	0	6	1	1	2	1	1	12
OG0004231	0	5	0	1	1	2	3	12
OG0004232	0	11	0	0	1	0	0	12
OG0004233	0	9	1	0	1	0	1	12
OG0004234	0	11	0	0	0	0	1	12
OG0004235	0	3	1	2	2	1	3	12
OG0004236	0	8	0	1	1	2	0	12
OG0004237	0	5	0	1	0	2	4	12
OG0004238	0	12	0	0	0	0	0	12
OG0004239	0	12	0	0	0	0	0	12
OG0004240	0	4	1	1	1	3	2	12
OG0004241	0	7	0	2	1	1	1	12
OG0004242	0	6	2	1	1	1	1	12
OG0004243	0	4	2	2	2	1	1	12
OG0004244	0	10	0	0	0	0	2	12
OG0004245	0	8	3	0	0	0	1	12
OG0004246	0	7	1	1	1	1	1	12
OG0004247	0	8	1	1	2	0	0	12
OG0004248	0	9	0	1	2	0	0	12
OG0004249	0	6	1	1	2	1	1	12
OG0004250	0	11	0	0	1	0	0	12
OG0004251	0	3	1	1	1	2	4	12
OG0004252	0	5	0	2	2	2	1	12
OG0004253	0	9	0	1	1	1	0	12
OG0004254	0	3	1	1	1	3	3	12
OG0004255	0	4	2	2	3	0	1	12
OG0004256	0	12	0	0	0	0	0	12
OG0004257	0	12	0	0	0	0	0	12
OG0004258	0	4	1	2	2	2	1	12
OG0004259	0	12	0	0	0	0	0	12
OG0004260	0	7	0	0	2	1	2	12
OG0004261	0	10	1	0	0	0	1	12
OG0004262	0	8	0	2	2	0	0	12
OG0004263	0	6	0	0	0	0	6	12
OG0004264	0	12	0	0	0	0	0	12
OG0004265	0	8	0	2	0	0	2	12
OG0004266	0	7	0	1	1	2	1	12
OG0004267	0	9	0	1	0	0	2	12
OG0004268	0	5	1	1	1	2	2	12
OG0004269	0	3	2	2	1	2	2	12
OG0004270	0	11	0	0	1	0	0	12
OG0004271	0	5	1	2	1	2	1	12
OG0004272	0	11	0	1	0	0	0	12
OG0004273	0	6	2	2	0	1	1	12
OG0004274	0	7	1	1	1	1	1	12
OG0004275	0	5	1	1	1	3	1	12
OG0004276	0	7	1	1	1	1	1	12
OG0004277	0	4	2	1	1	2	2	12
OG0004278	0	4	2	2	1	1	2	12
OG0004279	0	9	0	2	0	1	0	12
OG0004280	0	6	2	1	1	1	1	12
OG0004281	0	8	0	2	2	0	0	12
OG0004282	0	9	1	0	0	1	1	12
OG0004283	0	4	0	5	1	1	1	12
OG0004284	0	9	0	1	0	0	2	12
OG0004285	0	8	1	1	2	0	0	12
OG0004286	0	4	5	0	2	0	1	12
OG0004287	0	6	2	1	1	1	1	12
OG0004288	0	7	1	1	1	1	1	12
OG0004289	0	4	2	1	2	2	1	12
OG0004290	0	6	0	1	1	2	2	12
OG0004291	0	1	3	1	3	2	2	12
OG0004292	0	3	3	2	1	2	1	12
OG0004293	0	5	1	1	1	1	3	12
OG0004294	0	3	2	1	2	2	2	12
OG0004295	0	4	4	1	2	1	0	12
OG0004296	0	6	1	1	1	1	2	12
OG0004297	0	10	1	1	0	0	0	12
OG0004298	0	1	0	0	1	7	3	12
OG0004299	0	3	9	0	0	0	0	12
OG0004300	0	5	2	0	1	2	2	12
OG0004301	0	5	0	1	2	2	2	12
OG0004302	0	6	0	3	3	0	0	12
OG0004303	0	2	1	3	3	2	1	12
OG0004304	0	4	2	2	1	1	2	12
OG0004305	0	5	2	0	3	1	1	12
OG0004306	0	2	2	1	1	3	3	12
OG0004307	0	6	1	1	1	2	1	12
OG0004308	0	3	1	1	3	2	2	12
OG0004309	0	2	0	0	4	4	2	12
OG0004310	0	6	1	3	1	1	0	12
OG0004311	0	9	1	0	1	1	0	12
OG0004312	0	1	2	1	0	4	4	12
OG0004313	0	6	1	0	4	0	1	12
OG0004314	0	6	1	1	3	0	1	12
OG0004315	0	5	1	1	1	2	2	12
OG0004316	0	3	2	0	1	1	5	12
OG0004317	0	6	1	1	3	1	0	12
OG0004318	0	5	3	2	1	0	1	12
OG0004319	0	6	1	2	1	1	1	12
OG0004320	0	2	0	2	1	4	3	12
OG0004321	0	5	1	1	2	2	1	12
OG0004322	0	5	1	2	2	1	1	12
OG0004323	0	2	1	1	2	2	4	12
OG0004324	0	4	2	1	1	2	2	12
OG0004325	0	3	2	1	1	3	2	12
OG0004326	0	4	1	3	1	2	1	12
OG0004327	0	3	2	3	0	2	2	12
OG0004328	0	0	12	0	0	0	0	12
OG0004329	0	0	1	0	0	0	11	12
OG0004330	0	0	0	10	1	1	0	12
OG0004331	0	0	0	2	7	3	0	12
OG0004332	2	4	1	1	1	1	1	11
OG0004333	2	4	1	1	1	1	1	11
OG0004334	2	5	1	1	1	0	1	11
OG0004335	2	4	1	1	1	1	1	11
OG0004336	2	4	1	1	1	1	1	11
OG0004337	2	3	1	1	1	1	2	11
OG0004338	2	4	1	1	1	1	1	11
OG0004339	3	3	1	1	1	1	1	11
OG0004340	2	4	1	1	1	1	1	11
OG0004341	2	4	1	1	1	1	1	11
OG0004342	1	3	1	1	1	2	2	11
OG0004343	1	5	1	1	1	1	1	11
OG0004344	2	4	1	1	1	1	1	11
OG0004345	2	4	1	1	1	1	1	11
OG0004346	2	4	1	1	1	1	1	11
OG0004347	3	4	1	1	1	0	1	11
OG0004348	2	4	1	1	2	0	1	11
OG0004349	2	4	1	1	1	1	1	11
OG0004350	2	4	1	1	1	1	1	11
OG0004351	2	4	1	1	1	1	1	11
OG0004352	2	4	1	1	1	1	1	11
OG0004353	2	4	1	1	1	1	1	11
OG0004354	2	4	1	1	1	1	1	11
OG0004355	2	3	2	1	1	1	1	11
OG0004356	2	3	1	1	1	1	2	11
OG0004357	2	3	1	1	1	1	2	11
OG0004358	2	5	1	1	1	0	1	11
OG0004359	2	4	1	1	1	1	1	11
OG0004360	2	4	1	1	1	1	1	11
OG0004361	2	4	1	1	1	1	1	11
OG0004362	3	3	1	1	1	1	1	11
OG0004363	3	3	1	1	1	1	1	11
OG0004364	2	4	1	1	1	0	2	11
OG0004365	2	3	1	1	2	1	1	11
OG0004366	2	5	1	1	0	0	2	11
OG0004367	2	4	1	1	1	1	1	11
OG0004368	2	4	1	1	1	1	1	11
OG0004369	2	3	2	1	1	1	1	11
OG0004370	2	4	1	1	1	1	1	11
OG0004371	2	4	1	1	1	1	1	11
OG0004372	2	3	1	1	1	2	1	11
OG0004373	11	0	0	0	0	0	0	11
OG0004374	2	3	1	1	1	1	2	11
OG0004375	2	3	1	1	1	1	2	11
OG0004376	2	4	1	1	1	1	1	11
OG0004377	2	4	1	1	1	1	1	11
OG0004378	3	1	1	1	1	2	2	11
OG0004379	2	4	1	1	1	1	1	11
OG0004380	9	1	0	0	0	0	1	11
OG0004381	2	5	1	1	1	0	1	11
OG0004382	2	4	1	1	1	1	1	11
OG0004383	3	3	1	1	1	0	2	11
OG0004384	2	4	1	1	1	1	1	11
OG0004385	3	3	1	1	1	1	1	11
OG0004386	2	4	1	1	1	1	1	11
OG0004387	2	4	1	1	1	1	1	11
OG0004388	2	4	1	1	1	1	1	11
OG0004389	2	4	1	1	1	1	1	11
OG0004390	2	5	1	1	0	1	1	11
OG0004391	2	4	1	1	1	1	1	11
OG0004392	2	4	1	1	1	1	1	11
OG0004393	2	3	1	1	1	1	2	11
OG0004394	2	3	1	1	3	0	1	11
OG0004395	2	3	1	2	1	1	1	11
OG0004396	3	3	1	1	1	1	1	11
OG0004397	3	3	1	1	1	1	1	11
OG0004398	3	3	1	1	1	1	1	11
OG0004399	3	4	1	1	1	1	0	11
OG0004400	2	4	1	1	1	1	1	11
OG0004401	4	2	1	1	1	1	1	11
OG0004402	1	4	2	1	1	1	1	11
OG0004403	1	4	1	1	1	1	2	11
OG0004404	2	4	1	1	1	1	1	11
OG0004405	4	3	1	1	1	0	1	11
OG0004406	2	4	1	1	1	1	1	11
OG0004407	1	4	1	1	1	1	2	11
OG0004408	1	4	1	1	1	1	2	11
OG0004409	1	5	1	1	1	1	1	11
OG0004410	2	4	1	1	1	1	1	11
OG0004411	2	4	1	1	1	1	1	11
OG0004412	3	3	1	1	1	1	1	11
OG0004413	11	0	0	0	0	0	0	11
OG0004414	2	4	1	1	1	1	1	11
OG0004415	11	0	0	0	0	0	0	11
OG0004416	2	4	1	1	1	1	1	11
OG0004417	3	3	1	1	1	1	1	11
OG0004418	2	4	1	1	1	1	1	11
OG0004419	2	4	1	1	1	1	1	11
OG0004420	2	4	1	1	1	1	1	11
OG0004421	2	3	1	1	1	2	1	11
OG0004422	2	3	1	1	1	1	2	11
OG0004423	1	6	1	1	1	0	1	11
OG0004424	2	3	2	1	1	1	1	11
OG0004425	3	2	1	1	2	1	1	11
OG0004426	2	2	1	2	1	0	3	11
OG0004427	2	4	1	1	1	1	1	11
OG0004428	2	4	1	1	1	1	1	11
OG0004429	2	4	1	1	1	1	1	11
OG0004430	1	3	1	1	1	2	2	11
OG0004431	2	4	1	1	1	1	1	11
OG0004432	2	4	1	1	1	1	1	11
OG0004433	2	3	1	1	1	1	2	11
OG0004434	4	2	1	1	1	1	1	11
OG0004435	2	4	1	1	1	1	1	11
OG0004436	6	1	1	0	1	1	1	11
OG0004437	2	4	1	1	1	1	1	11
OG0004438	2	3	1	1	1	1	2	11
OG0004439	3	3	1	1	1	1	1	11
OG0004440	2	3	1	1	1	1	2	11
OG0004441	2	4	1	1	1	1	1	11
OG0004442	2	4	1	1	1	1	1	11
OG0004443	2	4	1	1	1	1	1	11
OG0004444	2	3	1	1	1	1	2	11
OG0004445	2	4	1	1	1	1	1	11
OG0004446	5	3	1	0	1	1	0	11
OG0004447	2	4	1	1	1	1	1	11
OG0004448	2	4	1	1	1	1	1	11
OG0004449	3	3	1	1	1	1	1	11
OG0004450	2	4	1	1	1	1	1	11
OG0004451	1	5	1	1	1	1	1	11
OG0004452	2	4	1	1	1	1	1	11
OG0004453	2	5	1	1	1	1	0	11
OG0004454	2	3	1	1	1	1	2	11
OG0004455	2	4	1	1	1	1	1	11
OG0004456	2	5	1	1	1	1	0	11
OG0004457	3	3	1	1	1	1	1	11
OG0004458	2	4	1	1	1	1	1	11
OG0004459	2	4	1	1	1	1	1	11
OG0004460	2	4	1	1	1	1	1	11
OG0004461	2	4	1	1	1	1	1	11
OG0004462	2	3	2	1	1	1	1	11
OG0004463	11	0	0	0	0	0	0	11
OG0004464	2	4	1	1	1	1	1	11
OG0004465	2	3	1	1	1	1	2	11
OG0004466	3	3	1	1	1	1	1	11
OG0004467	3	3	1	1	1	1	1	11
OG0004468	2	4	1	1	1	1	1	11
OG0004469	2	4	1	1	0	1	2	11
OG0004470	2	4	1	1	1	1	1	11
OG0004471	4	3	1	1	1	0	1	11
OG0004472	2	4	1	1	1	1	1	11
OG0004473	2	4	1	1	1	1	1	11
OG0004474	2	4	1	1	1	1	1	11
OG0004475	3	3	1	1	1	1	1	11
OG0004476	3	3	1	1	1	1	1	11
OG0004477	3	3	1	1	1	1	1	11
OG0004478	1	4	1	1	1	1	2	11
OG0004479	2	4	1	1	1	1	1	11
OG0004480	2	3	1	1	1	1	2	11
OG0004481	2	4	1	1	1	1	1	11
OG0004482	2	4	1	1	1	1	1	11
OG0004483	4	3	1	0	1	1	1	11
OG0004484	2	3	1	1	1	1	2	11
OG0004485	3	3	1	1	1	1	1	11
OG0004486	2	4	1	1	1	1	1	11
OG0004487	2	4	1	1	1	1	1	11
OG0004488	3	2	1	1	1	2	1	11
OG0004489	1	5	1	1	1	1	1	11
OG0004490	2	4	1	1	1	1	1	11
OG0004491	1	5	1	1	1	1	1	11
OG0004492	2	5	1	1	1	1	0	11
OG0004493	2	4	1	1	1	1	1	11
OG0004494	3	3	1	1	1	1	1	11
OG0004495	3	3	1	1	1	1	1	11
OG0004496	3	3	1	1	1	1	1	11
OG0004497	2	4	1	1	1	1	1	11
OG0004498	2	3	1	1	1	2	1	11
OG0004499	2	4	1	1	1	1	1	11
OG0004500	2	4	1	1	1	1	1	11
OG0004501	2	4	1	1	1	1	1	11
OG0004502	2	4	1	1	1	1	1	11
OG0004503	4	2	1	1	1	1	1	11
OG0004504	3	3	1	1	1	1	1	11
OG0004505	2	4	1	1	1	1	1	11
OG0004506	2	4	1	1	1	1	1	11
OG0004507	2	4	1	1	1	1	1	11
OG0004508	2	4	1	1	1	1	1	11
OG0004509	3	3	1	1	1	1	1	11
OG0004510	2	4	1	1	1	1	1	11
OG0004511	3	3	1	1	1	1	1	11
OG0004512	2	3	1	1	1	1	2	11
OG0004513	2	4	1	1	1	1	1	11
OG0004514	3	4	1	1	0	1	1	11
OG0004515	4	2	1	1	1	1	1	11
OG0004516	2	4	1	1	1	1	1	11
OG0004517	2	4	1	1	1	1	1	11
OG0004518	2	4	1	1	1	1	1	11
OG0004519	3	3	1	1	1	1	1	11
OG0004520	2	4	1	1	1	1	1	11
OG0004521	2	4	1	1	1	1	1	11
OG0004522	2	4	1	1	1	1	1	11
OG0004523	2	4	1	1	1	1	1	11
OG0004524	3	3	1	1	1	1	1	11
OG0004525	2	4	1	1	1	1	1	11
OG0004526	2	5	1	1	1	1	0	11
OG0004527	2	4	1	1	1	1	1	11
OG0004528	3	3	1	1	1	1	1	11
OG0004529	3	4	1	1	1	0	1	11
OG0004530	2	4	1	1	1	1	1	11
OG0004531	2	3	1	1	1	1	2	11
OG0004532	10	0	0	0	0	1	0	11
OG0004533	2	4	1	1	1	2	0	11
OG0004534	2	4	1	1	1	1	1	11
OG0004535	2	2	2	1	1	2	1	11
OG0004536	2	4	1	1	1	1	1	11
OG0004537	2	4	1	1	1	1	1	11
OG0004538	2	1	1	2	1	1	3	11
OG0004539	2	4	1	1	1	1	1	11
OG0004540	2	4	1	1	1	1	1	11
OG0004541	2	4	1	1	1	1	1	11
OG0004542	2	4	1	1	1	1	1	11
OG0004543	5	2	1	1	0	1	1	11
OG0004544	3	3	1	0	1	1	2	11
OG0004545	2	4	1	1	1	1	1	11
OG0004546	2	4	1	1	1	1	1	11
OG0004547	4	3	1	1	1	1	0	11
OG0004548	3	3	1	1	1	1	1	11
OG0004549	3	3	1	1	1	1	1	11
OG0004550	2	4	1	1	1	1	1	11
OG0004551	2	4	1	1	1	1	1	11
OG0004552	2	3	1	1	1	2	1	11
OG0004553	2	4	1	1	1	1	1	11
OG0004554	2	2	2	2	1	1	1	11
OG0004555	2	4	1	1	1	1	1	11
OG0004556	2	3	2	1	1	1	1	11
OG0004557	2	4	1	1	1	1	1	11
OG0004558	2	4	1	1	1	1	1	11
OG0004559	2	4	1	1	0	1	2	11
OG0004560	3	3	1	1	1	1	1	11
OG0004561	2	4	1	1	1	1	1	11
OG0004562	2	4	1	1	1	1	1	11
OG0004563	1	4	1	2	1	1	1	11
OG0004564	2	4	1	1	1	1	1	11
OG0004565	1	5	1	1	1	1	1	11
OG0004566	2	4	1	1	1	1	1	11
OG0004567	2	4	1	1	1	1	1	11
OG0004568	9	0	1	0	1	0	0	11
OG0004569	2	3	1	1	1	2	1	11
OG0004570	2	4	1	1	1	1	1	11
OG0004571	2	4	1	1	1	1	1	11
OG0004572	2	4	1	1	1	1	1	11
OG0004573	2	4	1	1	1	1	1	11
OG0004574	2	4	1	1	1	1	1	11
OG0004575	2	4	1	1	1	1	1	11
OG0004576	2	4	1	1	1	1	1	11
OG0004577	1	4	1	1	1	1	2	11
OG0004578	1	4	1	1	1	1	2	11
OG0004579	3	2	1	1	2	1	1	11
OG0004580	2	4	1	1	1	1	1	11
OG0004581	2	4	1	1	1	1	1	11
OG0004582	2	4	1	1	1	1	1	11
OG0004583	2	5	1	1	0	1	1	11
OG0004584	2	4	1	1	1	1	1	11
OG0004585	2	4	1	1	1	1	1	11
OG0004586	7	1	0	0	2	0	1	11
OG0004587	2	3	1	1	1	1	2	11
OG0004588	2	0	2	2	1	2	2	11
OG0004589	2	4	1	1	1	1	1	11
OG0004590	2	4	1	1	1	1	1	11
OG0004591	2	4	1	1	1	1	1	11
OG0004592	2	4	1	1	1	1	1	11
OG0004593	11	0	0	0	0	0	0	11
OG0004594	2	3	1	1	1	2	1	11
OG0004595	1	5	1	1	1	1	1	11
OG0004596	2	4	1	1	1	1	1	11
OG0004597	2	4	1	1	1	1	1	11
OG0004598	3	3	1	0	2	1	1	11
OG0004599	1	4	1	1	1	2	1	11
OG0004600	2	4	1	1	1	1	1	11
OG0004601	2	4	1	1	1	0	2	11
OG0004602	2	4	1	1	1	1	1	11
OG0004603	3	3	1	1	1	1	1	11
OG0004604	4	3	2	1	0	0	1	11
OG0004605	2	4	1	1	1	1	1	11
OG0004606	2	4	1	1	1	1	1	11
OG0004607	3	5	0	0	1	1	1	11
OG0004608	3	4	0	1	1	1	1	11
OG0004609	2	4	1	1	1	1	1	11
OG0004610	7	1	1	1	0	1	0	11
OG0004611	2	4	1	1	1	1	1	11
OG0004612	3	3	1	1	1	1	1	11
OG0004613	2	4	1	1	1	1	1	11
OG0004614	1	4	1	1	2	1	1	11
OG0004615	2	4	1	1	1	1	1	11
OG0004616	1	3	1	1	3	1	1	11
OG0004617	2	4	1	1	1	1	1	11
OG0004618	2	5	1	1	1	1	0	11
OG0004619	2	4	1	0	2	1	1	11
OG0004620	3	4	1	1	1	0	1	11
OG0004621	2	4	1	1	1	1	1	11
OG0004622	2	4	1	1	1	1	1	11
OG0004623	1	4	1	1	1	1	2	11
OG0004624	2	5	1	1	0	1	1	11
OG0004625	2	4	1	1	1	1	1	11
OG0004626	2	4	1	1	1	1	1	11
OG0004627	2	4	1	1	1	1	1	11
OG0004628	2	4	1	1	1	0	2	11
OG0004629	2	4	1	1	1	1	1	11
OG0004630	2	4	1	1	1	1	1	11
OG0004631	2	4	1	1	1	1	1	11
OG0004632	2	4	1	1	1	1	1	11
OG0004633	2	4	1	1	1	1	1	11
OG0004634	2	4	1	1	1	1	1	11
OG0004635	2	4	1	1	1	1	1	11
OG0004636	10	1	0	0	0	0	0	11
OG0004637	2	4	1	1	1	1	1	11
OG0004638	3	3	1	1	0	2	1	11
OG0004639	2	4	1	1	1	1	1	11
OG0004640	3	4	1	1	1	0	1	11
OG0004641	2	3	1	1	1	1	2	11
OG0004642	2	3	2	1	2	0	1	11
OG0004643	1	5	1	1	1	1	1	11
OG0004644	2	4	1	1	1	1	1	11
OG0004645	2	4	1	1	1	1	1	11
OG0004646	2	4	1	1	1	1	1	11
OG0004647	10	0	1	0	0	0	0	11
OG0004648	2	4	1	1	1	1	1	11
OG0004649	2	4	1	1	1	1	1	11
OG0004650	11	0	0	0	0	0	0	11
OG0004651	2	4	1	1	1	1	1	11
OG0004652	2	3	1	1	1	2	1	11
OG0004653	2	4	1	1	1	1	1	11
OG0004654	11	0	0	0	0	0	0	11
OG0004655	2	4	1	1	1	1	1	11
OG0004656	2	5	1	1	0	1	1	11
OG0004657	8	2	0	1	0	0	0	11
OG0004658	2	4	1	1	1	1	1	11
OG0004659	1	5	1	1	1	1	1	11
OG0004660	2	4	1	1	1	1	1	11
OG0004661	2	4	1	1	1	1	1	11
OG0004662	2	4	1	1	1	1	1	11
OG0004663	2	5	1	1	1	0	1	11
OG0004664	2	4	1	1	1	1	1	11
OG0004665	2	4	1	1	1	1	1	11
OG0004666	2	4	1	1	1	1	1	11
OG0004667	2	4	1	1	1	1	1	11
OG0004668	2	4	1	1	1	1	1	11
OG0004669	2	4	1	1	1	1	1	11
OG0004670	4	2	1	1	1	1	1	11
OG0004671	2	4	1	1	1	1	1	11
OG0004672	3	3	1	1	1	1	1	11
OG0004673	3	2	1	1	1	1	2	11
OG0004674	2	4	1	1	1	1	1	11
OG0004675	4	3	1	1	1	0	1	11
OG0004676	2	4	1	1	1	1	1	11
OG0004677	2	4	1	1	1	1	1	11
OG0004678	1	5	1	1	1	1	1	11
OG0004679	2	4	1	1	1	1	1	11
OG0004680	1	4	1	1	1	1	2	11
OG0004681	3	3	1	1	1	1	1	11
OG0004682	3	2	2	1	1	1	1	11
OG0004683	2	4	1	1	1	1	1	11
OG0004684	2	4	1	1	1	1	1	11
OG0004685	2	4	1	1	1	1	1	11
OG0004686	2	4	1	1	1	1	1	11
OG0004687	2	2	2	1	0	2	2	11
OG0004688	2	4	1	1	1	1	1	11
OG0004689	2	4	1	1	1	1	1	11
OG0004690	2	4	1	1	1	1	1	11
OG0004691	2	4	1	1	1	1	1	11
OG0004692	3	3	1	1	1	1	1	11
OG0004693	2	4	1	1	1	1	1	11
OG0004694	2	4	1	1	1	1	1	11
OG0004695	2	5	2	1	0	0	1	11
OG0004696	2	3	1	1	1	1	2	11
OG0004697	3	3	1	1	1	1	1	11
OG0004698	2	3	2	1	1	1	1	11
OG0004699	3	5	0	0	0	1	2	11
OG0004700	3	3	1	1	1	1	1	11
OG0004701	2	4	1	1	1	1	1	11
OG0004702	2	3	1	2	1	1	1	11
OG0004703	11	0	0	0	0	0	0	11
OG0004704	2	5	1	0	1	1	1	11
OG0004705	2	4	1	1	1	1	1	11
OG0004706	2	4	1	1	1	1	1	11
OG0004707	2	4	1	1	1	1	1	11
OG0004708	2	3	1	1	2	1	1	11
OG0004709	2	4	1	1	1	1	1	11
OG0004710	2	3	1	1	2	1	1	11
OG0004711	4	2	1	1	1	1	1	11
OG0004712	2	4	1	1	1	1	1	11
OG0004713	2	2	1	1	2	1	2	11
OG0004714	4	2	1	1	1	1	1	11
OG0004715	2	3	1	1	1	2	1	11
OG0004716	3	3	1	1	1	1	1	11
OG0004717	2	3	2	1	1	1	1	11
OG0004718	2	4	1	1	1	1	1	11
OG0004719	2	4	1	1	1	1	1	11
OG0004720	2	4	1	1	1	1	1	11
OG0004721	2	1	1	2	2	1	2	11
OG0004722	2	4	1	1	1	1	1	11
OG0004723	3	3	1	1	1	1	1	11
OG0004724	2	4	1	1	1	1	1	11
OG0004725	2	4	1	1	1	1	1	11
OG0004726	2	4	1	1	1	1	1	11
OG0004727	1	5	0	1	2	0	2	11
OG0004728	2	4	1	1	1	1	1	11
OG0004729	2	4	1	1	1	1	1	11
OG0004730	4	2	1	1	1	1	1	11
OG0004731	2	3	1	1	1	1	2	11
OG0004732	2	3	1	1	0	2	2	11
OG0004733	2	4	1	1	1	1	1	11
OG0004734	3	4	1	1	1	0	1	11
OG0004735	1	6	1	1	0	1	1	11
OG0004736	2	4	1	1	1	1	1	11
OG0004737	2	4	1	1	1	1	1	11
OG0004738	2	4	1	1	1	1	1	11
OG0004739	2	4	1	1	1	1	1	11
OG0004740	2	3	2	1	1	1	1	11
OG0004741	2	4	1	1	1	1	1	11
OG0004742	4	2	1	1	1	1	1	11
OG0004743	3	3	1	1	1	1	1	11
OG0004744	1	4	1	1	1	1	2	11
OG0004745	2	4	1	1	1	1	1	11
OG0004746	3	3	1	1	1	1	1	11
OG0004747	2	4	1	1	1	1	1	11
OG0004748	2	4	1	1	1	1	1	11
OG0004749	2	3	1	1	1	1	2	11
OG0004750	2	3	1	1	1	1	2	11
OG0004751	2	4	1	1	1	1	1	11
OG0004752	3	3	1	1	1	1	1	11
OG0004753	3	3	1	1	1	1	1	11
OG0004754	2	4	1	1	1	1	1	11
OG0004755	2	2	2	1	2	1	1	11
OG0004756	2	4	1	1	1	1	1	11
OG0004757	3	3	1	1	1	1	1	11
OG0004758	2	3	2	1	1	1	1	11
OG0004759	2	4	1	1	1	1	1	11
OG0004760	3	2	1	2	1	1	1	11
OG0004761	2	4	1	1	1	1	1	11
OG0004762	2	3	1	1	1	1	2	11
OG0004763	2	3	1	1	1	1	2	11
OG0004764	2	4	1	1	1	1	1	11
OG0004765	2	3	1	1	1	1	2	11
OG0004766	2	4	1	1	1	1	1	11
OG0004767	2	4	1	1	1	1	1	11
OG0004768	2	3	1	1	2	1	1	11
OG0004769	3	3	1	1	1	1	1	11
OG0004770	2	2	2	2	1	1	1	11
OG0004771	2	4	1	1	1	1	1	11
OG0004772	2	4	1	1	1	1	1	11
OG0004773	2	3	2	1	1	1	1	11
OG0004774	2	3	1	2	1	1	1	11
OG0004775	2	4	1	1	1	1	1	11
OG0004776	2	4	1	1	1	1	1	11
OG0004777	2	4	1	1	1	1	1	11
OG0004778	1	5	1	2	1	1	0	11
OG0004779	2	4	1	1	1	1	1	11
OG0004780	4	2	1	1	1	1	1	11
OG0004781	2	3	1	2	1	1	1	11
OG0004782	2	4	1	1	1	1	1	11
OG0004783	3	3	1	1	1	1	1	11
OG0004784	2	4	1	1	1	1	1	11
OG0004785	3	3	1	1	1	1	1	11
OG0004786	1	4	1	1	1	1	2	11
OG0004787	1	5	1	1	1	1	1	11
OG0004788	2	3	1	1	1	1	2	11
OG0004789	2	4	1	1	1	1	1	11
OG0004790	2	4	1	1	1	1	1	11
OG0004791	2	4	1	1	1	1	1	11
OG0004792	3	3	1	1	1	1	1	11
OG0004793	3	3	1	1	1	1	1	11
OG0004794	2	3	1	1	1	1	2	11
OG0004795	3	4	1	1	0	1	1	11
OG0004796	2	4	1	1	1	1	1	11
OG0004797	3	3	1	1	1	1	1	11
OG0004798	2	4	1	1	1	1	1	11
OG0004799	3	3	1	1	1	1	1	11
OG0004800	1	5	1	1	1	1	1	11
OG0004801	2	3	1	1	1	1	2	11
OG0004802	2	4	1	1	1	1	1	11
OG0004803	3	3	1	1	1	1	1	11
OG0004804	2	3	1	1	1	1	2	11
OG0004805	2	4	1	1	1	1	1	11
OG0004806	2	4	1	1	1	1	1	11
OG0004807	2	4	1	1	1	1	1	11
OG0004808	2	4	1	1	1	1	1	11
OG0004809	1	3	1	1	3	1	1	11
OG0004810	2	4	1	1	1	1	1	11
OG0004811	2	4	1	1	1	1	1	11
OG0004812	2	4	1	1	1	1	1	11
OG0004813	2	4	1	1	1	1	1	11
OG0004814	2	4	1	1	1	1	1	11
OG0004815	2	4	1	1	1	1	1	11
OG0004816	2	3	1	2	1	1	1	11
OG0004817	3	3	1	1	1	1	1	11
OG0004818	3	2	1	1	1	1	2	11
OG0004819	2	4	1	1	1	1	1	11
OG0004820	2	3	1	1	1	1	2	11
OG0004821	2	2	2	1	0	2	2	11
OG0004822	3	3	1	1	1	1	1	11
OG0004823	2	3	1	1	1	2	1	11
OG0004824	1	5	1	1	1	1	1	11
OG0004825	2	4	2	1	1	1	0	11
OG0004826	2	4	1	1	1	1	1	11
OG0004827	2	4	1	1	1	1	1	11
OG0004828	2	5	1	1	0	1	1	11
OG0004829	2	4	1	1	1	1	1	11
OG0004830	2	4	1	1	1	1	1	11
OG0004831	11	0	0	0	0	0	0	11
OG0004832	3	3	1	1	1	1	1	11
OG0004833	3	3	1	1	1	1	1	11
OG0004834	2	2	1	1	1	2	2	11
OG0004835	3	3	1	1	1	1	1	11
OG0004836	2	3	1	2	1	1	1	11
OG0004837	2	4	1	1	1	1	1	11
OG0004838	2	4	1	1	1	1	1	11
OG0004839	1	6	1	1	1	0	1	11
OG0004840	2	4	1	1	1	1	1	11
OG0004841	4	2	1	1	1	1	1	11
OG0004842	2	5	1	1	1	1	0	11
OG0004843	2	3	1	2	1	1	1	11
OG0004844	3	4	1	1	0	1	1	11
OG0004845	2	4	1	1	1	1	1	11
OG0004846	3	3	1	1	1	1	1	11
OG0004847	2	4	1	1	1	1	1	11
OG0004848	2	4	1	1	1	1	1	11
OG0004849	2	4	1	1	1	1	1	11
OG0004850	2	4	1	1	1	1	1	11
OG0004851	2	4	2	1	1	1	0	11
OG0004852	2	5	1	1	1	0	1	11
OG0004853	3	3	1	1	1	1	1	11
OG0004854	3	3	1	1	1	1	1	11
OG0004855	3	2	1	1	0	2	2	11
OG0004856	2	4	1	1	1	1	1	11
OG0004857	2	4	0	1	1	2	1	11
OG0004858	2	3	1	1	1	1	2	11
OG0004859	2	4	1	1	1	1	1	11
OG0004860	3	3	1	1	1	1	1	11
OG0004861	2	5	1	1	1	0	1	11
OG0004862	2	3	1	1	1	2	1	11
OG0004863	2	4	1	1	1	1	1	11
OG0004864	2	4	1	1	1	1	1	11
OG0004865	2	3	2	1	1	1	1	11
OG0004866	3	2	2	1	1	1	1	11
OG0004867	6	3	1	0	0	0	1	11
OG0004868	3	3	1	1	1	1	1	11
OG0004869	2	4	1	1	1	1	1	11
OG0004870	2	4	1	1	1	1	1	11
OG0004871	2	4	1	1	1	1	1	11
OG0004872	2	4	1	1	1	1	1	11
OG0004873	2	3	1	1	2	1	1	11
OG0004874	2	4	1	1	1	1	1	11
OG0004875	2	4	1	1	1	1	1	11
OG0004876	2	4	1	1	1	1	1	11
OG0004877	1	4	1	1	1	1	2	11
OG0004878	2	4	1	1	1	1	1	11
OG0004879	2	3	1	1	1	1	2	11
OG0004880	2	4	1	1	1	1	1	11
OG0004881	2	3	1	1	1	2	1	11
OG0004882	2	3	1	1	1	2	1	11
OG0004883	1	4	1	2	1	1	1	11
OG0004884	3	3	1	1	1	1	1	11
OG0004885	3	3	1	1	1	1	1	11
OG0004886	2	4	1	1	1	1	1	11
OG0004887	3	2	1	1	1	1	2	11
OG0004888	2	3	1	1	1	2	1	11
OG0004889	1	5	1	1	1	1	1	11
OG0004890	2	4	1	1	1	1	1	11
OG0004891	3	4	1	1	1	0	1	11
OG0004892	2	3	1	2	1	1	1	11
OG0004893	3	3	1	1	1	1	1	11
OG0004894	1	5	1	1	0	2	1	11
OG0004895	2	3	1	2	1	1	1	11
OG0004896	2	4	1	1	1	1	1	11
OG0004897	2	4	1	1	1	1	1	11
OG0004898	1	3	1	1	1	2	2	11
OG0004899	2	4	1	1	1	1	1	11
OG0004900	3	4	1	1	1	1	0	11
OG0004901	2	4	1	1	1	1	1	11
OG0004902	2	4	1	1	1	1	1	11
OG0004903	2	4	1	1	1	1	1	11
OG0004904	2	4	1	1	1	1	1	11
OG0004905	2	4	1	1	1	1	1	11
OG0004906	2	3	1	1	1	2	1	11
OG0004907	2	4	1	1	1	1	1	11
OG0004908	3	3	1	1	1	1	1	11
OG0004909	2	4	1	1	1	1	1	11
OG0004910	2	3	1	1	1	1	2	11
OG0004911	3	3	1	1	1	1	1	11
OG0004912	3	2	1	1	1	2	1	11
OG0004913	2	4	1	1	1	1	1	11
OG0004914	10	0	0	1	0	0	0	11
OG0004915	1	5	1	1	1	1	1	11
OG0004916	2	4	1	1	1	1	1	11
OG0004917	2	5	1	1	1	1	0	11
OG0004918	3	3	1	1	1	1	1	11
OG0004919	2	4	1	1	1	1	1	11
OG0004920	2	4	1	1	1	1	1	11
OG0004921	2	4	1	1	1	1	1	11
OG0004922	2	4	1	1	1	1	1	11
OG0004923	2	4	1	1	1	1	1	11
OG0004924	1	3	1	1	2	1	2	11
OG0004925	3	3	1	1	1	1	1	11
OG0004926	2	3	1	1	1	1	2	11
OG0004927	2	4	1	1	1	1	1	11
OG0004928	2	4	1	1	0	2	1	11
OG0004929	3	3	1	1	1	1	1	11
OG0004930	4	1	0	0	0	0	6	11
OG0004931	2	4	1	1	1	1	1	11
OG0004932	2	4	1	1	1	1	1	11
OG0004933	2	4	1	1	1	1	1	11
OG0004934	2	4	1	1	1	1	1	11
OG0004935	2	4	1	1	1	1	1	11
OG0004936	2	4	1	1	1	1	1	11
OG0004937	2	4	1	1	1	1	1	11
OG0004938	2	3	1	1	1	1	2	11
OG0004939	3	3	1	1	1	1	1	11
OG0004940	1	4	1	1	1	1	2	11
OG0004941	2	4	1	1	1	1	1	11
OG0004942	2	4	1	1	1	1	1	11
OG0004943	1	5	1	1	1	1	1	11
OG0004944	2	4	1	1	1	1	1	11
OG0004945	2	5	1	1	1	0	1	11
OG0004946	2	4	1	1	1	1	1	11
OG0004947	3	4	0	1	1	1	1	11
OG0004948	2	4	1	1	1	1	1	11
OG0004949	2	4	1	1	1	1	1	11
OG0004950	4	2	1	1	1	1	1	11
OG0004951	2	3	1	1	1	2	1	11
OG0004952	1	4	2	1	1	1	1	11
OG0004953	3	3	1	1	1	1	1	11
OG0004954	11	0	0	0	0	0	0	11
OG0004955	2	5	1	1	1	1	0	11
OG0004956	2	4	1	1	1	1	1	11
OG0004957	1	5	1	1	1	1	1	11
OG0004958	2	4	1	1	1	1	1	11
OG0004959	2	4	1	1	1	1	1	11
OG0004960	2	4	1	1	1	1	1	11
OG0004961	2	4	1	1	1	1	1	11
OG0004962	2	4	1	1	1	1	1	11
OG0004963	2	4	1	1	1	1	1	11
OG0004964	2	4	1	1	1	1	1	11
OG0004965	2	4	1	1	1	1	1	11
OG0004966	2	4	1	1	1	1	1	11
OG0004967	3	3	1	1	1	1	1	11
OG0004968	2	4	1	1	1	1	1	11
OG0004969	1	4	1	1	1	1	2	11
OG0004970	2	4	1	1	1	1	1	11
OG0004971	3	3	1	1	1	1	1	11
OG0004972	2	2	1	1	1	2	2	11
OG0004973	2	2	1	1	3	1	1	11
OG0004974	3	3	1	1	1	1	1	11
OG0004975	2	3	2	1	1	1	1	11
OG0004976	2	4	1	1	1	1	1	11
OG0004977	1	5	1	1	1	1	1	11
OG0004978	2	4	1	1	1	1	1	11
OG0004979	2	4	1	1	1	1	1	11
OG0004980	2	4	1	1	1	1	1	11
OG0004981	3	3	1	1	1	1	1	11
OG0004982	2	4	1	1	1	1	1	11
OG0004983	3	3	1	1	1	1	1	11
OG0004984	3	3	1	1	1	1	1	11
OG0004985	2	4	1	1	1	1	1	11
OG0004986	2	4	1	1	1	1	1	11
OG0004987	11	0	0	0	0	0	0	11
OG0004988	2	4	1	1	1	1	1	11
OG0004989	2	4	1	1	1	1	1	11
OG0004990	2	4	1	1	1	1	1	11
OG0004991	2	4	1	1	1	1	1	11
OG0004992	2	3	1	1	1	1	2	11
OG0004993	1	3	1	1	2	1	2	11
OG0004994	2	3	1	1	1	1	2	11
OG0004995	4	3	1	1	1	1	0	11
OG0004996	2	4	1	1	1	1	1	11
OG0004997	2	4	1	1	1	1	1	11
OG0004998	2	4	1	1	1	1	1	11
OG0004999	2	4	1	1	1	1	1	11
OG0005000	2	4	1	1	1	1	1	11
OG0005001	2	3	1	1	1	1	2	11
OG0005002	2	4	1	1	1	1	1	11
OG0005003	2	4	1	1	1	1	1	11
OG0005004	3	5	1	1	0	0	1	11
OG0005005	2	4	1	1	1	0	2	11
OG0005006	3	3	1	1	1	1	1	11
OG0005007	1	4	1	2	1	1	1	11
OG0005008	3	3	1	1	1	1	1	11
OG0005009	2	5	1	1	1	1	0	11
OG0005010	2	4	1	1	1	1	1	11
OG0005011	2	4	1	1	1	1	1	11
OG0005012	2	5	2	0	0	0	2	11
OG0005013	2	4	1	1	1	1	1	11
OG0005014	3	3	1	1	1	1	1	11
OG0005015	2	4	1	1	1	1	1	11
OG0005016	1	2	0	0	5	1	2	11
OG0005017	3	3	1	1	1	1	1	11
OG0005018	1	5	1	1	1	1	1	11
OG0005019	1	3	2	1	1	2	1	11
OG0005020	3	3	1	1	1	1	1	11
OG0005021	1	5	1	1	1	1	1	11
OG0005022	2	4	1	1	1	1	1	11
OG0005023	2	4	1	1	1	1	1	11
OG0005024	4	2	1	1	1	1	1	11
OG0005025	2	3	2	1	1	1	1	11
OG0005026	2	4	1	1	1	1	1	11
OG0005027	9	1	0	0	1	0	0	11
OG0005028	2	3	1	2	1	1	1	11
OG0005029	2	4	1	1	1	1	1	11
OG0005030	2	4	1	1	1	1	1	11
OG0005031	2	4	1	1	1	1	1	11
OG0005032	3	3	1	1	1	1	1	11
OG0005033	2	4	1	1	1	1	1	11
OG0005034	3	3	1	1	1	1	1	11
OG0005035	2	4	1	1	1	1	1	11
OG0005036	3	3	1	1	1	1	1	11
OG0005037	1	5	1	1	1	1	1	11
OG0005038	2	4	1	1	1	1	1	11
OG0005039	2	4	1	1	1	1	1	11
OG0005040	2	4	1	1	1	1	1	11
OG0005041	3	3	1	1	1	1	1	11
OG0005042	2	3	1	1	1	2	1	11
OG0005043	2	4	1	1	1	1	1	11
OG0005044	1	3	1	1	1	1	3	11
OG0005045	2	4	1	1	1	1	1	11
OG0005046	3	3	1	1	1	1	1	11
OG0005047	1	4	1	1	2	1	1	11
OG0005048	2	3	2	1	1	1	1	11
OG0005049	4	2	1	1	1	1	1	11
OG0005050	4	3	1	1	0	1	1	11
OG0005051	2	4	1	1	1	1	1	11
OG0005052	1	5	1	1	1	1	1	11
OG0005053	2	4	1	1	1	1	1	11
OG0005054	3	4	0	0	1	2	1	11
OG0005055	3	3	1	1	1	1	1	11
OG0005056	2	4	1	1	1	1	1	11
OG0005057	10	0	1	0	0	0	0	11
OG0005058	2	4	1	1	1	1	1	11
OG0005059	4	2	0	1	1	1	2	11
OG0005060	2	4	1	1	1	1	1	11
OG0005061	1	5	1	1	1	1	1	11
OG0005062	2	3	1	1	1	1	2	11
OG0005063	1	5	1	1	1	1	1	11
OG0005064	2	4	1	1	1	1	1	11
OG0005065	2	4	1	1	1	1	1	11
OG0005066	2	4	1	1	1	1	1	11
OG0005067	2	3	1	1	2	1	1	11
OG0005068	2	4	1	1	1	1	1	11
OG0005069	2	3	1	1	1	2	1	11
OG0005070	2	4	1	1	1	1	1	11
OG0005071	3	3	0	2	1	1	1	11
OG0005072	2	3	1	1	1	2	1	11
OG0005073	2	4	1	1	1	1	1	11
OG0005074	3	3	1	1	1	1	1	11
OG0005075	2	4	1	1	1	1	1	11
OG0005076	2	4	1	1	1	1	1	11
OG0005077	2	3	1	1	1	1	2	11
OG0005078	2	4	1	1	1	1	1	11
OG0005079	2	5	1	0	1	1	1	11
OG0005080	2	4	1	1	1	1	1	11
OG0005081	2	4	1	1	1	1	1	11
OG0005082	2	4	1	1	1	1	1	11
OG0005083	2	4	1	1	1	1	1	11
OG0005084	2	4	1	1	1	1	1	11
OG0005085	2	3	1	1	2	1	1	11
OG0005086	9	1	0	0	1	0	0	11
OG0005087	3	4	1	0	1	1	1	11
OG0005088	2	3	1	1	1	1	2	11
OG0005089	11	0	0	0	0	0	0	11
OG0005090	2	4	1	1	1	1	1	11
OG0005091	2	3	2	1	1	1	1	11
OG0005092	2	4	1	1	1	1	1	11
OG0005093	2	4	1	1	1	1	1	11
OG0005094	3	3	1	1	1	1	1	11
OG0005095	2	4	1	1	1	1	1	11
OG0005096	1	4	1	1	2	1	1	11
OG0005097	2	4	1	1	1	1	1	11
OG0005098	2	5	1	1	1	1	0	11
OG0005099	2	4	1	1	1	1	1	11
OG0005100	3	4	1	1	1	0	1	11
OG0005101	2	4	1	1	1	1	1	11
OG0005102	1	5	1	1	1	1	1	11
OG0005103	2	4	1	1	1	1	1	11
OG0005104	3	4	1	1	1	1	0	11
OG0005105	2	4	1	1	1	1	1	11
OG0005106	1	5	1	1	1	1	1	11
OG0005107	2	4	1	1	1	1	1	11
OG0005108	2	4	1	1	1	1	1	11
OG0005109	2	4	1	1	1	1	1	11
OG0005110	2	3	1	1	1	2	1	11
OG0005111	2	4	1	1	1	1	1	11
OG0005112	2	4	1	1	1	1	1	11
OG0005113	3	3	1	1	1	1	1	11
OG0005114	1	4	1	1	1	2	1	11
OG0005115	3	3	1	1	1	1	1	11
OG0005116	2	4	1	1	1	1	1	11
OG0005117	3	3	1	1	1	1	1	11
OG0005118	2	4	1	1	1	1	1	11
OG0005119	4	1	1	2	1	1	1	11
OG0005120	1	5	1	1	1	1	1	11
OG0005121	4	1	1	1	1	2	1	11
OG0005122	3	3	1	1	1	1	1	11
OG0005123	2	4	1	1	1	1	1	11
OG0005124	2	4	1	1	1	1	1	11
OG0005125	1	5	1	1	1	1	1	11
OG0005126	2	4	1	1	1	1	1	11
OG0005127	2	2	1	1	1	2	2	11
OG0005128	2	4	1	1	1	1	1	11
OG0005129	3	4	1	1	0	1	1	11
OG0005130	3	3	1	1	1	1	1	11
OG0005131	1	5	1	1	1	1	1	11
OG0005132	2	4	1	1	1	1	1	11
OG0005133	2	4	1	1	1	1	1	11
OG0005134	2	4	1	1	1	1	1	11
OG0005135	2	4	1	1	1	1	1	11
OG0005136	2	2	1	2	1	2	1	11
OG0005137	2	4	1	1	1	1	1	11
OG0005138	2	3	1	2	1	1	1	11
OG0005139	2	4	1	1	1	1	1	11
OG0005140	2	4	1	1	1	1	1	11
OG0005141	2	4	1	1	1	1	1	11
OG0005142	2	4	1	1	1	1	1	11
OG0005143	1	4	1	1	1	1	2	11
OG0005144	2	5	1	1	1	0	1	11
OG0005145	2	4	1	1	1	1	1	11
OG0005146	2	4	1	1	1	1	1	11
OG0005147	3	3	1	1	1	1	1	11
OG0005148	2	4	2	1	0	1	1	11
OG0005149	1	5	1	1	1	1	1	11
OG0005150	2	3	1	1	1	1	2	11
OG0005151	2	4	1	1	1	1	1	11
OG0005152	2	4	1	1	1	1	1	11
OG0005153	3	4	1	1	1	1	0	11
OG0005154	2	3	1	1	1	2	1	11
OG0005155	2	4	1	1	1	1	1	11
OG0005156	2	4	1	1	1	1	1	11
OG0005157	2	4	1	1	1	1	1	11
OG0005158	2	5	1	1	1	1	0	11
OG0005159	2	4	1	1	1	1	1	11
OG0005160	2	4	1	1	1	1	1	11
OG0005161	3	3	1	1	1	1	1	11
OG0005162	2	4	1	1	1	1	1	11
OG0005163	2	4	1	1	1	1	1	11
OG0005164	2	4	1	1	1	1	1	11
OG0005165	3	4	1	1	1	1	0	11
OG0005166	3	3	1	1	1	1	1	11
OG0005167	4	2	1	1	1	1	1	11
OG0005168	2	4	1	1	1	1	1	11
OG0005169	2	4	1	1	1	1	1	11
OG0005170	2	4	1	1	1	1	1	11
OG0005171	3	2	1	1	2	1	1	11
OG0005172	2	3	1	1	1	2	1	11
OG0005173	2	4	1	1	0	2	1	11
OG0005174	2	4	1	1	1	1	1	11
OG0005175	2	4	1	1	1	1	1	11
OG0005176	2	4	1	1	1	1	1	11
OG0005177	2	4	1	1	1	1	1	11
OG0005178	2	4	1	1	1	1	1	11
OG0005179	2	4	1	1	1	1	1	11
OG0005180	1	5	1	1	1	1	1	11
OG0005181	2	4	1	1	1	1	1	11
OG0005182	2	4	1	1	1	1	1	11
OG0005183	2	4	1	1	1	1	1	11
OG0005184	2	4	1	1	1	1	1	11
OG0005185	2	3	2	1	1	1	1	11
OG0005186	2	4	1	1	1	1	1	11
OG0005187	2	4	1	1	1	1	1	11
OG0005188	2	4	1	1	1	1	1	11
OG0005189	2	5	1	1	1	1	0	11
OG0005190	2	4	1	1	1	1	1	11
OG0005191	2	4	1	1	1	1	1	11
OG0005192	2	3	1	1	1	1	2	11
OG0005193	2	4	1	1	1	1	1	11
OG0005194	2	4	1	1	1	1	1	11
OG0005195	2	0	2	2	2	1	2	11
OG0005196	3	3	2	1	1	0	1	11
OG0005197	3	3	2	1	1	1	0	11
OG0005198	2	4	1	1	1	1	1	11
OG0005199	2	4	1	1	1	1	1	11
OG0005200	3	3	1	1	1	1	1	11
OG0005201	2	4	1	1	1	1	1	11
OG0005202	1	3	2	2	0	0	3	11
OG0005203	3	3	1	1	1	1	1	11
OG0005204	2	4	1	1	1	1	1	11
OG0005205	2	4	1	1	1	1	1	11
OG0005206	3	3	1	1	1	1	1	11
OG0005207	2	4	1	1	1	1	1	11
OG0005208	1	5	1	1	1	1	1	11
OG0005209	2	4	1	1	1	1	1	11
OG0005210	3	3	1	1	1	1	1	11
OG0005211	2	4	1	1	1	1	1	11
OG0005212	1	5	1	1	1	1	1	11
OG0005213	2	4	1	1	1	1	1	11
OG0005214	2	4	1	1	1	1	1	11
OG0005215	2	3	1	1	1	2	1	11
OG0005216	2	4	1	1	1	1	1	11
OG0005217	2	4	1	1	1	1	1	11
OG0005218	2	4	1	1	1	1	1	11
OG0005219	2	2	1	1	1	1	3	11
OG0005220	3	2	2	1	1	1	1	11
OG0005221	2	4	1	1	1	1	1	11
OG0005222	3	4	1	1	1	0	1	11
OG0005223	3	3	1	1	1	1	1	11
OG0005224	3	3	1	1	1	1	1	11
OG0005225	3	3	1	1	1	1	1	11
OG0005226	2	4	1	1	1	1	1	11
OG0005227	2	4	1	1	1	1	1	11
OG0005228	2	3	1	1	1	1	2	11
OG0005229	2	4	1	1	1	1	1	11
OG0005230	2	4	1	1	1	1	1	11
OG0005231	2	3	1	1	1	1	2	11
OG0005232	2	4	1	1	1	1	1	11
OG0005233	2	4	1	1	1	1	1	11
OG0005234	3	3	1	1	1	1	1	11
OG0005235	3	3	1	1	1	1	1	11
OG0005236	3	3	1	1	1	1	1	11
OG0005237	2	4	1	1	1	1	1	11
OG0005238	1	5	1	1	1	1	1	11
OG0005239	4	2	1	1	1	1	1	11
OG0005240	2	4	1	1	1	1	1	11
OG0005241	2	4	1	1	1	1	1	11
OG0005242	2	4	1	1	1	1	1	11
OG0005243	2	4	1	1	1	1	1	11
OG0005244	2	4	1	1	1	1	1	11
OG0005245	2	4	1	1	1	1	1	11
OG0005246	2	4	1	1	1	1	1	11
OG0005247	2	4	1	1	1	1	1	11
OG0005248	2	4	1	1	1	1	1	11
OG0005249	3	3	1	1	1	1	1	11
OG0005250	1	4	1	1	1	2	1	11
OG0005251	3	3	1	1	1	1	1	11
OG0005252	2	4	1	1	1	1	1	11
OG0005253	4	2	1	1	1	1	1	11
OG0005254	3	3	1	1	1	1	1	11
OG0005255	2	4	1	1	1	1	1	11
OG0005256	2	4	1	1	1	1	1	11
OG0005257	2	4	1	1	1	1	1	11
OG0005258	3	3	1	1	1	1	1	11
OG0005259	2	4	1	1	1	1	1	11
OG0005260	2	3	1	1	1	1	2	11
OG0005261	2	4	1	1	1	1	1	11
OG0005262	2	4	1	1	1	1	1	11
OG0005263	2	4	1	1	1	1	1	11
OG0005264	3	3	1	1	1	1	1	11
OG0005265	1	4	1	2	1	1	1	11
OG0005266	2	4	1	1	1	1	1	11
OG0005267	4	1	1	1	1	2	1	11
OG0005268	2	4	1	1	1	1	1	11
OG0005269	2	3	1	1	1	2	1	11
OG0005270	3	2	1	1	1	1	2	11
OG0005271	2	4	1	1	1	1	1	11
OG0005272	2	4	1	1	1	1	1	11
OG0005273	2	4	1	1	1	1	1	11
OG0005274	2	4	1	2	0	1	1	11
OG0005275	2	4	1	1	1	1	1	11
OG0005276	2	4	1	1	1	1	1	11
OG0005277	2	4	1	1	1	1	1	11
OG0005278	2	4	1	1	1	1	1	11
OG0005279	2	4	1	1	1	1	1	11
OG0005280	3	3	1	1	1	1	1	11
OG0005281	2	4	1	1	1	1	1	11
OG0005282	2	4	1	1	1	1	1	11
OG0005283	4	1	2	0	0	0	4	11
OG0005284	2	4	1	1	1	1	1	11
OG0005285	2	4	1	1	1	1	1	11
OG0005286	1	4	2	1	1	1	1	11
OG0005287	2	4	1	1	1	1	1	11
OG0005288	1	4	1	1	1	2	1	11
OG0005289	2	3	2	1	1	1	1	11
OG0005290	2	4	1	1	1	1	1	11
OG0005291	2	4	1	1	1	1	1	11
OG0005292	1	4	1	1	1	1	2	11
OG0005293	2	4	1	1	1	1	1	11
OG0005294	4	3	1	0	1	1	1	11
OG0005295	1	5	1	1	1	1	1	11
OG0005296	2	4	1	1	1	1	1	11
OG0005297	2	4	1	1	1	1	1	11
OG0005298	2	4	1	1	1	1	1	11
OG0005299	1	5	1	1	1	1	1	11
OG0005300	2	4	1	1	1	1	1	11
OG0005301	6	0	1	1	2	1	0	11
OG0005302	2	4	1	1	1	1	1	11
OG0005303	2	4	1	1	1	1	1	11
OG0005304	2	4	1	1	1	1	1	11
OG0005305	2	2	1	1	0	2	3	11
OG0005306	4	2	1	1	1	1	1	11
OG0005307	2	4	1	1	1	1	1	11
OG0005308	2	4	1	1	1	1	1	11
OG0005309	2	4	1	1	1	1	1	11
OG0005310	3	2	1	1	1	1	2	11
OG0005311	3	3	1	1	1	1	1	11
OG0005312	2	4	1	1	1	1	1	11
OG0005313	2	4	1	1	1	1	1	11
OG0005314	2	4	1	1	1	1	1	11
OG0005315	2	4	1	1	1	1	1	11
OG0005316	3	4	1	0	1	1	1	11
OG0005317	2	4	1	1	1	1	1	11
OG0005318	2	4	1	1	1	1	1	11
OG0005319	4	2	2	1	1	0	1	11
OG0005320	2	4	1	1	1	1	1	11
OG0005321	2	3	2	1	1	1	1	11
OG0005322	2	6	2	0	0	0	1	11
OG0005323	2	4	1	1	1	1	1	11
OG0005324	2	4	1	1	1	0	2	11
OG0005325	2	4	1	1	1	1	1	11
OG0005326	1	5	1	1	1	1	1	11
OG0005327	3	3	1	1	1	1	1	11
OG0005328	4	2	1	1	1	1	1	11
OG0005329	2	3	1	1	1	1	2	11
OG0005330	2	4	1	1	1	1	1	11
OG0005331	2	4	1	1	1	1	1	11
OG0005332	1	4	1	2	1	1	1	11
OG0005333	3	3	1	1	1	1	1	11
OG0005334	2	3	1	1	1	1	2	11
OG0005335	2	3	2	1	1	1	1	11
OG0005336	3	3	1	1	1	1	1	11
OG0005337	2	4	1	1	1	1	1	11
OG0005338	2	4	1	1	1	1	1	11
OG0005339	3	3	1	1	1	1	1	11
OG0005340	2	4	1	1	1	1	1	11
OG0005341	2	4	1	1	1	1	1	11
OG0005342	2	4	1	1	1	1	1	11
OG0005343	2	4	1	1	1	1	1	11
OG0005344	2	4	1	1	1	1	1	11
OG0005345	2	4	1	1	1	1	1	11
OG0005346	3	4	1	1	1	1	0	11
OG0005347	2	3	1	1	1	1	2	11
OG0005348	3	3	1	1	1	1	1	11
OG0005349	5	2	1	1	0	1	1	11
OG0005350	2	4	1	1	1	1	1	11
OG0005351	3	3	1	1	1	1	1	11
OG0005352	2	4	1	1	1	1	1	11
OG0005353	2	4	1	1	1	1	1	11
OG0005354	1	3	1	2	1	1	2	11
OG0005355	2	4	1	1	1	1	1	11
OG0005356	1	5	1	1	1	1	1	11
OG0005357	2	4	1	1	1	1	1	11
OG0005358	3	3	1	1	1	1	1	11
OG0005359	2	3	1	1	1	1	2	11
OG0005360	3	3	1	1	1	1	1	11
OG0005361	2	3	1	1	1	2	1	11
OG0005362	1	5	1	1	1	1	1	11
OG0005363	1	5	1	1	1	1	1	11
OG0005364	3	3	1	1	1	1	1	11
OG0005365	2	3	1	1	1	1	2	11
OG0005366	2	4	1	1	1	1	1	11
OG0005367	2	5	1	0	1	1	1	11
OG0005368	3	4	1	0	1	1	1	11
OG0005369	5	2	1	1	1	0	1	11
OG0005370	2	4	1	1	1	1	1	11
OG0005371	2	3	1	1	1	2	1	11
OG0005372	2	4	1	1	1	1	1	11
OG0005373	2	3	1	1	1	1	2	11
OG0005374	2	4	1	1	1	1	1	11
OG0005375	2	4	1	1	1	1	1	11
OG0005376	2	4	1	1	1	1	1	11
OG0005377	2	4	1	1	1	1	1	11
OG0005378	2	4	1	1	1	1	1	11
OG0005379	3	2	1	1	1	1	2	11
OG0005380	2	4	1	1	1	1	1	11
OG0005381	2	4	1	1	1	1	1	11
OG0005382	3	3	1	1	1	1	1	11
OG0005383	2	4	1	1	1	1	1	11
OG0005384	2	3	1	1	1	1	2	11
OG0005385	2	4	1	1	1	1	1	11
OG0005386	3	3	1	1	1	1	1	11
OG0005387	2	4	1	1	1	1	1	11
OG0005388	4	2	1	1	1	1	1	11
OG0005389	3	3	1	1	1	1	1	11
OG0005390	2	4	1	1	1	1	1	11
OG0005391	1	2	2	1	1	2	2	11
OG0005392	3	2	1	1	1	2	1	11
OG0005393	2	3	1	1	1	1	2	11
OG0005394	2	4	1	1	1	1	1	11
OG0005395	2	4	1	1	1	1	1	11
OG0005396	1	5	1	1	1	1	1	11
OG0005397	1	4	0	2	1	2	1	11
OG0005398	2	4	1	1	1	1	1	11
OG0005399	3	3	1	1	1	1	1	11
OG0005400	1	4	1	1	1	1	2	11
OG0005401	2	3	1	2	1	1	1	11
OG0005402	3	3	1	1	1	1	1	11
OG0005403	2	4	1	1	1	1	1	11
OG0005404	2	4	1	1	1	1	1	11
OG0005405	2	5	1	1	1	0	1	11
OG0005406	2	4	1	1	1	1	1	11
OG0005407	2	4	1	1	1	1	1	11
OG0005408	3	3	1	1	1	1	1	11
OG0005409	2	4	1	1	1	1	1	11
OG0005410	3	3	1	1	1	1	1	11
OG0005411	3	3	1	1	1	1	1	11
OG0005412	2	4	1	1	1	1	1	11
OG0005413	2	4	1	1	2	0	1	11
OG0005414	2	4	1	1	1	1	1	11
OG0005415	2	3	2	1	1	1	1	11
OG0005416	2	3	1	1	1	2	1	11
OG0005417	2	4	1	1	1	0	2	11
OG0005418	2	3	1	1	1	2	1	11
OG0005419	3	2	1	1	1	1	2	11
OG0005420	3	3	1	1	1	1	1	11
OG0005421	2	2	1	1	1	3	1	11
OG0005422	1	5	1	1	1	1	1	11
OG0005423	2	4	1	1	1	1	1	11
OG0005424	2	4	1	1	1	1	1	11
OG0005425	3	3	1	1	1	1	1	11
OG0005426	2	5	1	1	1	0	1	11
OG0005427	4	2	0	0	2	2	1	11
OG0005428	4	3	1	0	1	1	1	11
OG0005429	2	4	1	1	1	1	1	11
OG0005430	2	4	1	1	1	1	1	11
OG0005431	2	4	1	1	1	1	1	11
OG0005432	3	3	1	1	1	1	1	11
OG0005433	2	4	1	1	1	1	1	11
OG0005434	2	4	1	1	1	1	1	11
OG0005435	2	4	1	2	0	1	1	11
OG0005436	3	4	1	1	1	0	1	11
OG0005437	2	4	1	1	1	1	1	11
OG0005438	2	4	1	1	1	1	1	11
OG0005439	2	4	1	1	1	1	1	11
OG0005440	2	4	1	1	1	1	1	11
OG0005441	2	4	1	1	1	1	1	11
OG0005442	2	4	1	1	1	1	1	11
OG0005443	2	4	1	1	1	1	1	11
OG0005444	3	3	1	1	1	1	1	11
OG0005445	2	4	1	1	1	1	1	11
OG0005446	2	4	1	1	1	1	1	11
OG0005447	2	4	1	1	1	1	1	11
OG0005448	2	5	1	1	1	1	0	11
OG0005449	2	4	1	1	1	1	1	11
OG0005450	1	4	1	2	1	1	1	11
OG0005451	2	5	1	0	1	1	1	11
OG0005452	3	3	1	1	1	1	1	11
OG0005453	3	3	1	1	1	1	1	11
OG0005454	2	4	1	1	1	1	1	11
OG0005455	2	4	1	1	1	1	1	11
OG0005456	2	4	1	1	1	1	1	11
OG0005457	1	5	1	1	1	1	1	11
OG0005458	2	3	1	1	1	2	1	11
OG0005459	1	5	1	1	1	1	1	11
OG0005460	1	4	1	2	1	1	1	11
OG0005461	2	3	1	2	1	1	1	11
OG0005462	2	4	1	1	1	1	1	11
OG0005463	2	4	1	1	1	1	1	11
OG0005464	2	4	1	1	1	1	1	11
OG0005465	2	4	1	1	1	1	1	11
OG0005466	2	4	1	1	1	1	1	11
OG0005467	2	2	1	1	1	2	2	11
OG0005468	2	4	1	1	1	1	1	11
OG0005469	2	4	1	1	1	1	1	11
OG0005470	10	1	0	0	0	0	0	11
OG0005471	2	4	1	1	1	1	1	11
OG0005472	2	3	1	1	1	0	3	11
OG0005473	2	4	1	1	1	1	1	11
OG0005474	3	3	1	1	1	1	1	11
OG0005475	3	3	1	1	1	1	1	11
OG0005476	3	3	1	1	1	1	1	11
OG0005477	2	3	1	1	2	1	1	11
OG0005478	2	2	1	3	0	1	2	11
OG0005479	2	5	1	1	1	0	1	11
OG0005480	2	4	1	1	1	1	1	11
OG0005481	2	3	1	1	2	1	1	11
OG0005482	2	4	1	1	1	1	1	11
OG0005483	1	5	1	1	1	1	1	11
OG0005484	2	4	1	1	1	1	1	11
OG0005485	2	4	1	1	1	1	1	11
OG0005486	3	3	1	1	1	1	1	11
OG0005487	2	4	1	1	1	1	1	11
OG0005488	2	4	1	1	1	1	1	11
OG0005489	1	5	1	1	1	1	1	11
OG0005490	2	4	1	1	1	1	1	11
OG0005491	2	4	1	1	1	1	1	11
OG0005492	2	4	1	1	1	1	1	11
OG0005493	1	5	1	1	1	1	1	11
OG0005494	1	4	1	1	1	2	1	11
OG0005495	2	4	1	1	1	1	1	11
OG0005496	2	4	1	1	1	1	1	11
OG0005497	1	5	1	1	1	1	1	11
OG0005498	2	4	1	1	1	1	1	11
OG0005499	1	4	1	1	1	1	2	11
OG0005500	1	3	2	1	1	1	2	11
OG0005501	2	3	2	1	1	1	1	11
OG0005502	2	2	1	1	1	3	1	11
OG0005503	2	3	2	1	1	1	1	11
OG0005504	3	3	1	1	1	1	1	11
OG0005505	1	5	1	1	0	2	1	11
OG0005506	3	3	1	1	1	1	1	11
OG0005507	2	4	1	1	1	1	1	11
OG0005508	2	4	1	1	1	1	1	11
OG0005509	2	4	1	1	1	1	1	11
OG0005510	2	4	1	1	1	1	1	11
OG0005511	2	5	1	1	1	0	1	11
OG0005512	2	4	1	1	1	1	1	11
OG0005513	2	4	1	1	1	1	1	11
OG0005514	2	4	1	1	1	1	1	11
OG0005515	2	4	1	1	1	1	1	11
OG0005516	2	3	1	1	1	2	1	11
OG0005517	3	3	1	1	1	1	1	11
OG0005518	2	4	1	1	1	1	1	11
OG0005519	3	3	1	1	1	1	1	11
OG0005520	2	4	1	1	1	1	1	11
OG0005521	2	4	1	1	1	1	1	11
OG0005522	2	4	1	1	1	1	1	11
OG0005523	2	3	1	2	1	1	1	11
OG0005524	3	3	1	1	1	1	1	11
OG0005525	2	4	1	1	1	1	1	11
OG0005526	3	3	1	1	1	1	1	11
OG0005527	2	4	1	1	1	1	1	11
OG0005528	1	4	2	1	1	1	1	11
OG0005529	2	4	1	1	1	1	1	11
OG0005530	3	3	1	1	1	0	2	11
OG0005531	2	5	1	1	1	0	1	11
OG0005532	3	3	1	1	1	1	1	11
OG0005533	2	4	1	1	1	1	1	11
OG0005534	1	5	1	1	1	1	1	11
OG0005535	2	3	1	1	1	1	2	11
OG0005536	2	3	1	1	1	2	1	11
OG0005537	2	4	1	1	1	1	1	11
OG0005538	2	4	1	1	1	1	1	11
OG0005539	2	4	1	1	1	1	1	11
OG0005540	2	4	1	1	1	1	1	11
OG0005541	1	5	1	1	1	1	1	11
OG0005542	2	4	1	1	1	1	1	11
OG0005543	2	4	1	1	1	1	1	11
OG0005544	2	4	1	1	1	1	1	11
OG0005545	2	5	1	1	1	1	0	11
OG0005546	2	3	1	1	1	1	2	11
OG0005547	2	4	1	1	1	1	1	11
OG0005548	2	4	1	1	1	1	1	11
OG0005549	2	4	1	1	1	1	1	11
OG0005550	3	3	0	1	1	1	2	11
OG0005551	2	4	1	1	1	1	1	11
OG0005552	2	4	1	1	1	1	1	11
OG0005553	2	4	1	1	1	1	1	11
OG0005554	3	3	1	1	1	1	1	11
OG0005555	2	3	1	2	1	1	1	11
OG0005556	1	3	1	1	1	1	3	11
OG0005557	1	0	1	3	3	2	1	11
OG0005558	2	4	1	1	1	1	1	11
OG0005559	2	3	1	2	1	1	1	11
OG0005560	2	4	1	1	1	1	1	11
OG0005561	2	3	1	1	1	1	2	11
OG0005562	3	2	1	1	2	1	1	11
OG0005563	2	4	1	1	1	1	1	11
OG0005564	2	4	1	1	1	1	1	11
OG0005565	2	4	1	1	1	1	1	11
OG0005566	2	4	1	1	1	1	1	11
OG0005567	2	4	1	1	1	1	1	11
OG0005568	2	4	1	1	1	1	1	11
OG0005569	2	3	1	1	1	1	2	11
OG0005570	3	3	1	1	1	1	1	11
OG0005571	3	3	1	1	1	1	1	11
OG0005572	2	4	1	1	1	1	1	11
OG0005573	3	2	1	1	1	2	1	11
OG0005574	3	3	1	1	1	1	1	11
OG0005575	2	3	1	1	1	2	1	11
OG0005576	2	4	1	1	1	1	1	11
OG0005577	1	5	1	1	1	1	1	11
OG0005578	2	4	1	1	1	1	1	11
OG0005579	2	3	1	1	1	2	1	11
OG0005580	2	4	1	1	1	1	1	11
OG0005581	2	4	1	1	1	1	1	11
OG0005582	3	3	1	1	1	1	1	11
OG0005583	3	3	1	1	1	1	1	11
OG0005584	2	4	1	1	1	1	1	11
OG0005585	2	4	1	1	1	1	1	11
OG0005586	2	3	1	1	1	1	2	11
OG0005587	2	4	1	1	1	1	1	11
OG0005588	1	4	2	1	1	1	1	11
OG0005589	2	4	1	1	1	1	1	11
OG0005590	1	3	1	1	1	1	3	11
OG0005591	3	3	1	1	1	1	1	11
OG0005592	2	4	1	1	1	1	1	11
OG0005593	1	2	1	1	2	2	2	11
OG0005594	2	4	1	1	1	1	1	11
OG0005595	2	3	1	1	2	1	1	11
OG0005596	2	4	1	1	1	1	1	11
OG0005597	2	4	1	1	1	1	1	11
OG0005598	2	4	1	1	1	1	1	11
OG0005599	2	5	1	1	1	0	1	11
OG0005600	2	4	1	1	1	1	1	11
OG0005601	2	3	2	1	1	1	1	11
OG0005602	2	4	1	1	1	1	1	11
OG0005603	2	4	1	1	1	1	1	11
OG0005604	2	4	1	1	1	1	1	11
OG0005605	2	4	1	1	1	1	1	11
OG0005606	1	5	1	0	1	1	2	11
OG0005607	2	4	1	1	1	1	1	11
OG0005608	1	2	1	1	1	2	3	11
OG0005609	1	4	2	1	1	1	1	11
OG0005610	2	3	1	2	1	1	1	11
OG0005611	1	3	1	1	1	1	3	11
OG0005612	2	4	1	1	1	1	1	11
OG0005613	3	4	1	1	1	1	0	11
OG0005614	2	4	1	1	1	1	1	11
OG0005615	4	2	1	1	1	1	1	11
OG0005616	1	5	1	1	1	1	1	11
OG0005617	2	4	1	1	1	1	1	11
OG0005618	2	4	1	1	1	1	1	11
OG0005619	2	4	1	1	1	1	1	11
OG0005620	3	3	1	1	1	1	1	11
OG0005621	2	4	1	1	1	1	1	11
OG0005622	2	3	1	1	1	1	2	11
OG0005623	1	2	1	1	2	2	2	11
OG0005624	1	4	1	1	1	1	2	11
OG0005625	2	4	1	1	1	1	1	11
OG0005626	2	4	1	1	1	1	1	11
OG0005627	2	4	1	1	1	1	1	11
OG0005628	2	4	1	1	1	1	1	11
OG0005629	2	4	1	1	1	1	1	11
OG0005630	3	3	1	1	1	1	1	11
OG0005631	2	3	1	1	1	2	1	11
OG0005632	2	4	1	1	1	1	1	11
OG0005633	2	4	1	1	1	1	1	11
OG0005634	2	3	1	1	1	1	2	11
OG0005635	2	4	1	1	1	1	1	11
OG0005636	1	3	1	1	1	2	2	11
OG0005637	2	4	1	1	1	1	1	11
OG0005638	2	4	1	1	1	1	1	11
OG0005639	2	4	1	1	1	1	1	11
OG0005640	2	4	1	1	1	1	1	11
OG0005641	2	4	1	1	1	1	1	11
OG0005642	11	0	0	0	0	0	0	11
OG0005643	2	4	1	1	1	1	1	11
OG0005644	2	4	1	1	1	1	1	11
OG0005645	2	4	1	1	1	1	1	11
OG0005646	1	5	1	1	1	1	1	11
OG0005647	4	3	1	1	1	0	1	11
OG0005648	3	3	1	1	1	1	1	11
OG0005649	2	4	1	1	1	1	1	11
OG0005650	2	4	1	1	1	1	1	11
OG0005651	2	4	1	1	1	1	1	11
OG0005652	2	4	1	1	1	2	0	11
OG0005653	2	4	1	1	1	1	1	11
OG0005654	2	4	1	1	1	1	1	11
OG0005655	2	4	1	1	1	1	1	11
OG0005656	2	4	1	1	1	1	1	11
OG0005657	1	5	1	1	1	1	1	11
OG0005658	2	3	1	1	1	2	1	11
OG0005659	1	5	1	1	1	1	1	11
OG0005660	2	4	1	1	1	1	1	11
OG0005661	2	3	1	1	1	1	2	11
OG0005662	2	4	1	1	1	1	1	11
OG0005663	1	4	1	1	2	1	1	11
OG0005664	2	3	1	1	1	1	2	11
OG0005665	3	2	1	1	1	2	1	11
OG0005666	3	3	1	1	1	1	1	11
OG0005667	4	2	1	1	1	1	1	11
OG0005668	2	4	1	1	1	1	1	11
OG0005669	2	3	1	1	1	2	1	11
OG0005670	2	4	1	1	1	1	1	11
OG0005671	2	4	1	1	1	1	1	11
OG0005672	2	4	2	1	1	0	1	11
OG0005673	1	3	1	1	1	1	3	11
OG0005674	2	4	1	1	1	1	1	11
OG0005675	3	3	1	1	1	1	1	11
OG0005676	2	4	1	1	1	1	1	11
OG0005677	2	4	1	1	1	1	1	11
OG0005678	1	5	1	1	1	1	1	11
OG0005679	1	6	1	0	1	1	1	11
OG0005680	2	4	1	1	1	1	1	11
OG0005681	2	4	1	1	1	1	1	11
OG0005682	2	4	1	1	1	1	1	11
OG0005683	2	4	1	1	1	1	1	11
OG0005684	1	4	1	2	1	1	1	11
OG0005685	2	4	1	1	1	1	1	11
OG0005686	2	4	1	1	1	1	1	11
OG0005687	2	5	1	1	0	1	1	11
OG0005688	2	4	1	1	1	1	1	11
OG0005689	3	3	1	1	1	1	1	11
OG0005690	2	4	1	1	1	1	1	11
OG0005691	2	4	1	1	1	1	1	11
OG0005692	2	4	1	1	1	1	1	11
OG0005693	2	4	1	1	1	1	1	11
OG0005694	2	4	1	1	1	1	1	11
OG0005695	2	4	1	1	1	1	1	11
OG0005696	2	3	2	1	1	1	1	11
OG0005697	3	3	1	1	1	0	2	11
OG0005698	2	4	1	1	1	1	1	11
OG0005699	2	4	1	1	1	1	1	11
OG0005700	2	3	1	1	1	1	2	11
OG0005701	2	4	1	1	1	1	1	11
OG0005702	2	4	1	1	1	1	1	11
OG0005703	2	5	1	1	1	1	0	11
OG0005704	2	4	1	1	1	1	1	11
OG0005705	3	3	1	1	1	1	1	11
OG0005706	2	4	1	1	1	1	1	11
OG0005707	5	1	1	1	1	1	1	11
OG0005708	1	3	1	1	1	2	2	11
OG0005709	2	4	1	1	1	1	1	11
OG0005710	2	4	1	1	1	1	1	11
OG0005711	2	4	1	1	1	1	1	11
OG0005712	3	3	1	1	1	1	1	11
OG0005713	2	4	1	1	1	1	1	11
OG0005714	2	4	1	1	1	1	1	11
OG0005715	2	4	1	1	1	1	1	11
OG0005716	2	4	1	1	1	1	1	11
OG0005717	2	3	0	1	1	2	2	11
OG0005718	2	4	1	1	1	1	1	11
OG0005719	3	3	1	1	1	1	1	11
OG0005720	3	3	1	1	1	1	1	11
OG0005721	2	4	1	1	1	1	1	11
OG0005722	3	3	1	1	1	2	0	11
OG0005723	2	3	1	1	0	2	2	11
OG0005724	2	3	2	1	1	1	1	11
OG0005725	1	4	2	1	1	1	1	11
OG0005726	2	3	2	1	1	1	1	11
OG0005727	2	4	1	1	1	1	1	11
OG0005728	1	2	1	1	2	2	2	11
OG0005729	1	4	1	1	1	1	2	11
OG0005730	2	4	1	1	1	1	1	11
OG0005731	2	4	1	1	1	1	1	11
OG0005732	2	4	1	1	1	1	1	11
OG0005733	2	4	1	1	1	1	1	11
OG0005734	2	4	1	1	1	1	1	11
OG0005735	2	4	1	1	1	1	1	11
OG0005736	2	5	1	1	1	0	1	11
OG0005737	2	4	1	1	1	1	1	11
OG0005738	1	5	1	1	1	1	1	11
OG0005739	2	5	2	0	0	0	2	11
OG0005740	2	4	1	1	1	1	1	11
OG0005741	1	5	1	1	1	1	1	11
OG0005742	2	4	1	1	1	1	1	11
OG0005743	2	3	2	1	1	1	1	11
OG0005744	2	4	1	1	1	1	1	11
OG0005745	2	4	1	1	1	1	1	11
OG0005746	2	4	1	1	1	1	1	11
OG0005747	2	4	1	1	1	1	1	11
OG0005748	3	3	1	1	1	1	1	11
OG0005749	2	4	1	1	1	1	1	11
OG0005750	4	2	1	1	1	1	1	11
OG0005751	2	4	1	1	1	0	2	11
OG0005752	2	4	1	1	1	1	1	11
OG0005753	1	5	1	1	1	1	1	11
OG0005754	2	4	1	1	1	1	1	11
OG0005755	2	4	1	1	1	1	1	11
OG0005756	1	5	1	1	1	1	1	11
OG0005757	2	3	1	1	2	1	1	11
OG0005758	2	4	1	1	1	1	1	11
OG0005759	2	4	1	1	1	1	1	11
OG0005760	3	3	1	1	1	1	1	11
OG0005761	1	4	1	1	2	1	1	11
OG0005762	2	3	1	1	1	1	2	11
OG0005763	2	3	1	1	1	2	1	11
OG0005764	2	3	1	1	1	2	1	11
OG0005765	2	4	1	1	1	1	1	11
OG0005766	2	4	1	1	1	1	1	11
OG0005767	2	4	1	1	1	1	1	11
OG0005768	2	4	1	1	1	1	1	11
OG0005769	2	4	1	1	1	1	1	11
OG0005770	1	4	1	1	1	2	1	11
OG0005771	2	4	1	1	1	1	1	11
OG0005772	3	3	1	1	1	1	1	11
OG0005773	2	3	1	1	1	2	1	11
OG0005774	2	4	1	1	1	1	1	11
OG0005775	1	4	1	1	1	1	2	11
OG0005776	3	3	1	1	0	2	1	11
OG0005777	2	5	1	1	1	0	1	11
OG0005778	2	3	1	1	1	1	2	11
OG0005779	2	4	1	1	1	1	1	11
OG0005780	1	4	1	1	2	1	1	11
OG0005781	2	3	1	1	1	1	2	11
OG0005782	3	3	1	1	1	1	1	11
OG0005783	2	4	1	1	1	1	1	11
OG0005784	2	5	1	1	1	1	0	11
OG0005785	3	3	1	1	1	1	1	11
OG0005786	2	3	1	1	1	2	1	11
OG0005787	2	2	1	1	1	2	2	11
OG0005788	2	4	1	1	1	1	1	11
OG0005789	2	4	1	1	1	1	1	11
OG0005790	2	3	2	1	1	0	2	11
OG0005791	2	4	1	1	1	1	1	11
OG0005792	2	4	1	1	1	1	1	11
OG0005793	2	3	2	1	1	1	1	11
OG0005794	2	4	1	1	1	1	1	11
OG0005795	2	4	1	1	1	1	1	11
OG0005796	2	3	1	1	1	2	1	11
OG0005797	1	5	1	1	1	1	1	11
OG0005798	1	4	1	2	1	1	1	11
OG0005799	2	4	1	1	1	1	1	11
OG0005800	2	4	1	1	1	1	1	11
OG0005801	1	4	1	1	1	1	2	11
OG0005802	2	4	1	1	1	1	1	11
OG0005803	2	4	1	1	1	1	1	11
OG0005804	2	5	1	1	1	0	1	11
OG0005805	2	4	1	1	1	1	1	11
OG0005806	1	5	1	1	1	1	1	11
OG0005807	2	4	1	1	1	1	1	11
OG0005808	2	4	1	1	1	1	1	11
OG0005809	2	4	1	1	1	1	1	11
OG0005810	2	4	1	1	2	1	0	11
OG0005811	2	4	1	1	1	1	1	11
OG0005812	2	4	1	1	1	1	1	11
OG0005813	2	4	1	1	1	1	1	11
OG0005814	2	4	1	1	1	1	1	11
OG0005815	1	4	1	1	1	1	2	11
OG0005816	2	4	1	1	1	1	1	11
OG0005817	1	3	1	1	1	2	2	11
OG0005818	1	3	3	1	1	1	1	11
OG0005819	2	4	1	1	1	1	1	11
OG0005820	2	4	1	1	1	1	1	11
OG0005821	3	4	1	1	1	1	0	11
OG0005822	2	4	1	1	1	1	1	11
OG0005823	2	4	1	1	1	1	1	11
OG0005824	2	4	1	1	1	1	1	11
OG0005825	2	3	2	1	1	1	1	11
OG0005826	2	4	1	1	1	1	1	11
OG0005827	2	4	1	1	1	1	1	11
OG0005828	2	4	1	1	1	1	1	11
OG0005829	2	4	1	1	1	1	1	11
OG0005830	2	5	1	1	1	0	1	11
OG0005831	2	3	2	2	0	0	2	11
OG0005832	1	5	1	1	1	1	1	11
OG0005833	2	4	1	1	1	1	1	11
OG0005834	2	4	1	1	1	1	1	11
OG0005835	2	4	1	1	1	1	1	11
OG0005836	2	4	1	1	1	1	1	11
OG0005837	2	4	1	1	1	1	1	11
OG0005838	2	4	1	1	1	1	1	11
OG0005839	2	4	1	1	1	1	1	11
OG0005840	2	3	2	1	1	1	1	11
OG0005841	2	4	1	1	1	1	1	11
OG0005842	2	4	1	1	1	1	1	11
OG0005843	3	3	1	1	1	1	1	11
OG0005844	1	5	1	1	1	1	1	11
OG0005845	3	4	1	1	1	1	0	11
OG0005846	2	3	1	1	1	1	2	11
OG0005847	2	5	1	1	0	1	1	11
OG0005848	1	4	2	1	1	1	1	11
OG0005849	1	5	1	1	1	1	1	11
OG0005850	2	4	1	1	1	1	1	11
OG0005851	2	4	1	1	1	1	1	11
OG0005852	2	4	1	1	1	1	1	11
OG0005853	2	4	1	1	1	1	1	11
OG0005854	2	4	1	1	1	1	1	11
OG0005855	1	5	1	1	1	1	1	11
OG0005856	2	3	1	1	1	1	2	11
OG0005857	2	4	1	1	1	1	1	11
OG0005858	2	4	1	1	1	1	1	11
OG0005859	3	3	1	1	2	0	1	11
OG0005860	2	4	1	1	1	1	1	11
OG0005861	2	4	1	1	1	1	1	11
OG0005862	2	4	1	1	1	1	1	11
OG0005863	2	4	1	1	1	1	1	11
OG0005864	1	4	1	2	1	0	2	11
OG0005865	2	4	1	1	1	1	1	11
OG0005866	2	4	1	1	1	1	1	11
OG0005867	1	5	1	1	1	1	1	11
OG0005868	1	4	1	1	1	1	2	11
OG0005869	2	4	1	1	1	1	1	11
OG0005870	1	5	1	1	1	1	1	11
OG0005871	3	3	1	1	1	1	1	11
OG0005872	2	4	1	1	1	1	1	11
OG0005873	3	3	1	1	0	1	2	11
OG0005874	2	3	1	1	1	1	2	11
OG0005875	2	3	1	2	1	1	1	11
OG0005876	2	4	1	1	1	1	1	11
OG0005877	2	3	1	1	1	1	2	11
OG0005878	2	4	1	1	1	1	1	11
OG0005879	2	4	1	1	1	1	1	11
OG0005880	2	3	1	1	1	2	1	11
OG0005881	2	4	1	1	1	1	1	11
OG0005882	2	4	1	1	1	1	1	11
OG0005883	2	4	1	1	1	1	1	11
OG0005884	2	3	1	1	1	2	1	11
OG0005885	2	3	1	1	2	1	1	11
OG0005886	2	4	1	1	1	1	1	11
OG0005887	2	4	1	1	1	1	1	11
OG0005888	1	3	1	1	1	1	3	11
OG0005889	2	4	1	1	1	1	1	11
OG0005890	2	4	1	1	1	1	1	11
OG0005891	2	4	1	1	1	1	1	11
OG0005892	2	4	1	1	1	1	1	11
OG0005893	2	4	1	1	1	1	1	11
OG0005894	2	4	1	1	1	1	1	11
OG0005895	1	6	1	1	1	1	0	11
OG0005896	2	3	1	2	1	1	1	11
OG0005897	3	5	2	1	0	0	0	11
OG0005898	2	4	1	1	1	1	1	11
OG0005899	3	3	1	1	1	1	1	11
OG0005900	3	3	1	1	1	1	1	11
OG0005901	2	3	2	1	1	1	1	11
OG0005902	2	4	1	1	1	1	1	11
OG0005903	2	3	1	2	1	1	1	11
OG0005904	1	5	1	1	1	1	1	11
OG0005905	2	4	1	1	1	1	1	11
OG0005906	2	4	1	1	1	1	1	11
OG0005907	1	4	1	1	1	2	1	11
OG0005908	1	4	1	1	1	1	2	11
OG0005909	3	3	1	1	1	1	1	11
OG0005910	2	3	1	1	1	2	1	11
OG0005911	3	4	0	1	1	1	1	11
OG0005912	2	4	1	1	1	1	1	11
OG0005913	2	4	1	1	1	1	1	11
OG0005914	2	3	1	1	1	1	2	11
OG0005915	3	3	1	1	1	1	1	11
OG0005916	2	4	1	1	1	0	2	11
OG0005917	2	4	1	1	1	1	1	11
OG0005918	1	3	2	2	2	1	0	11
OG0005919	1	5	1	1	1	1	1	11
OG0005920	2	3	1	1	1	1	2	11
OG0005921	1	5	1	1	1	1	1	11
OG0005922	2	3	1	1	1	1	2	11
OG0005923	1	4	1	1	1	1	2	11
OG0005924	1	3	1	3	1	1	1	11
OG0005925	1	4	2	1	1	1	1	11
OG0005926	1	4	1	1	1	2	1	11
OG0005927	2	4	1	1	1	1	1	11
OG0005928	3	2	2	1	1	1	1	11
OG0005929	2	3	2	1	1	1	1	11
OG0005930	2	4	1	1	1	1	1	11
OG0005931	2	4	1	1	1	1	1	11
OG0005932	1	4	1	2	1	1	1	11
OG0005933	2	4	1	1	1	1	1	11
OG0005934	2	4	1	1	1	1	1	11
OG0005935	3	3	1	1	1	1	1	11
OG0005936	2	4	1	1	1	1	1	11
OG0005937	1	3	1	1	3	1	1	11
OG0005938	2	3	1	2	1	1	1	11
OG0005939	2	4	1	1	1	1	1	11
OG0005940	2	4	1	1	1	1	1	11
OG0005941	2	4	1	1	1	1	1	11
OG0005942	2	4	1	1	1	1	1	11
OG0005943	2	4	1	1	1	1	1	11
OG0005944	2	4	1	1	1	1	1	11
OG0005945	1	5	1	1	1	1	1	11
OG0005946	2	4	1	1	1	1	1	11
OG0005947	2	4	1	1	1	1	1	11
OG0005948	2	4	1	1	1	1	1	11
OG0005949	2	4	1	1	1	1	1	11
OG0005950	2	4	1	1	1	1	1	11
OG0005951	2	4	1	1	1	1	1	11
OG0005952	2	4	1	1	1	1	1	11
OG0005953	3	3	1	1	1	1	1	11
OG0005954	2	3	1	1	1	1	2	11
OG0005955	2	4	1	1	1	1	1	11
OG0005956	1	5	1	1	1	1	1	11
OG0005957	2	4	1	1	1	1	1	11
OG0005958	1	4	1	1	1	2	1	11
OG0005959	2	3	1	1	1	1	2	11
OG0005960	1	5	1	1	1	1	1	11
OG0005961	2	4	1	1	1	1	1	11
OG0005962	3	3	1	1	1	1	1	11
OG0005963	2	4	1	1	1	1	1	11
OG0005964	1	4	1	2	1	1	1	11
OG0005965	2	4	1	1	1	1	1	11
OG0005966	2	3	1	1	1	2	1	11
OG0005967	1	4	1	1	2	1	1	11
OG0005968	2	5	1	1	0	1	1	11
OG0005969	1	4	1	1	1	1	2	11
OG0005970	2	4	1	1	1	1	1	11
OG0005971	2	4	1	1	1	1	1	11
OG0005972	2	3	1	1	2	1	1	11
OG0005973	1	5	1	1	1	1	1	11
OG0005974	1	5	1	1	1	1	1	11
OG0005975	2	4	1	1	1	1	1	11
OG0005976	2	4	1	1	1	1	1	11
OG0005977	2	4	1	1	1	1	1	11
OG0005978	2	4	1	1	1	1	1	11
OG0005979	1	5	1	1	1	1	1	11
OG0005980	2	4	1	1	1	1	1	11
OG0005981	2	3	1	1	1	1	2	11
OG0005982	2	4	1	1	1	1	1	11
OG0005983	2	4	1	1	1	1	1	11
OG0005984	2	4	1	1	1	1	1	11
OG0005985	3	3	1	1	1	1	1	11
OG0005986	2	4	1	1	1	1	1	11
OG0005987	2	4	1	1	1	1	1	11
OG0005988	2	4	1	1	1	1	1	11
OG0005989	2	2	1	1	1	1	3	11
OG0005990	2	4	1	1	1	1	1	11
OG0005991	2	4	1	1	1	1	1	11
OG0005992	4	2	1	1	1	1	1	11
OG0005993	2	4	1	1	1	1	1	11
OG0005994	2	4	1	1	1	0	2	11
OG0005995	2	2	2	1	0	3	1	11
OG0005996	2	4	1	1	1	1	1	11
OG0005997	3	3	1	1	1	1	1	11
OG0005998	2	4	1	1	1	1	1	11
OG0005999	2	4	1	1	1	1	1	11
OG0006000	2	4	1	1	1	1	1	11
OG0006001	2	0	2	2	1	2	2	11
OG0006002	2	4	1	1	1	1	1	11
OG0006003	2	4	1	2	0	1	1	11
OG0006004	3	3	1	1	1	1	1	11
OG0006005	2	4	1	1	1	1	1	11
OG0006006	1	5	1	1	1	1	1	11
OG0006007	1	4	1	1	1	1	2	11
OG0006008	2	4	1	1	1	1	1	11
OG0006009	2	4	1	1	1	1	1	11
OG0006010	2	3	2	1	1	1	1	11
OG0006011	2	4	1	1	1	1	1	11
OG0006012	2	4	1	1	1	1	1	11
OG0006013	2	4	1	1	1	1	1	11
OG0006014	2	4	1	1	1	1	1	11
OG0006015	2	4	1	1	1	1	1	11
OG0006016	2	4	1	1	1	1	1	11
OG0006017	2	5	1	1	1	0	1	11
OG0006018	2	3	2	1	1	1	1	11
OG0006019	1	5	1	1	1	1	1	11
OG0006020	1	3	1	2	2	1	1	11
OG0006021	2	3	1	1	1	1	2	11
OG0006022	2	4	1	1	1	1	1	11
OG0006023	2	3	1	1	0	2	2	11
OG0006024	2	4	1	1	1	1	1	11
OG0006025	1	4	1	1	2	1	1	11
OG0006026	2	3	1	1	1	1	2	11
OG0006027	2	4	1	1	1	1	1	11
OG0006028	2	4	1	1	1	1	1	11
OG0006029	2	4	1	1	1	1	1	11
OG0006030	2	4	1	1	1	1	1	11
OG0006031	3	3	1	1	1	1	1	11
OG0006032	2	4	1	1	1	1	1	11
OG0006033	1	4	1	1	1	1	2	11
OG0006034	2	3	1	1	1	1	2	11
OG0006035	1	5	1	1	1	1	1	11
OG0006036	2	3	1	1	1	1	2	11
OG0006037	2	4	1	1	1	1	1	11
OG0006038	2	4	1	1	1	1	1	11
OG0006039	2	4	1	1	1	1	1	11
OG0006040	2	4	1	1	1	1	1	11
OG0006041	1	3	2	2	1	1	1	11
OG0006042	2	4	1	1	1	1	1	11
OG0006043	3	3	1	1	1	1	1	11
OG0006044	2	4	1	1	1	1	1	11
OG0006045	2	5	0	1	1	1	1	11
OG0006046	2	4	1	1	1	1	1	11
OG0006047	1	4	1	1	1	1	2	11
OG0006048	1	4	1	1	1	1	2	11
OG0006049	2	4	1	1	1	1	1	11
OG0006050	2	4	1	1	1	1	1	11
OG0006051	1	4	1	2	1	1	1	11
OG0006052	2	4	1	1	1	1	1	11
OG0006053	4	1	1	1	1	1	2	11
OG0006054	2	4	1	1	1	1	1	11
OG0006055	2	4	1	1	1	1	1	11
OG0006056	2	3	1	1	2	1	1	11
OG0006057	2	4	1	1	1	1	1	11
OG0006058	2	4	1	1	1	1	1	11
OG0006059	1	3	2	1	2	2	0	11
OG0006060	2	4	1	1	1	1	1	11
OG0006061	1	5	1	1	1	1	1	11
OG0006062	2	4	1	1	1	1	1	11
OG0006063	2	4	1	1	1	1	1	11
OG0006064	2	4	1	1	1	1	1	11
OG0006065	3	3	1	1	1	1	1	11
OG0006066	2	4	1	1	1	1	1	11
OG0006067	2	3	1	2	1	1	1	11
OG0006068	1	3	1	2	1	2	1	11
OG0006069	2	4	1	1	1	1	1	11
OG0006070	2	4	1	1	1	1	1	11
OG0006071	1	4	1	1	1	2	1	11
OG0006072	2	4	1	1	1	1	1	11
OG0006073	2	4	1	1	1	1	1	11
OG0006074	2	4	1	1	1	1	1	11
OG0006075	2	4	1	1	1	1	1	11
OG0006076	2	4	1	1	1	1	1	11
OG0006077	1	4	1	1	1	2	1	11
OG0006078	2	4	1	1	1	1	1	11
OG0006079	2	4	1	1	1	1	1	11
OG0006080	2	4	1	1	1	1	1	11
OG0006081	2	4	1	1	1	1	1	11
OG0006082	2	4	1	1	1	1	1	11
OG0006083	1	5	1	1	1	1	1	11
OG0006084	2	3	1	1	1	1	2	11
OG0006085	2	4	1	1	1	1	1	11
OG0006086	2	4	1	1	1	1	1	11
OG0006087	2	4	1	1	1	1	1	11
OG0006088	2	3	1	1	2	1	1	11
OG0006089	2	3	1	1	1	1	2	11
OG0006090	1	4	2	1	3	0	0	11
OG0006091	1	5	1	1	1	1	1	11
OG0006092	3	3	1	1	1	1	1	11
OG0006093	1	5	1	1	1	1	1	11
OG0006094	1	4	2	1	1	1	1	11
OG0006095	2	4	1	1	1	1	1	11
OG0006096	2	4	1	1	1	1	1	11
OG0006097	3	3	1	1	1	1	1	11
OG0006098	2	4	1	1	1	1	1	11
OG0006099	2	4	1	1	1	1	1	11
OG0006100	2	4	1	1	1	1	1	11
OG0006101	2	4	1	1	1	1	1	11
OG0006102	2	4	1	1	1	1	1	11
OG0006103	3	3	1	1	1	1	1	11
OG0006104	3	3	1	1	1	1	1	11
OG0006105	2	4	1	1	1	1	1	11
OG0006106	2	4	1	1	1	1	1	11
OG0006107	2	3	1	1	1	2	1	11
OG0006108	1	3	3	1	1	1	1	11
OG0006109	3	4	1	1	1	1	0	11
OG0006110	1	5	1	1	1	1	1	11
OG0006111	2	3	1	1	1	2	1	11
OG0006112	2	4	1	1	1	1	1	11
OG0006113	2	4	1	1	1	1	1	11
OG0006114	2	3	2	1	1	1	1	11
OG0006115	1	4	0	1	3	1	1	11
OG0006116	1	5	1	1	1	1	1	11
OG0006117	2	4	1	1	1	1	1	11
OG0006118	2	4	1	1	1	1	1	11
OG0006119	2	4	1	1	1	1	1	11
OG0006120	1	5	1	1	1	1	1	11
OG0006121	2	3	2	1	1	1	1	11
OG0006122	2	4	1	1	1	1	1	11
OG0006123	2	4	1	1	1	1	1	11
OG0006124	2	4	1	1	1	1	1	11
OG0006125	3	3	1	1	1	1	1	11
OG0006126	2	4	1	1	1	1	1	11
OG0006127	1	5	1	1	1	1	1	11
OG0006128	1	4	1	1	1	2	1	11
OG0006129	1	4	1	1	1	1	2	11
OG0006130	2	4	1	1	1	1	1	11
OG0006131	2	3	2	1	1	1	1	11
OG0006132	2	3	0	1	3	2	0	11
OG0006133	2	4	1	1	1	1	1	11
OG0006134	2	5	1	1	1	0	1	11
OG0006135	1	5	2	0	1	1	1	11
OG0006136	1	4	1	1	1	1	2	11
OG0006137	2	4	1	1	1	1	1	11
OG0006138	1	5	1	1	1	1	1	11
OG0006139	1	5	1	1	1	1	1	11
OG0006140	2	4	1	1	1	1	1	11
OG0006141	2	4	1	1	1	1	1	11
OG0006142	1	5	1	1	1	1	1	11
OG0006143	4	2	1	1	1	1	1	11
OG0006144	2	4	1	1	1	1	1	11
OG0006145	1	5	1	1	1	1	1	11
OG0006146	2	4	1	1	1	1	1	11
OG0006147	2	3	2	1	1	1	1	11
OG0006148	2	3	1	1	1	0	3	11
OG0006149	2	4	1	1	1	1	1	11
OG0006150	2	4	1	1	1	1	1	11
OG0006151	2	3	1	1	1	1	2	11
OG0006152	2	4	1	1	1	1	1	11
OG0006153	2	3	1	1	2	1	1	11
OG0006154	2	4	1	1	1	1	1	11
OG0006155	2	4	1	1	1	1	1	11
OG0006156	1	5	1	1	1	1	1	11
OG0006157	2	4	1	1	1	1	1	11
OG0006158	1	1	1	1	1	2	4	11
OG0006159	2	4	1	1	1	1	1	11
OG0006160	1	3	2	2	1	1	1	11
OG0006161	2	4	1	1	1	1	1	11
OG0006162	2	4	1	1	1	1	1	11
OG0006163	2	4	1	1	1	1	1	11
OG0006164	1	3	1	1	2	1	2	11
OG0006165	2	4	1	1	1	1	1	11
OG0006166	1	5	1	1	1	2	0	11
OG0006167	2	4	1	1	1	1	1	11
OG0006168	1	4	1	1	2	1	1	11
OG0006169	2	4	1	1	1	1	1	11
OG0006170	2	4	1	1	1	1	1	11
OG0006171	2	4	1	1	1	1	1	11
OG0006172	2	3	3	1	1	1	0	11
OG0006173	1	5	1	1	1	1	1	11
OG0006174	2	3	1	1	1	1	2	11
OG0006175	2	4	1	1	1	1	1	11
OG0006176	2	4	1	1	1	1	1	11
OG0006177	2	4	1	1	1	1	1	11
OG0006178	2	4	1	1	1	1	1	11
OG0006179	4	2	1	1	1	1	1	11
OG0006180	2	3	1	1	1	1	2	11
OG0006181	2	3	1	2	1	1	1	11
OG0006182	2	4	1	1	1	1	1	11
OG0006183	2	4	1	1	1	1	1	11
OG0006184	1	4	1	2	1	1	1	11
OG0006185	1	5	1	1	1	1	1	11
OG0006186	2	4	1	1	1	1	1	11
OG0006187	2	4	1	1	1	1	1	11
OG0006188	1	5	1	1	1	1	1	11
OG0006189	2	3	1	1	1	1	2	11
OG0006190	2	4	1	1	1	1	1	11
OG0006191	1	5	1	1	1	1	1	11
OG0006192	1	4	1	1	1	2	1	11
OG0006193	1	3	1	1	1	1	3	11
OG0006194	1	4	1	1	1	2	1	11
OG0006195	1	5	1	1	1	1	1	11
OG0006196	3	3	1	1	1	1	1	11
OG0006197	1	3	2	1	1	2	1	11
OG0006198	2	4	1	1	1	1	1	11
OG0006199	2	4	1	1	1	1	1	11
OG0006200	2	4	1	1	1	1	1	11
OG0006201	1	5	1	0	2	1	1	11
OG0006202	2	4	2	1	1	1	0	11
OG0006203	2	4	1	1	1	1	1	11
OG0006204	2	4	1	1	1	1	1	11
OG0006205	1	5	1	1	1	1	1	11
OG0006206	2	4	1	1	1	1	1	11
OG0006207	1	3	1	1	3	1	1	11
OG0006208	3	3	1	1	1	1	1	11
OG0006209	2	4	1	1	1	1	1	11
OG0006210	2	4	1	1	1	1	1	11
OG0006211	2	4	1	1	1	1	1	11
OG0006212	1	4	1	1	2	1	1	11
OG0006213	1	5	1	1	1	1	1	11
OG0006214	2	4	1	1	1	1	1	11
OG0006215	1	4	2	1	1	1	1	11
OG0006216	2	4	1	1	1	1	1	11
OG0006217	1	4	1	1	2	1	1	11
OG0006218	2	4	1	1	1	1	1	11
OG0006219	2	4	1	1	1	1	1	11
OG0006220	1	5	1	1	1	1	1	11
OG0006221	2	3	2	1	1	1	1	11
OG0006222	2	4	1	1	1	1	1	11
OG0006223	1	10	0	0	0	0	0	11
OG0006224	2	4	1	1	1	1	1	11
OG0006225	2	4	1	1	1	1	1	11
OG0006226	2	4	1	1	1	1	1	11
OG0006227	1	4	1	1	2	1	1	11
OG0006228	3	4	1	1	1	0	1	11
OG0006229	3	2	1	1	0	1	3	11
OG0006230	1	4	1	2	1	1	1	11
OG0006231	2	4	1	1	1	1	1	11
OG0006232	2	3	2	1	1	1	1	11
OG0006233	2	4	1	1	1	1	1	11
OG0006234	3	3	1	1	1	1	1	11
OG0006235	2	4	1	1	1	1	1	11
OG0006236	2	4	1	1	1	1	1	11
OG0006237	3	3	1	1	1	1	1	11
OG0006238	2	2	1	1	1	2	2	11
OG0006239	2	3	2	1	1	1	1	11
OG0006240	3	3	1	1	1	1	1	11
OG0006241	2	4	1	1	1	1	1	11
OG0006242	2	4	1	1	1	1	1	11
OG0006243	1	5	1	1	1	1	1	11
OG0006244	2	3	1	2	1	1	1	11
OG0006245	1	5	1	1	1	1	1	11
OG0006246	2	4	1	1	1	1	1	11
OG0006247	2	3	1	1	1	1	2	11
OG0006248	2	3	1	1	1	1	2	11
OG0006249	2	4	1	1	1	1	1	11
OG0006250	2	4	1	1	1	1	1	11
OG0006251	1	4	1	2	1	1	1	11
OG0006252	2	4	1	1	1	1	1	11
OG0006253	2	4	1	1	1	1	1	11
OG0006254	2	4	1	1	1	1	1	11
OG0006255	1	4	2	1	1	1	1	11
OG0006256	2	4	1	1	1	1	1	11
OG0006257	1	4	1	1	2	1	1	11
OG0006258	2	3	1	1	1	1	2	11
OG0006259	3	4	1	1	1	0	1	11
OG0006260	2	4	1	1	1	1	1	11
OG0006261	2	4	1	1	1	1	1	11
OG0006262	2	4	1	1	1	1	1	11
OG0006263	1	4	1	1	2	1	1	11
OG0006264	1	5	1	1	1	1	1	11
OG0006265	2	4	1	1	1	1	1	11
OG0006266	1	5	1	1	1	1	1	11
OG0006267	2	6	3	0	0	0	0	11
OG0006268	2	3	1	1	1	1	2	11
OG0006269	2	4	1	1	1	1	1	11
OG0006270	1	5	1	1	1	1	1	11
OG0006271	3	3	1	1	1	1	1	11
OG0006272	2	4	1	1	1	1	1	11
OG0006273	2	4	1	1	1	1	1	11
OG0006274	1	4	1	1	1	1	2	11
OG0006275	2	3	1	2	1	1	1	11
OG0006276	2	4	1	1	1	1	1	11
OG0006277	2	4	1	1	1	1	1	11
OG0006278	2	4	1	1	1	1	1	11
OG0006279	2	4	1	1	1	1	1	11
OG0006280	1	5	1	1	1	1	1	11
OG0006281	1	4	1	1	1	2	1	11
OG0006282	2	3	1	1	1	1	2	11
OG0006283	2	3	1	1	1	2	1	11
OG0006284	1	4	1	1	1	2	1	11
OG0006285	2	3	2	1	1	1	1	11
OG0006286	1	5	1	1	1	1	1	11
OG0006287	2	4	1	1	1	1	1	11
OG0006288	2	4	1	1	1	1	1	11
OG0006289	3	3	1	1	1	1	1	11
OG0006290	2	4	1	1	1	1	1	11
OG0006291	2	3	1	1	2	1	1	11
OG0006292	1	5	1	1	1	1	1	11
OG0006293	2	4	1	1	1	1	1	11
OG0006294	1	3	1	2	1	1	2	11
OG0006295	2	4	1	1	1	1	1	11
OG0006296	1	6	1	2	0	1	0	11
OG0006297	3	3	1	1	1	1	1	11
OG0006298	2	4	1	1	1	1	1	11
OG0006299	2	4	1	1	1	1	1	11
OG0006300	3	3	1	1	1	1	1	11
OG0006301	2	4	1	1	1	1	1	11
OG0006302	1	3	1	1	1	2	2	11
OG0006303	2	4	1	1	1	1	1	11
OG0006304	2	4	1	1	1	1	1	11
OG0006305	2	4	1	1	1	1	1	11
OG0006306	1	4	1	1	1	1	2	11
OG0006307	2	4	1	1	1	1	1	11
OG0006308	3	4	1	1	1	0	1	11
OG0006309	2	4	1	1	1	1	1	11
OG0006310	2	4	1	1	1	1	1	11
OG0006311	2	4	1	1	1	1	1	11
OG0006312	3	3	1	1	1	1	1	11
OG0006313	2	3	1	1	1	1	2	11
OG0006314	2	4	1	1	1	1	1	11
OG0006315	2	4	1	1	1	1	1	11
OG0006316	2	3	1	1	1	1	2	11
OG0006317	2	4	1	1	1	1	1	11
OG0006318	2	4	1	1	1	1	1	11
OG0006319	1	3	1	3	1	1	1	11
OG0006320	1	5	1	1	1	1	1	11
OG0006321	1	5	1	1	1	1	1	11
OG0006322	2	4	1	1	1	1	1	11
OG0006323	2	4	1	1	1	1	1	11
OG0006324	1	5	1	1	1	1	1	11
OG0006325	1	5	1	1	1	1	1	11
OG0006326	1	5	1	1	1	1	1	11
OG0006327	2	4	1	1	1	1	1	11
OG0006328	2	4	1	1	1	1	1	11
OG0006329	2	4	1	1	1	1	1	11
OG0006330	2	4	1	1	0	2	1	11
OG0006331	2	3	1	2	1	1	1	11
OG0006332	2	4	1	1	1	1	1	11
OG0006333	2	4	1	1	1	1	1	11
OG0006334	2	5	1	1	1	0	1	11
OG0006335	2	4	1	1	1	1	1	11
OG0006336	1	0	2	2	2	2	2	11
OG0006337	2	4	1	1	1	1	1	11
OG0006338	2	4	1	1	1	1	1	11
OG0006339	1	5	1	1	1	1	1	11
OG0006340	2	3	1	1	1	1	2	11
OG0006341	2	4	1	1	1	1	1	11
OG0006342	1	5	1	0	1	1	2	11
OG0006343	2	3	1	1	1	2	1	11
OG0006344	1	4	1	1	1	1	2	11
OG0006345	2	4	1	1	1	1	1	11
OG0006346	1	5	1	1	1	1	1	11
OG0006347	2	4	1	1	1	1	1	11
OG0006348	2	4	1	1	1	1	1	11
OG0006349	2	3	1	1	1	2	1	11
OG0006350	1	5	1	1	1	1	1	11
OG0006351	2	4	1	1	1	1	1	11
OG0006352	3	2	1	1	1	2	1	11
OG0006353	3	3	1	1	1	1	1	11
OG0006354	2	4	1	1	1	1	1	11
OG0006355	2	4	1	1	1	1	1	11
OG0006356	2	4	1	1	1	1	1	11
OG0006357	2	4	1	1	1	1	1	11
OG0006358	2	4	1	1	1	1	1	11
OG0006359	1	3	3	1	1	1	1	11
OG0006360	2	4	1	1	1	1	1	11
OG0006361	2	4	1	1	1	1	1	11
OG0006362	1	4	2	1	1	1	1	11
OG0006363	2	5	1	1	1	1	0	11
OG0006364	2	4	1	1	1	1	1	11
OG0006365	1	4	1	1	2	2	0	11
OG0006366	2	3	2	1	1	1	1	11
OG0006367	2	4	1	1	1	1	1	11
OG0006368	2	3	1	1	1	1	2	11
OG0006369	2	4	1	1	1	1	1	11
OG0006370	1	3	1	1	1	2	2	11
OG0006371	1	5	1	1	1	1	1	11
OG0006372	2	4	1	1	1	1	1	11
OG0006373	2	4	1	1	1	1	1	11
OG0006374	2	4	1	1	1	1	1	11
OG0006375	2	3	2	1	1	1	1	11
OG0006376	2	3	2	1	1	1	1	11
OG0006377	2	4	1	1	1	1	1	11
OG0006378	2	4	1	1	1	1	1	11
OG0006379	2	3	1	1	1	2	1	11
OG0006380	3	3	1	1	1	1	1	11
OG0006381	3	3	1	1	1	1	1	11
OG0006382	2	4	1	1	1	1	1	11
OG0006383	1	5	1	1	1	1	1	11
OG0006384	2	4	1	1	1	1	1	11
OG0006385	1	4	1	1	1	1	2	11
OG0006386	2	4	1	1	1	1	1	11
OG0006387	2	4	1	1	1	1	1	11
OG0006388	2	4	1	1	1	1	1	11
OG0006389	2	4	1	1	1	1	1	11
OG0006390	2	4	1	1	1	1	1	11
OG0006391	2	4	1	1	1	1	1	11
OG0006392	2	4	1	1	1	1	1	11
OG0006393	1	5	1	1	1	1	1	11
OG0006394	2	3	1	1	1	1	2	11
OG0006395	2	4	1	1	1	1	1	11
OG0006396	2	4	1	1	1	1	1	11
OG0006397	1	4	2	1	1	1	1	11
OG0006398	2	3	1	1	1	1	2	11
OG0006399	1	5	1	1	1	1	1	11
OG0006400	2	3	1	1	1	1	2	11
OG0006401	2	4	1	1	1	1	1	11
OG0006402	2	4	1	1	1	1	1	11
OG0006403	3	4	1	1	1	0	1	11
OG0006404	2	3	1	2	1	1	1	11
OG0006405	2	4	1	1	1	1	1	11
OG0006406	3	3	1	1	1	1	1	11
OG0006407	1	4	1	1	1	1	2	11
OG0006408	2	4	1	1	1	1	1	11
OG0006409	1	5	1	1	1	1	1	11
OG0006410	1	3	2	0	2	2	1	11
OG0006411	1	5	1	1	1	1	1	11
OG0006412	2	4	1	1	1	1	1	11
OG0006413	2	4	1	1	1	1	1	11
OG0006414	2	4	1	1	1	1	1	11
OG0006415	2	4	1	1	1	1	1	11
OG0006416	1	4	1	1	2	1	1	11
OG0006417	1	5	1	1	1	1	1	11
OG0006418	2	4	1	1	1	1	1	11
OG0006419	2	4	1	1	1	1	1	11
OG0006420	1	4	1	2	1	1	1	11
OG0006421	1	4	1	1	1	1	2	11
OG0006422	2	4	1	1	1	1	1	11
OG0006423	2	3	2	1	1	1	1	11
OG0006424	2	4	1	1	1	1	1	11
OG0006425	2	3	1	1	1	1	2	11
OG0006426	2	6	1	0	1	0	1	11
OG0006427	2	4	1	1	1	1	1	11
OG0006428	1	5	1	1	1	1	1	11
OG0006429	2	4	1	1	1	1	1	11
OG0006430	1	5	1	1	1	1	1	11
OG0006431	2	3	1	1	1	2	1	11
OG0006432	2	4	1	1	1	1	1	11
OG0006433	1	2	1	2	1	2	2	11
OG0006434	2	4	1	1	1	1	1	11
OG0006435	2	4	1	1	1	1	1	11
OG0006436	2	4	1	1	1	1	1	11
OG0006437	2	4	1	1	1	1	1	11
OG0006438	1	4	1	2	1	1	1	11
OG0006439	1	4	1	1	1	2	1	11
OG0006440	2	4	1	1	1	1	1	11
OG0006441	2	4	1	1	1	1	1	11
OG0006442	2	3	1	1	0	1	3	11
OG0006443	2	4	1	1	1	1	1	11
OG0006444	2	4	1	1	1	1	1	11
OG0006445	2	3	2	1	1	1	1	11
OG0006446	2	4	1	1	1	1	1	11
OG0006447	2	3	1	1	1	1	2	11
OG0006448	1	4	1	2	1	1	1	11
OG0006449	2	4	1	1	1	1	1	11
OG0006450	2	4	1	1	1	1	1	11
OG0006451	2	4	1	1	1	1	1	11
OG0006452	2	4	1	1	1	1	1	11
OG0006453	2	4	1	1	1	1	1	11
OG0006454	2	4	1	1	1	1	1	11
OG0006455	2	4	1	1	1	1	1	11
OG0006456	1	4	1	1	1	1	2	11
OG0006457	2	4	1	1	1	1	1	11
OG0006458	1	6	1	1	0	0	2	11
OG0006459	1	4	2	1	1	1	1	11
OG0006460	2	4	1	1	1	1	1	11
OG0006461	2	4	1	1	1	1	1	11
OG0006462	2	4	1	1	1	1	1	11
OG0006463	2	4	1	1	1	1	1	11
OG0006464	2	5	1	1	1	0	1	11
OG0006465	2	4	1	1	1	1	1	11
OG0006466	2	4	1	1	1	1	1	11
OG0006467	1	4	1	1	1	1	2	11
OG0006468	2	3	1	1	2	1	1	11
OG0006469	2	4	1	1	1	1	1	11
OG0006470	1	4	1	1	1	2	1	11
OG0006471	2	4	1	1	1	1	1	11
OG0006472	1	5	1	1	1	1	1	11
OG0006473	2	4	1	1	1	1	1	11
OG0006474	2	4	1	1	1	1	1	11
OG0006475	2	4	1	1	1	1	1	11
OG0006476	2	4	1	1	1	1	1	11
OG0006477	2	4	1	1	1	1	1	11
OG0006478	1	3	1	1	1	2	2	11
OG0006479	2	1	2	1	2	1	2	11
OG0006480	2	4	1	1	1	1	1	11
OG0006481	1	5	1	1	1	1	1	11
OG0006482	2	4	1	1	1	1	1	11
OG0006483	3	4	1	1	0	1	1	11
OG0006484	1	4	1	1	2	1	1	11
OG0006485	1	5	1	2	1	1	0	11
OG0006486	2	2	1	1	1	1	3	11
OG0006487	2	3	2	1	1	1	1	11
OG0006488	1	5	1	1	1	1	1	11
OG0006489	2	4	1	1	1	1	1	11
OG0006490	1	4	1	1	1	1	2	11
OG0006491	2	4	1	1	1	1	1	11
OG0006492	1	5	1	1	1	1	1	11
OG0006493	2	4	1	1	1	1	1	11
OG0006494	2	4	1	1	1	1	1	11
OG0006495	2	4	1	1	1	1	1	11
OG0006496	2	4	1	1	1	1	1	11
OG0006497	2	4	1	1	1	1	1	11
OG0006498	1	5	1	1	1	1	1	11
OG0006499	2	4	1	1	1	1	1	11
OG0006500	2	4	1	1	1	1	1	11
OG0006501	1	4	1	2	1	1	1	11
OG0006502	2	4	1	1	1	1	1	11
OG0006503	2	4	1	1	1	1	1	11
OG0006504	2	4	1	1	1	1	1	11
OG0006505	1	4	1	1	1	1	2	11
OG0006506	2	4	1	1	1	1	1	11
OG0006507	2	4	1	1	1	1	1	11
OG0006508	2	2	2	2	1	1	1	11
OG0006509	1	5	1	2	1	1	0	11
OG0006510	2	4	1	1	1	1	1	11
OG0006511	2	4	1	1	1	1	1	11
OG0006512	2	3	1	2	1	0	2	11
OG0006513	2	5	1	1	1	0	1	11
OG0006514	1	1	1	1	2	2	3	11
OG0006515	2	4	1	1	1	0	2	11
OG0006516	2	4	1	1	1	1	1	11
OG0006517	2	4	1	1	1	1	1	11
OG0006518	2	4	1	1	1	1	1	11
OG0006519	2	4	1	1	1	1	1	11
OG0006520	2	4	1	1	1	1	1	11
OG0006521	2	3	2	1	1	1	1	11
OG0006522	1	4	2	1	1	1	1	11
OG0006523	1	5	1	1	1	1	1	11
OG0006524	1	4	1	1	1	2	1	11
OG0006525	2	4	1	1	1	1	1	11
OG0006526	1	5	1	1	1	1	1	11
OG0006527	2	4	1	1	1	1	1	11
OG0006528	1	5	1	1	1	1	1	11
OG0006529	2	4	1	1	0	1	2	11
OG0006530	2	4	1	1	1	1	1	11
OG0006531	2	4	1	1	1	1	1	11
OG0006532	1	3	2	2	0	2	1	11
OG0006533	5	1	3	1	1	0	0	11
OG0006534	1	5	1	1	1	1	1	11
OG0006535	1	3	1	1	1	2	2	11
OG0006536	2	4	1	1	1	1	1	11
OG0006537	1	5	1	1	1	1	1	11
OG0006538	2	3	2	1	1	1	1	11
OG0006539	2	3	1	1	2	1	1	11
OG0006540	2	4	1	1	1	1	1	11
OG0006541	2	4	1	1	1	1	1	11
OG0006542	1	4	1	2	1	1	1	11
OG0006543	2	3	1	1	1	2	1	11
OG0006544	1	4	1	1	1	2	1	11
OG0006545	2	4	1	1	1	1	1	11
OG0006546	1	4	1	1	1	1	2	11
OG0006547	1	2	5	0	1	1	1	11
OG0006548	1	4	1	1	1	2	1	11
OG0006549	3	3	1	1	1	1	1	11
OG0006550	1	5	1	1	1	1	1	11
OG0006551	1	5	1	1	1	1	1	11
OG0006552	2	4	1	1	1	1	1	11
OG0006553	2	2	2	1	2	1	1	11
OG0006554	2	4	1	1	1	1	1	11
OG0006555	1	5	1	1	1	1	1	11
OG0006556	1	2	1	1	1	2	3	11
OG0006557	3	3	1	1	1	1	1	11
OG0006558	2	3	1	1	1	2	1	11
OG0006559	2	3	1	1	1	2	1	11
OG0006560	3	3	1	1	1	1	1	11
OG0006561	2	4	2	1	1	0	1	11
OG0006562	1	3	1	1	1	2	2	11
OG0006563	2	4	2	1	1	1	0	11
OG0006564	1	5	1	1	1	1	1	11
OG0006565	2	4	1	1	1	1	1	11
OG0006566	2	4	1	1	1	1	1	11
OG0006567	2	4	1	1	1	1	1	11
OG0006568	1	5	0	1	1	1	2	11
OG0006569	1	4	1	1	1	2	1	11
OG0006570	1	4	0	1	0	1	4	11
OG0006571	1	4	2	1	1	1	1	11
OG0006572	1	5	1	1	1	1	1	11
OG0006573	1	5	1	1	1	1	1	11
OG0006574	1	4	1	1	1	1	2	11
OG0006575	1	4	3	1	1	0	1	11
OG0006576	1	4	1	2	1	1	1	11
OG0006577	1	3	1	1	1	1	3	11
OG0006578	1	5	1	1	1	1	1	11
OG0006579	1	5	1	1	1	1	1	11
OG0006580	2	4	1	1	1	1	1	11
OG0006581	1	5	1	1	1	1	1	11
OG0006582	1	3	2	1	1	1	2	11
OG0006583	2	4	1	1	1	1	1	11
OG0006584	1	1	2	2	3	1	1	11
OG0006585	1	4	1	2	1	1	1	11
OG0006586	2	4	0	1	1	1	2	11
OG0006587	1	3	1	1	1	2	2	11
OG0006588	1	2	1	2	1	2	2	11
OG0006589	1	4	1	1	2	2	0	11
OG0006590	1	3	1	1	2	2	1	11
OG0006591	1	2	1	1	2	2	2	11
OG0006592	1	5	1	1	1	1	1	11
OG0006593	1	4	2	1	1	1	1	11
OG0006594	1	5	1	1	1	1	1	11
OG0006595	1	4	2	1	1	1	1	11
OG0006596	1	5	1	1	1	1	1	11
OG0006597	2	4	1	1	1	1	1	11
OG0006598	1	4	1	1	1	2	1	11
OG0006599	2	4	1	1	1	1	1	11
OG0006600	1	0	1	2	1	2	4	11
OG0006601	1	5	1	1	2	1	0	11
OG0006602	1	5	1	1	1	1	1	11
OG0006603	2	4	1	1	1	1	1	11
OG0006604	1	5	1	1	1	1	1	11
OG0006605	2	4	1	1	1	1	1	11
OG0006606	1	1	2	1	3	1	2	11
OG0006607	1	3	3	1	1	1	1	11
OG0006608	0	6	0	2	0	2	1	11
OG0006609	0	6	1	1	1	1	1	11
OG0006610	0	5	2	1	1	1	1	11
OG0006611	0	5	0	1	2	2	1	11
OG0006612	0	11	0	0	0	0	0	11
OG0006613	0	4	1	1	3	1	1	11
OG0006614	0	9	0	1	1	0	0	11
OG0006615	0	11	0	0	0	0	0	11
OG0006616	0	3	3	1	1	2	1	11
OG0006617	0	8	0	0	1	2	0	11
OG0006618	0	3	1	0	1	2	4	11
OG0006619	0	8	0	0	1	1	1	11
OG0006620	0	3	3	2	1	1	1	11
OG0006621	0	8	0	1	0	0	2	11
OG0006622	0	9	1	0	0	0	1	11
OG0006623	0	4	3	2	0	2	0	11
OG0006624	0	11	0	0	0	0	0	11
OG0006625	0	3	1	2	1	2	2	11
OG0006626	0	1	0	0	1	0	9	11
OG0006627	0	11	0	0	0	0	0	11
OG0006628	0	4	1	2	1	2	1	11
OG0006629	0	4	1	2	1	1	2	11
OG0006630	0	9	0	0	0	1	1	11
OG0006631	0	6	1	1	1	1	1	11
OG0006632	0	5	1	2	1	0	2	11
OG0006633	0	5	1	0	1	1	3	11
OG0006634	0	6	0	1	1	0	3	11
OG0006635	0	4	2	1	1	1	2	11
OG0006636	0	8	0	1	1	1	0	11
OG0006637	0	4	1	2	1	2	1	11
OG0006638	0	5	3	0	2	0	1	11
OG0006639	0	5	1	1	2	2	0	11
OG0006640	0	11	0	0	0	0	0	11
OG0006641	0	6	1	1	1	1	1	11
OG0006642	0	11	0	0	0	0	0	11
OG0006643	0	6	1	1	1	1	1	11
OG0006644	0	3	1	1	0	4	2	11
OG0006645	0	3	1	1	2	1	3	11
OG0006646	0	5	1	1	1	1	2	11
OG0006647	0	11	0	0	0	0	0	11
OG0006648	0	9	0	0	0	1	1	11
OG0006649	0	7	0	2	1	0	1	11
OG0006650	0	11	0	0	0	0	0	11
OG0006651	0	9	0	2	0	0	0	11
OG0006652	0	4	1	1	2	1	2	11
OG0006653	0	11	0	0	0	0	0	11
OG0006654	0	4	1	1	2	1	2	11
OG0006655	0	9	0	0	0	1	1	11
OG0006656	0	6	1	1	1	1	1	11
OG0006657	0	8	1	0	0	1	1	11
OG0006658	0	5	1	2	0	2	1	11
OG0006659	0	6	1	1	1	1	1	11
OG0006660	0	5	3	2	0	0	1	11
OG0006661	0	11	0	0	0	0	0	11
OG0006662	0	6	0	1	2	2	0	11
OG0006663	0	5	0	2	1	3	0	11
OG0006664	0	5	1	1	1	2	1	11
OG0006665	0	11	0	0	0	0	0	11
OG0006666	0	9	0	0	1	0	1	11
OG0006667	0	5	0	2	2	1	1	11
OG0006668	0	6	0	1	1	2	1	11
OG0006669	0	6	2	1	2	0	0	11
OG0006670	0	7	0	1	2	1	0	11
OG0006671	0	4	1	1	3	0	2	11
OG0006672	0	4	3	1	2	1	0	11
OG0006673	0	8	0	0	0	0	3	11
OG0006674	0	10	1	0	0	0	0	11
OG0006675	0	6	1	1	1	1	1	11
OG0006676	0	6	1	1	1	1	1	11
OG0006677	0	4	2	1	1	2	1	11
OG0006678	0	8	0	0	1	0	2	11
OG0006679	0	5	1	1	1	1	2	11
OG0006680	0	5	1	1	1	1	2	11
OG0006681	0	5	2	1	1	1	1	11
OG0006682	0	10	0	0	0	0	1	11
OG0006683	0	9	0	1	1	0	0	11
OG0006684	0	5	0	0	0	2	4	11
OG0006685	0	4	1	1	1	2	2	11
OG0006686	0	5	2	2	2	0	0	11
OG0006687	0	5	1	1	1	1	2	11
OG0006688	0	6	0	1	2	1	1	11
OG0006689	0	5	0	2	2	1	1	11
OG0006690	0	3	1	1	2	2	2	11
OG0006691	0	6	0	3	1	0	1	11
OG0006692	0	4	0	0	0	0	7	11
OG0006693	0	9	1	1	0	0	0	11
OG0006694	0	11	0	0	0	0	0	11
OG0006695	0	6	2	0	1	0	2	11
OG0006696	0	5	1	1	1	1	2	11
OG0006697	0	11	0	0	0	0	0	11
OG0006698	0	2	3	1	1	2	2	11
OG0006699	0	7	0	1	2	0	1	11
OG0006700	0	6	0	1	2	1	1	11
OG0006701	0	4	0	3	2	1	1	11
OG0006702	0	5	2	1	1	1	1	11
OG0006703	0	5	1	1	1	1	2	11
OG0006704	0	4	2	1	2	1	1	11
OG0006705	0	5	2	2	1	1	0	11
OG0006706	0	11	0	0	0	0	0	11
OG0006707	0	5	0	2	0	2	2	11
OG0006708	0	6	1	1	1	1	1	11
OG0006709	0	5	0	2	1	0	3	11
OG0006710	0	1	2	1	2	4	1	11
OG0006711	0	4	1	0	1	3	2	11
OG0006712	0	5	1	2	1	1	1	11
OG0006713	0	9	0	1	0	1	0	11
OG0006714	0	8	0	0	2	0	1	11
OG0006715	0	5	1	1	1	1	2	11
OG0006716	0	5	1	1	1	1	2	11
OG0006717	0	5	2	1	0	0	3	11
OG0006718	0	5	0	1	1	1	3	11
OG0006719	0	6	1	1	1	1	1	11
OG0006720	0	2	1	2	2	2	2	11
OG0006721	0	6	1	0	2	1	1	11
OG0006722	0	5	1	2	1	1	1	11
OG0006723	0	7	1	1	1	0	1	11
OG0006724	0	5	2	1	1	1	1	11
OG0006725	0	4	1	1	1	3	1	11
OG0006726	0	2	1	3	4	1	0	11
OG0006727	0	5	1	1	1	2	1	11
OG0006728	0	3	2	2	2	1	1	11
OG0006729	0	5	1	3	0	1	1	11
OG0006730	0	5	0	1	2	1	2	11
OG0006731	0	4	0	0	0	0	7	11
OG0006732	0	6	2	1	1	0	1	11
OG0006733	0	4	1	1	1	1	3	11
OG0006734	0	5	1	1	2	1	1	11
OG0006735	0	4	1	2	1	1	2	11
OG0006736	0	4	1	1	1	1	3	11
OG0006737	0	6	1	1	1	1	1	11
OG0006738	0	4	1	1	1	2	2	11
OG0006739	0	5	2	0	1	0	3	11
OG0006740	0	4	1	2	2	1	1	11
OG0006741	0	7	1	1	2	0	0	11
OG0006742	0	5	1	1	2	1	1	11
OG0006743	0	2	0	0	1	4	4	11
OG0006744	0	5	1	1	2	1	1	11
OG0006745	0	5	1	1	2	1	1	11
OG0006746	0	6	1	1	1	1	1	11
OG0006747	0	2	3	1	1	2	2	11
OG0006748	0	2	2	1	2	2	2	11
OG0006749	0	2	1	1	1	3	3	11
OG0006750	0	2	1	0	3	3	2	11
OG0006751	0	2	2	2	1	2	2	11
OG0006752	0	1	3	0	0	1	6	11
OG0006753	0	5	1	3	2	0	0	11
OG0006754	0	4	1	1	1	1	3	11
OG0006755	0	1	1	3	3	2	1	11
OG0006756	0	2	3	2	1	1	2	11
OG0006757	0	1	0	1	1	0	8	11
OG0006758	0	0	1	0	0	0	10	11
OG0006759	0	0	0	1	0	0	10	11
OG0006760	0	0	0	0	0	0	11	11
OG0006761	0	0	0	0	0	0	11	11
OG0006762	0	0	0	0	0	0	11	11
OG0006763	2	4	1	1	1	0	1	10
OG0006764	2	3	1	1	1	1	1	10
OG0006765	1	4	1	1	1	1	1	10
OG0006766	3	3	1	1	1	1	0	10
OG0006767	2	3	1	1	1	1	1	10
OG0006768	1	4	1	1	1	1	1	10
OG0006769	2	3	1	1	1	1	1	10
OG0006770	2	3	1	1	1	1	1	10
OG0006771	2	3	1	1	1	1	1	10
OG0006772	1	4	1	1	1	1	1	10
OG0006773	2	4	1	1	0	1	1	10
OG0006774	3	4	1	0	0	1	1	10
OG0006775	2	4	1	1	1	1	0	10
OG0006776	2	3	1	1	1	1	1	10
OG0006777	2	3	1	1	1	1	1	10
OG0006778	2	3	1	1	1	1	1	10
OG0006779	2	3	1	1	1	1	1	10
OG0006780	2	3	1	1	1	1	1	10
OG0006781	2	3	1	1	1	1	1	10
OG0006782	3	2	1	1	1	1	1	10
OG0006783	2	3	1	1	1	1	1	10
OG0006784	3	3	1	1	0	1	1	10
OG0006785	2	3	1	1	1	1	1	10
OG0006786	2	2	2	1	1	1	1	10
OG0006787	5	0	1	1	1	1	1	10
OG0006788	1	4	1	1	1	1	1	10
OG0006789	3	2	1	1	1	1	1	10
OG0006790	1	4	1	1	1	1	1	10
OG0006791	2	3	1	1	1	1	1	10
OG0006792	3	3	1	0	1	1	1	10
OG0006793	3	2	1	1	1	1	1	10
OG0006794	2	4	1	1	1	1	0	10
OG0006795	1	4	1	1	1	1	1	10
OG0006796	1	3	1	1	2	1	1	10
OG0006797	1	4	1	1	1	1	1	10
OG0006798	3	2	1	1	1	1	1	10
OG0006799	2	3	1	1	1	1	1	10
OG0006800	2	3	1	1	1	1	1	10
OG0006801	2	3	1	1	1	1	1	10
OG0006802	2	3	1	1	1	1	1	10
OG0006803	2	3	1	1	1	1	1	10
OG0006804	1	4	1	1	1	1	1	10
OG0006805	2	2	1	1	1	2	1	10
OG0006806	2	3	1	1	1	1	1	10
OG0006807	2	3	1	1	1	1	1	10
OG0006808	2	3	1	1	1	1	1	10
OG0006809	2	3	1	1	1	1	1	10
OG0006810	2	3	1	1	1	1	1	10
OG0006811	2	3	1	1	1	1	1	10
OG0006812	2	3	1	1	1	1	1	10
OG0006813	1	4	1	1	0	1	2	10
OG0006814	2	3	1	1	1	1	1	10
OG0006815	2	3	1	1	1	1	1	10
OG0006816	2	3	1	1	1	1	1	10
OG0006817	2	4	1	1	1	0	1	10
OG0006818	2	5	1	1	0	0	1	10
OG0006819	2	4	0	1	2	1	0	10
OG0006820	2	3	1	1	1	1	1	10
OG0006821	1	4	1	1	1	1	1	10
OG0006822	2	3	1	1	1	1	1	10
OG0006823	2	3	1	1	1	1	1	10
OG0006824	2	3	1	1	1	1	1	10
OG0006825	2	3	1	1	1	1	1	10
OG0006826	1	3	1	1	2	1	1	10
OG0006827	2	3	1	1	1	1	1	10
OG0006828	3	2	1	1	1	1	1	10
OG0006829	1	3	1	1	2	1	1	10
OG0006830	3	2	1	1	1	1	1	10
OG0006831	3	2	1	1	1	1	1	10
OG0006832	3	3	1	1	0	1	1	10
OG0006833	2	3	1	1	1	1	1	10
OG0006834	2	3	1	1	1	1	1	10
OG0006835	2	3	1	1	1	1	1	10
OG0006836	2	4	1	1	1	1	0	10
OG0006837	2	3	1	1	1	1	1	10
OG0006838	2	3	1	1	1	1	1	10
OG0006839	2	3	1	1	1	1	1	10
OG0006840	3	5	2	0	0	0	0	10
OG0006841	3	3	1	1	0	1	1	10
OG0006842	2	3	1	1	1	1	1	10
OG0006843	2	3	1	1	1	1	1	10
OG0006844	2	3	1	1	1	1	1	10
OG0006845	2	3	1	1	1	1	1	10
OG0006846	2	3	1	1	1	1	1	10
OG0006847	2	3	1	1	1	1	1	10
OG0006848	2	3	1	1	1	1	1	10
OG0006849	2	3	1	1	1	1	1	10
OG0006850	2	3	1	1	1	1	1	10
OG0006851	1	0	7	0	0	1	1	10
OG0006852	3	3	1	0	1	1	1	10
OG0006853	2	3	1	1	1	1	1	10
OG0006854	2	3	1	1	1	1	1	10
OG0006855	2	3	1	1	1	1	1	10
OG0006856	2	3	1	1	1	1	1	10
OG0006857	2	4	1	0	1	1	1	10
OG0006858	2	3	1	1	1	1	1	10
OG0006859	3	2	1	1	0	2	1	10
OG0006860	2	3	1	1	1	1	1	10
OG0006861	2	3	1	1	1	1	1	10
OG0006862	2	3	1	1	1	1	1	10
OG0006863	10	0	0	0	0	0	0	10
OG0006864	2	3	1	1	1	1	1	10
OG0006865	2	3	1	1	1	1	1	10
OG0006866	2	3	1	1	1	1	1	10
OG0006867	2	3	1	1	1	1	1	10
OG0006868	2	3	1	1	1	1	1	10
OG0006869	3	3	1	1	1	0	1	10
OG0006870	3	2	1	1	1	1	1	10
OG0006871	2	4	1	1	1	0	1	10
OG0006872	2	3	1	1	1	1	1	10
OG0006873	2	3	1	1	1	1	1	10
OG0006874	2	3	1	1	1	1	1	10
OG0006875	2	3	1	1	1	1	1	10
OG0006876	2	3	1	1	1	1	1	10
OG0006877	2	3	1	1	1	1	1	10
OG0006878	3	2	1	1	1	1	1	10
OG0006879	2	3	1	1	1	1	1	10
OG0006880	1	4	1	1	1	1	1	10
OG0006881	2	3	1	1	1	1	1	10
OG0006882	2	3	1	1	1	1	1	10
OG0006883	2	3	1	1	1	1	1	10
OG0006884	2	3	1	1	1	1	1	10
OG0006885	2	2	1	0	2	1	2	10
OG0006886	2	4	1	1	1	0	1	10
OG0006887	2	3	1	1	1	1	1	10
OG0006888	2	4	1	1	1	0	1	10
OG0006889	1	4	1	1	1	1	1	10
OG0006890	2	3	1	1	1	1	1	10
OG0006891	1	4	1	1	1	1	1	10
OG0006892	10	0	0	0	0	0	0	10
OG0006893	2	4	1	1	0	1	1	10
OG0006894	2	3	1	1	1	1	1	10
OG0006895	3	2	1	1	1	1	1	10
OG0006896	3	2	1	1	1	1	1	10
OG0006897	2	3	1	1	1	1	1	10
OG0006898	2	3	1	1	1	1	1	10
OG0006899	3	2	1	1	1	1	1	10
OG0006900	2	3	1	1	1	1	1	10
OG0006901	2	3	1	1	1	1	1	10
OG0006902	1	4	1	1	1	1	1	10
OG0006903	2	3	1	1	1	1	1	10
OG0006904	2	3	1	1	1	1	1	10
OG0006905	2	3	1	1	1	1	1	10
OG0006906	2	2	1	2	1	1	1	10
OG0006907	2	2	2	0	1	1	2	10
OG0006908	2	3	1	1	1	1	1	10
OG0006909	2	3	1	1	1	1	1	10
OG0006910	2	2	1	1	1	2	1	10
OG0006911	3	3	1	1	0	1	1	10
OG0006912	2	3	1	1	1	1	1	10
OG0006913	2	3	1	1	1	1	1	10
OG0006914	2	3	1	1	1	1	1	10
OG0006915	2	2	1	1	1	1	2	10
OG0006916	1	4	1	1	1	1	1	10
OG0006917	2	3	1	1	1	1	1	10
OG0006918	2	3	1	1	1	1	1	10
OG0006919	5	2	1	1	0	0	1	10
OG0006920	2	3	1	1	1	1	1	10
OG0006921	2	3	1	1	2	0	1	10
OG0006922	2	3	1	1	1	1	1	10
OG0006923	2	5	1	1	0	0	1	10
OG0006924	2	3	1	1	1	1	1	10
OG0006925	3	2	1	1	1	1	1	10
OG0006926	1	3	1	1	1	2	1	10
OG0006927	1	4	1	1	1	1	1	10
OG0006928	2	3	1	1	1	1	1	10
OG0006929	1	4	1	1	1	1	1	10
OG0006930	10	0	0	0	0	0	0	10
OG0006931	3	2	1	1	1	1	1	10
OG0006932	2	4	1	0	1	1	1	10
OG0006933	2	3	1	1	1	1	1	10
OG0006934	2	4	1	1	1	0	1	10
OG0006935	5	1	1	0	1	1	1	10
OG0006936	2	3	1	1	1	1	1	10
OG0006937	1	4	1	1	1	1	1	10
OG0006938	3	3	1	1	1	0	1	10
OG0006939	2	3	1	1	1	1	1	10
OG0006940	10	0	0	0	0	0	0	10
OG0006941	3	2	1	1	1	1	1	10
OG0006942	3	2	1	1	1	1	1	10
OG0006943	2	3	1	1	1	1	1	10
OG0006944	2	3	1	1	1	1	1	10
OG0006945	1	4	1	1	1	1	1	10
OG0006946	2	3	1	1	1	1	1	10
OG0006947	2	3	1	1	1	1	1	10
OG0006948	3	2	1	1	1	1	1	10
OG0006949	3	2	1	1	1	1	1	10
OG0006950	2	3	1	1	1	0	2	10
OG0006951	2	4	1	1	0	1	1	10
OG0006952	3	2	1	1	1	1	1	10
OG0006953	2	3	1	1	1	1	1	10
OG0006954	2	3	1	1	1	1	1	10
OG0006955	2	3	1	1	1	1	1	10
OG0006956	3	3	2	1	0	0	1	10
OG0006957	2	3	1	1	1	1	1	10
OG0006958	2	3	1	1	1	1	1	10
OG0006959	2	3	1	1	1	1	1	10
OG0006960	2	3	1	1	1	1	1	10
OG0006961	1	6	1	1	1	0	0	10
OG0006962	1	4	1	1	1	1	1	10
OG0006963	3	2	1	1	1	1	1	10
OG0006964	2	3	1	1	1	1	1	10
OG0006965	3	2	1	1	1	1	1	10
OG0006966	2	3	1	1	1	1	1	10
OG0006967	2	3	1	1	1	1	1	10
OG0006968	4	1	1	1	1	1	1	10
OG0006969	2	3	1	1	1	1	1	10
OG0006970	2	3	1	1	1	1	1	10
OG0006971	2	3	1	1	1	1	1	10
OG0006972	2	3	1	1	1	1	1	10
OG0006973	2	2	1	1	1	1	2	10
OG0006974	3	2	1	1	1	1	1	10
OG0006975	10	0	0	0	0	0	0	10
OG0006976	2	3	1	1	1	1	1	10
OG0006977	2	3	1	1	1	1	1	10
OG0006978	2	1	3	1	1	1	1	10
OG0006979	2	4	1	1	1	0	1	10
OG0006980	2	3	1	1	1	0	2	10
OG0006981	1	4	2	1	1	0	1	10
OG0006982	3	6	1	0	0	0	0	10
OG0006983	2	4	1	1	1	0	1	10
OG0006984	2	4	1	1	1	0	1	10
OG0006985	2	3	1	1	1	1	1	10
OG0006986	2	3	1	1	1	1	1	10
OG0006987	8	0	2	0	0	0	0	10
OG0006988	2	3	1	1	1	1	1	10
OG0006989	2	3	1	1	1	1	1	10
OG0006990	2	3	1	1	1	1	1	10
OG0006991	1	3	1	0	1	2	2	10
OG0006992	2	3	1	1	1	1	1	10
OG0006993	2	3	1	1	1	1	1	10
OG0006994	2	3	1	1	1	1	1	10
OG0006995	2	4	1	1	1	0	1	10
OG0006996	3	2	1	1	1	1	1	10
OG0006997	3	4	1	1	0	0	1	10
OG0006998	3	2	1	1	1	1	1	10
OG0006999	2	2	1	1	1	2	1	10
OG0007000	10	0	0	0	0	0	0	10
OG0007001	2	3	1	1	1	1	1	10
OG0007002	1	4	1	1	1	1	1	10
OG0007003	3	2	1	1	1	1	1	10
OG0007004	2	3	1	1	1	1	1	10
OG0007005	2	3	1	1	1	1	1	10
OG0007006	1	4	1	1	1	1	1	10
OG0007007	2	4	1	1	1	1	0	10
OG0007008	2	3	1	1	1	1	1	10
OG0007009	2	3	1	1	1	1	1	10
OG0007010	2	4	0	1	1	1	1	10
OG0007011	2	3	1	1	1	1	1	10
OG0007012	2	4	1	1	0	1	1	10
OG0007013	2	3	1	1	1	1	1	10
OG0007014	1	4	1	1	1	1	1	10
OG0007015	3	2	1	1	1	1	1	10
OG0007016	2	4	1	1	1	0	1	10
OG0007017	2	3	1	1	1	1	1	10
OG0007018	2	3	1	1	1	1	1	10
OG0007019	2	3	1	1	1	1	1	10
OG0007020	2	3	1	1	1	1	1	10
OG0007021	1	4	1	1	1	1	1	10
OG0007022	2	2	2	1	1	1	1	10
OG0007023	1	4	1	1	1	1	1	10
OG0007024	2	3	1	1	1	1	1	10
OG0007025	2	3	1	1	1	1	1	10
OG0007026	2	3	1	1	1	1	1	10
OG0007027	3	2	1	1	1	1	1	10
OG0007028	2	3	1	1	1	1	1	10
OG0007029	2	3	1	1	1	1	1	10
OG0007030	5	2	2	0	0	1	0	10
OG0007031	2	3	1	1	1	1	1	10
OG0007032	1	2	3	1	1	1	1	10
OG0007033	2	3	1	1	1	1	1	10
OG0007034	2	3	1	1	1	1	1	10
OG0007035	2	3	1	1	1	1	1	10
OG0007036	2	3	1	1	1	1	1	10
OG0007037	2	3	1	1	1	1	1	10
OG0007038	2	3	1	1	1	1	1	10
OG0007039	2	3	1	1	1	1	1	10
OG0007040	1	2	1	2	1	0	3	10
OG0007041	2	4	1	1	1	1	0	10
OG0007042	2	3	1	1	1	1	1	10
OG0007043	2	3	1	1	1	1	1	10
OG0007044	2	3	1	1	1	1	1	10
OG0007045	2	3	1	1	1	1	1	10
OG0007046	2	3	1	1	1	1	1	10
OG0007047	2	3	1	1	1	1	1	10
OG0007048	2	4	1	1	0	1	1	10
OG0007049	2	3	1	1	1	1	1	10
OG0007050	1	4	1	1	1	1	1	10
OG0007051	2	3	1	1	1	1	1	10
OG0007052	2	4	1	1	1	0	1	10
OG0007053	2	3	1	1	1	1	1	10
OG0007054	2	3	1	1	1	1	1	10
OG0007055	2	3	1	1	1	1	1	10
OG0007056	2	3	1	1	1	1	1	10
OG0007057	3	2	1	1	1	1	1	10
OG0007058	2	3	1	1	1	1	1	10
OG0007059	3	3	1	1	0	1	1	10
OG0007060	2	3	1	1	1	1	1	10
OG0007061	2	3	1	1	1	1	1	10
OG0007062	2	3	1	1	1	1	1	10
OG0007063	2	3	1	1	1	1	1	10
OG0007064	2	3	1	1	1	1	1	10
OG0007065	2	3	1	1	1	1	1	10
OG0007066	2	3	1	1	1	1	1	10
OG0007067	2	4	1	1	1	0	1	10
OG0007068	1	4	1	1	1	1	1	10
OG0007069	2	3	1	1	1	1	1	10
OG0007070	2	4	0	1	0	1	2	10
OG0007071	1	4	1	1	1	1	1	10
OG0007072	3	3	1	1	0	1	1	10
OG0007073	1	5	1	1	1	1	0	10
OG0007074	2	4	1	1	1	1	0	10
OG0007075	2	3	1	1	1	1	1	10
OG0007076	1	3	1	1	1	2	1	10
OG0007077	3	2	1	1	1	1	1	10
OG0007078	2	4	1	1	1	1	0	10
OG0007079	1	3	1	1	1	1	2	10
OG0007080	2	4	1	1	1	0	1	10
OG0007081	3	0	1	1	1	2	2	10
OG0007082	2	3	1	1	1	1	1	10
OG0007083	2	3	1	1	1	1	1	10
OG0007084	2	3	1	1	1	1	1	10
OG0007085	5	1	0	0	1	1	2	10
OG0007086	2	3	1	1	1	1	1	10
OG0007087	3	2	1	1	1	1	1	10
OG0007088	2	3	1	1	1	1	1	10
OG0007089	2	4	1	1	1	0	1	10
OG0007090	2	3	1	1	1	1	1	10
OG0007091	2	3	1	1	1	1	1	10
OG0007092	2	3	1	1	1	1	1	10
OG0007093	2	3	1	1	1	1	1	10
OG0007094	10	0	0	0	0	0	0	10
OG0007095	2	3	1	1	1	1	1	10
OG0007096	1	4	1	1	1	0	2	10
OG0007097	2	3	2	1	0	1	1	10
OG0007098	2	3	1	1	1	1	1	10
OG0007099	2	4	1	1	0	1	1	10
OG0007100	2	3	1	1	1	1	1	10
OG0007101	2	3	1	1	1	1	1	10
OG0007102	3	2	1	1	1	1	1	10
OG0007103	2	3	1	1	1	1	1	10
OG0007104	1	6	1	1	1	0	0	10
OG0007105	2	3	1	1	1	1	1	10
OG0007106	2	3	1	1	1	1	1	10
OG0007107	2	3	1	1	1	1	1	10
OG0007108	2	3	1	1	1	1	1	10
OG0007109	1	4	1	1	1	1	1	10
OG0007110	2	3	1	1	1	1	1	10
OG0007111	2	3	1	0	1	1	2	10
OG0007112	2	3	1	1	1	1	1	10
OG0007113	2	3	1	1	1	1	1	10
OG0007114	3	2	1	1	1	1	1	10
OG0007115	1	3	1	1	1	1	2	10
OG0007116	2	4	1	1	1	1	0	10
OG0007117	10	0	0	0	0	0	0	10
OG0007118	2	3	1	1	1	1	1	10
OG0007119	2	3	1	1	1	1	1	10
OG0007120	2	3	1	1	1	1	1	10
OG0007121	2	3	1	1	1	1	1	10
OG0007122	3	2	1	1	1	1	1	10
OG0007123	2	3	1	1	1	1	1	10
OG0007124	2	4	1	1	0	1	1	10
OG0007125	2	3	1	1	1	1	1	10
OG0007126	2	3	1	1	1	1	1	10
OG0007127	2	3	1	1	1	1	1	10
OG0007128	2	3	1	1	2	0	1	10
OG0007129	2	3	1	1	2	0	1	10
OG0007130	2	3	1	1	1	1	1	10
OG0007131	1	4	1	1	1	1	1	10
OG0007132	4	3	1	1	1	0	0	10
OG0007133	2	2	1	1	1	2	1	10
OG0007134	2	2	1	1	1	1	2	10
OG0007135	2	3	1	1	1	1	1	10
OG0007136	2	4	1	1	1	0	1	10
OG0007137	2	3	1	1	1	1	1	10
OG0007138	1	3	1	2	1	1	1	10
OG0007139	1	4	1	1	1	1	1	10
OG0007140	2	3	1	1	1	1	1	10
OG0007141	1	3	2	1	1	1	1	10
OG0007142	2	3	1	1	1	1	1	10
OG0007143	2	3	1	1	1	1	1	10
OG0007144	2	3	1	1	1	1	1	10
OG0007145	2	3	1	1	1	1	1	10
OG0007146	1	4	1	1	1	1	1	10
OG0007147	1	4	1	1	1	1	1	10
OG0007148	3	2	1	1	1	1	1	10
OG0007149	2	3	1	1	1	1	1	10
OG0007150	3	3	1	1	1	1	0	10
OG0007151	2	4	1	1	0	1	1	10
OG0007152	2	3	1	1	1	1	1	10
OG0007153	1	4	1	1	1	1	1	10
OG0007154	2	3	1	1	1	1	1	10
OG0007155	2	2	1	2	1	1	1	10
OG0007156	2	3	1	1	1	1	1	10
OG0007157	2	3	1	1	1	1	1	10
OG0007158	2	3	1	1	1	1	1	10
OG0007159	1	4	1	1	1	1	1	10
OG0007160	2	3	1	1	1	1	1	10
OG0007161	3	2	2	1	1	0	1	10
OG0007162	3	2	1	1	1	1	1	10
OG0007163	2	3	1	1	1	1	1	10
OG0007164	10	0	0	0	0	0	0	10
OG0007165	2	4	1	1	1	0	1	10
OG0007166	2	3	1	1	1	1	1	10
OG0007167	3	2	1	1	1	1	1	10
OG0007168	1	4	1	1	1	1	1	10
OG0007169	2	3	1	1	1	1	1	10
OG0007170	2	3	1	1	1	1	1	10
OG0007171	3	2	1	1	1	1	1	10
OG0007172	2	3	1	1	1	1	1	10
OG0007173	2	3	1	1	1	1	1	10
OG0007174	2	3	1	1	1	1	1	10
OG0007175	2	2	1	1	1	2	1	10
OG0007176	10	0	0	0	0	0	0	10
OG0007177	1	4	1	1	1	1	1	10
OG0007178	3	2	1	1	1	1	1	10
OG0007179	2	3	1	1	1	1	1	10
OG0007180	2	3	1	1	1	1	1	10
OG0007181	2	3	1	1	1	1	1	10
OG0007182	2	4	1	1	1	0	1	10
OG0007183	2	3	1	1	1	1	1	10
OG0007184	2	2	1	1	1	1	2	10
OG0007185	2	3	1	1	1	1	1	10
OG0007186	2	3	1	1	1	1	1	10
OG0007187	10	0	0	0	0	0	0	10
OG0007188	2	3	1	1	1	1	1	10
OG0007189	1	3	1	1	1	1	2	10
OG0007190	1	8	0	0	1	0	0	10
OG0007191	2	3	1	1	1	1	1	10
OG0007192	2	3	1	1	1	1	1	10
OG0007193	2	3	1	1	1	1	1	10
OG0007194	2	3	1	1	1	1	1	10
OG0007195	1	4	1	1	1	1	1	10
OG0007196	1	4	1	1	1	1	1	10
OG0007197	2	3	1	1	1	1	1	10
OG0007198	2	3	1	1	1	1	1	10
OG0007199	2	3	1	1	1	1	1	10
OG0007200	2	3	1	1	1	1	1	10
OG0007201	3	2	1	1	1	0	2	10
OG0007202	2	3	1	1	1	1	1	10
OG0007203	2	3	1	1	1	1	1	10
OG0007204	1	4	1	1	1	1	1	10
OG0007205	2	3	1	1	1	1	1	10
OG0007206	3	2	1	1	1	1	1	10
OG0007207	2	3	1	1	1	1	1	10
OG0007208	2	3	1	1	1	1	1	10
OG0007209	2	4	1	1	1	0	1	10
OG0007210	1	4	1	1	1	1	1	10
OG0007211	1	3	2	1	1	1	1	10
OG0007212	2	3	1	1	1	1	1	10
OG0007213	2	3	1	1	1	1	1	10
OG0007214	2	3	1	1	1	1	1	10
OG0007215	2	3	1	1	1	1	1	10
OG0007216	1	4	1	1	1	1	1	10
OG0007217	2	3	1	1	1	1	1	10
OG0007218	3	2	1	1	1	1	1	10
OG0007219	3	2	1	0	1	1	2	10
OG0007220	1	4	1	1	1	1	1	10
OG0007221	2	4	0	1	1	1	1	10
OG0007222	3	2	1	1	0	2	1	10
OG0007223	2	3	1	1	1	1	1	10
OG0007224	2	2	1	1	1	1	2	10
OG0007225	1	4	1	1	1	1	1	10
OG0007226	2	3	1	1	1	1	1	10
OG0007227	2	3	1	1	1	0	2	10
OG0007228	2	4	1	0	0	0	3	10
OG0007229	2	3	1	1	1	1	1	10
OG0007230	2	3	1	1	1	1	1	10
OG0007231	2	3	1	1	1	1	1	10
OG0007232	2	3	1	1	1	1	1	10
OG0007233	2	3	1	1	1	1	1	10
OG0007234	1	5	1	1	1	0	1	10
OG0007235	2	3	1	1	1	1	1	10
OG0007236	2	3	1	1	1	1	1	10
OG0007237	2	3	1	1	1	1	1	10
OG0007238	2	3	1	1	1	1	1	10
OG0007239	2	3	1	1	1	0	2	10
OG0007240	2	3	1	1	1	1	1	10
OG0007241	2	3	1	1	1	1	1	10
OG0007242	2	3	1	1	1	1	1	10
OG0007243	2	3	1	1	1	1	1	10
OG0007244	1	4	1	1	1	1	1	10
OG0007245	2	3	1	1	1	1	1	10
OG0007246	2	3	1	1	1	1	1	10
OG0007247	2	3	1	1	1	1	1	10
OG0007248	2	4	1	1	1	0	1	10
OG0007249	2	3	1	1	1	1	1	10
OG0007250	2	4	1	1	1	1	0	10
OG0007251	3	2	1	1	1	1	1	10
OG0007252	10	0	0	0	0	0	0	10
OG0007253	2	3	1	1	1	1	1	10
OG0007254	2	3	1	1	1	1	1	10
OG0007255	2	3	1	1	1	1	1	10
OG0007256	2	3	1	1	1	1	1	10
OG0007257	2	4	1	1	1	0	1	10
OG0007258	10	0	0	0	0	0	0	10
OG0007259	2	3	1	1	1	1	1	10
OG0007260	2	3	1	1	1	1	1	10
OG0007261	2	3	1	1	1	1	1	10
OG0007262	2	3	1	1	1	1	1	10
OG0007263	2	3	1	1	1	1	1	10
OG0007264	2	3	1	1	1	1	1	10
OG0007265	2	3	1	1	1	1	1	10
OG0007266	1	3	1	2	1	1	1	10
OG0007267	2	3	1	1	1	1	1	10
OG0007268	3	3	1	0	1	1	1	10
OG0007269	2	3	1	1	1	1	1	10
OG0007270	2	3	1	1	1	1	1	10
OG0007271	3	2	1	1	1	1	1	10
OG0007272	3	2	1	1	1	1	1	10
OG0007273	3	3	0	0	2	1	1	10
OG0007274	2	3	1	1	1	0	2	10
OG0007275	2	3	1	1	1	0	2	10
OG0007276	2	3	1	1	1	1	1	10
OG0007277	2	3	1	1	1	1	1	10
OG0007278	2	3	1	1	1	1	1	10
OG0007279	2	4	1	1	0	1	1	10
OG0007280	2	3	1	1	1	1	1	10
OG0007281	2	3	1	1	1	1	1	10
OG0007282	2	3	1	1	1	1	1	10
OG0007283	2	3	1	1	1	1	1	10
OG0007284	2	3	1	1	1	1	1	10
OG0007285	2	4	1	1	1	1	0	10
OG0007286	2	3	1	1	1	1	1	10
OG0007287	2	3	1	1	1	1	1	10
OG0007288	2	3	1	1	1	1	1	10
OG0007289	2	3	1	1	1	1	1	10
OG0007290	3	2	1	1	1	0	2	10
OG0007291	2	3	1	1	1	1	1	10
OG0007292	3	2	1	1	1	1	1	10
OG0007293	2	3	1	1	1	1	1	10
OG0007294	1	4	1	1	1	1	1	10
OG0007295	2	3	1	1	1	1	1	10
OG0007296	1	4	1	1	1	1	1	10
OG0007297	3	3	1	1	1	1	0	10
OG0007298	2	3	1	1	1	1	1	10
OG0007299	2	3	1	1	1	1	1	10
OG0007300	2	3	1	1	1	1	1	10
OG0007301	3	2	1	1	1	1	1	10
OG0007302	2	3	1	1	1	1	1	10
OG0007303	2	3	1	1	1	1	1	10
OG0007304	2	3	1	1	1	1	1	10
OG0007305	3	2	1	1	1	1	1	10
OG0007306	3	2	1	1	1	1	1	10
OG0007307	2	3	1	1	1	1	1	10
OG0007308	3	2	1	1	1	1	1	10
OG0007309	3	2	1	1	1	1	1	10
OG0007310	6	1	0	1	0	1	1	10
OG0007311	1	4	1	1	1	1	1	10
OG0007312	2	3	1	1	1	1	1	10
OG0007313	1	4	1	1	1	1	1	10
OG0007314	2	3	1	1	1	1	1	10
OG0007315	2	3	1	1	1	1	1	10
OG0007316	3	2	1	1	1	1	1	10
OG0007317	2	3	1	1	1	1	1	10
OG0007318	2	3	1	1	1	1	1	10
OG0007319	3	2	1	1	1	1	1	10
OG0007320	1	4	1	1	1	1	1	10
OG0007321	2	3	1	1	1	1	1	10
OG0007322	2	5	1	1	0	1	0	10
OG0007323	2	3	1	1	1	1	1	10
OG0007324	2	3	1	1	1	1	1	10
OG0007325	2	3	1	1	1	1	1	10
OG0007326	1	4	1	1	1	1	1	10
OG0007327	2	3	1	1	1	1	1	10
OG0007328	3	3	1	1	1	0	1	10
OG0007329	2	3	1	1	1	1	1	10
OG0007330	9	1	0	0	0	0	0	10
OG0007331	2	3	1	1	1	1	1	10
OG0007332	1	3	1	1	1	1	2	10
OG0007333	2	3	1	1	1	1	1	10
OG0007334	1	3	1	1	1	1	2	10
OG0007335	2	3	1	1	1	1	1	10
OG0007336	3	2	1	1	1	1	1	10
OG0007337	1	3	1	1	1	2	1	10
OG0007338	1	3	2	1	1	1	1	10
OG0007339	2	3	1	1	1	1	1	10
OG0007340	2	2	1	1	1	2	1	10
OG0007341	1	4	1	1	1	1	1	10
OG0007342	2	3	1	1	1	1	1	10
OG0007343	3	3	1	1	1	0	1	10
OG0007344	10	0	0	0	0	0	0	10
OG0007345	1	4	1	1	1	1	1	10
OG0007346	2	3	1	1	1	1	1	10
OG0007347	2	3	1	1	1	1	1	10
OG0007348	2	3	1	1	1	1	1	10
OG0007349	2	3	1	1	1	1	1	10
OG0007350	7	2	0	1	0	0	0	10
OG0007351	2	3	1	1	1	1	1	10
OG0007352	2	3	1	1	1	1	1	10
OG0007353	2	3	1	1	1	1	1	10
OG0007354	2	3	1	1	1	1	1	10
OG0007355	1	4	1	1	1	1	1	10
OG0007356	1	4	1	1	1	1	1	10
OG0007357	2	3	1	1	1	1	1	10
OG0007358	10	0	0	0	0	0	0	10
OG0007359	1	4	1	1	1	1	1	10
OG0007360	2	3	1	1	1	1	1	10
OG0007361	2	3	1	1	1	1	1	10
OG0007362	1	4	1	1	1	1	1	10
OG0007363	1	8	0	1	0	0	0	10
OG0007364	2	3	1	1	1	1	1	10
OG0007365	2	3	1	1	1	1	1	10
OG0007366	2	3	1	1	1	1	1	10
OG0007367	2	3	1	1	1	1	1	10
OG0007368	1	3	1	1	1	2	1	10
OG0007369	1	4	1	1	1	1	1	10
OG0007370	3	4	1	1	1	0	0	10
OG0007371	2	3	1	1	1	1	1	10
OG0007372	2	3	1	1	1	1	1	10
OG0007373	2	4	1	0	1	1	1	10
OG0007374	2	3	1	1	1	1	1	10
OG0007375	2	3	1	1	1	1	1	10
OG0007376	2	3	1	1	1	1	1	10
OG0007377	3	2	1	1	1	1	1	10
OG0007378	2	2	1	1	1	1	2	10
OG0007379	2	3	1	1	1	1	1	10
OG0007380	2	3	1	1	1	1	1	10
OG0007381	3	2	1	1	1	1	1	10
OG0007382	2	3	1	1	1	1	1	10
OG0007383	2	3	1	1	1	1	1	10
OG0007384	2	2	1	2	1	1	1	10
OG0007385	3	2	1	1	1	1	1	10
OG0007386	2	3	1	1	1	1	1	10
OG0007387	2	3	1	1	1	1	1	10
OG0007388	2	3	1	1	1	1	1	10
OG0007389	2	3	1	1	1	1	1	10
OG0007390	2	4	1	1	1	0	1	10
OG0007391	3	3	1	0	1	1	1	10
OG0007392	2	3	1	1	1	1	1	10
OG0007393	2	3	1	1	1	1	1	10
OG0007394	2	3	1	1	1	1	1	10
OG0007395	7	2	0	0	0	0	1	10
OG0007396	2	5	1	0	1	1	0	10
OG0007397	3	2	1	1	1	1	1	10
OG0007398	2	3	1	1	1	1	1	10
OG0007399	1	4	1	1	1	1	1	10
OG0007400	2	3	1	1	1	1	1	10
OG0007401	1	4	1	1	1	1	1	10
OG0007402	2	4	1	1	1	0	1	10
OG0007403	2	3	1	1	1	1	1	10
OG0007404	1	3	1	1	1	1	2	10
OG0007405	2	3	1	1	1	1	1	10
OG0007406	2	3	1	1	1	1	1	10
OG0007407	3	2	1	1	1	1	1	10
OG0007408	2	3	1	1	1	1	1	10
OG0007409	2	3	1	1	1	1	1	10
OG0007410	2	3	1	1	1	0	2	10
OG0007411	2	3	1	1	1	1	1	10
OG0007412	2	3	2	0	1	1	1	10
OG0007413	1	4	1	1	1	0	2	10
OG0007414	2	3	1	1	1	1	1	10
OG0007415	2	3	1	1	1	1	1	10
OG0007416	2	4	1	1	0	1	1	10
OG0007417	2	3	1	1	1	1	1	10
OG0007418	2	3	1	1	1	1	1	10
OG0007419	2	3	1	1	1	1	1	10
OG0007420	3	3	1	0	1	1	1	10
OG0007421	2	1	1	1	1	2	2	10
OG0007422	2	3	1	1	1	1	1	10
OG0007423	2	3	1	1	1	1	1	10
OG0007424	2	3	1	1	1	1	1	10
OG0007425	2	3	1	1	1	1	1	10
OG0007426	1	4	1	1	1	1	1	10
OG0007427	2	3	1	1	1	1	1	10
OG0007428	2	3	1	1	1	1	1	10
OG0007429	2	2	2	1	1	1	1	10
OG0007430	2	3	1	1	1	1	1	10
OG0007431	1	3	1	1	1	2	1	10
OG0007432	2	2	2	1	1	1	1	10
OG0007433	2	0	1	2	2	1	2	10
OG0007434	2	3	1	1	1	1	1	10
OG0007435	2	3	1	1	1	1	1	10
OG0007436	2	3	1	1	1	1	1	10
OG0007437	2	3	1	1	1	1	1	10
OG0007438	2	3	1	1	1	1	1	10
OG0007439	2	3	1	1	1	1	1	10
OG0007440	2	3	1	1	1	1	1	10
OG0007441	2	3	1	1	1	1	1	10
OG0007442	1	4	1	1	1	1	1	10
OG0007443	2	3	1	1	1	1	1	10
OG0007444	2	3	1	1	1	1	1	10
OG0007445	2	3	1	1	1	1	1	10
OG0007446	2	3	1	1	1	1	1	10
OG0007447	2	3	1	1	1	1	1	10
OG0007448	2	3	1	1	1	1	1	10
OG0007449	2	3	1	1	1	1	1	10
OG0007450	3	2	1	1	1	1	1	10
OG0007451	7	1	0	0	0	1	1	10
OG0007452	1	4	1	1	1	1	1	10
OG0007453	3	2	1	1	1	1	1	10
OG0007454	3	2	1	1	1	1	1	10
OG0007455	2	2	1	1	1	2	1	10
OG0007456	2	3	1	1	1	1	1	10
OG0007457	2	3	1	1	1	1	1	10
OG0007458	1	4	1	1	1	1	1	10
OG0007459	1	4	1	1	1	1	1	10
OG0007460	3	2	1	1	1	1	1	10
OG0007461	1	4	1	1	1	1	1	10
OG0007462	2	3	1	1	1	1	1	10
OG0007463	1	4	1	1	1	1	1	10
OG0007464	2	2	1	1	1	2	1	10
OG0007465	2	3	1	1	1	1	1	10
OG0007466	2	3	1	1	1	1	1	10
OG0007467	3	3	1	1	1	1	0	10
OG0007468	2	4	1	1	1	0	1	10
OG0007469	1	4	1	1	1	1	1	10
OG0007470	2	3	1	1	1	1	1	10
OG0007471	2	3	1	1	1	1	1	10
OG0007472	1	4	1	1	1	1	1	10
OG0007473	3	2	1	1	1	1	1	10
OG0007474	4	2	1	1	1	0	1	10
OG0007475	3	2	1	1	1	1	1	10
OG0007476	10	0	0	0	0	0	0	10
OG0007477	2	2	1	1	1	2	1	10
OG0007478	2	4	1	1	1	0	1	10
OG0007479	3	4	1	1	1	0	0	10
OG0007480	2	2	1	1	1	1	2	10
OG0007481	2	3	1	1	1	1	1	10
OG0007482	1	4	1	1	1	1	1	10
OG0007483	2	3	1	1	1	1	1	10
OG0007484	2	3	1	1	1	1	1	10
OG0007485	2	3	1	1	1	1	1	10
OG0007486	2	3	1	1	1	1	1	10
OG0007487	2	4	1	1	1	0	1	10
OG0007488	2	3	1	1	1	1	1	10
OG0007489	2	4	1	1	1	0	1	10
OG0007490	4	1	1	1	1	1	1	10
OG0007491	2	4	1	1	1	0	1	10
OG0007492	2	4	1	1	1	1	0	10
OG0007493	2	3	1	1	1	1	1	10
OG0007494	2	3	1	1	1	1	1	10
OG0007495	2	3	1	1	1	1	1	10
OG0007496	2	2	1	1	1	1	2	10
OG0007497	2	3	1	1	1	1	1	10
OG0007498	2	3	1	1	1	1	1	10
OG0007499	2	4	1	1	1	1	0	10
OG0007500	2	3	1	1	1	1	1	10
OG0007501	2	3	1	1	1	1	1	10
OG0007502	2	3	1	1	1	1	1	10
OG0007503	1	3	2	1	1	1	1	10
OG0007504	2	3	1	1	1	1	1	10
OG0007505	3	2	1	1	1	1	1	10
OG0007506	3	2	1	1	1	1	1	10
OG0007507	2	3	1	1	1	1	1	10
OG0007508	2	2	1	1	1	1	2	10
OG0007509	1	5	1	1	0	1	1	10
OG0007510	2	3	1	0	2	1	1	10
OG0007511	2	2	1	1	1	1	2	10
OG0007512	2	3	1	1	1	1	1	10
OG0007513	2	3	1	1	1	1	1	10
OG0007514	1	4	1	1	1	1	1	10
OG0007515	2	3	1	1	1	1	1	10
OG0007516	2	3	1	1	1	1	1	10
OG0007517	2	4	1	1	1	1	0	10
OG0007518	1	4	1	1	1	1	1	10
OG0007519	2	3	1	1	1	0	2	10
OG0007520	1	5	1	0	1	1	1	10
OG0007521	2	2	1	1	1	2	1	10
OG0007522	2	3	1	0	2	1	1	10
OG0007523	1	3	1	1	1	2	1	10
OG0007524	1	4	1	1	1	1	1	10
OG0007525	1	4	1	1	1	1	1	10
OG0007526	2	3	1	1	1	1	1	10
OG0007527	3	2	1	1	1	1	1	10
OG0007528	2	3	1	1	1	1	1	10
OG0007529	2	4	1	1	1	0	1	10
OG0007530	1	4	1	1	1	1	1	10
OG0007531	2	3	1	1	1	1	1	10
OG0007532	2	3	1	1	1	1	1	10
OG0007533	2	2	1	1	1	2	1	10
OG0007534	2	2	2	1	1	1	1	10
OG0007535	2	3	1	1	1	1	1	10
OG0007536	2	3	1	1	1	1	1	10
OG0007537	4	2	0	1	1	1	1	10
OG0007538	3	2	1	1	1	1	1	10
OG0007539	2	3	1	1	1	1	1	10
OG0007540	2	4	1	0	1	1	1	10
OG0007541	2	3	1	1	1	1	1	10
OG0007542	2	3	1	1	1	1	1	10
OG0007543	1	4	1	1	1	1	1	10
OG0007544	1	4	1	1	1	1	1	10
OG0007545	2	3	1	1	1	1	1	10
OG0007546	2	3	1	1	1	1	1	10
OG0007547	2	3	1	1	1	1	1	10
OG0007548	2	3	1	1	1	1	1	10
OG0007549	2	3	1	1	1	1	1	10
OG0007550	2	3	1	1	1	1	1	10
OG0007551	2	4	1	1	1	0	1	10
OG0007552	2	3	1	1	1	1	1	10
OG0007553	2	3	1	1	1	1	1	10
OG0007554	2	3	1	1	1	1	1	10
OG0007555	2	3	1	1	2	0	1	10
OG0007556	2	3	1	1	1	1	1	10
OG0007557	3	2	1	1	1	1	1	10
OG0007558	2	3	1	1	1	1	1	10
OG0007559	1	4	1	1	1	1	1	10
OG0007560	1	4	1	1	1	1	1	10
OG0007561	1	4	1	1	1	1	1	10
OG0007562	2	3	1	1	1	1	1	10
OG0007563	2	4	1	1	0	1	1	10
OG0007564	2	3	1	1	1	1	1	10
OG0007565	2	3	1	1	1	1	1	10
OG0007566	2	3	1	1	1	1	1	10
OG0007567	2	3	1	1	1	1	1	10
OG0007568	2	2	1	1	1	2	1	10
OG0007569	3	3	1	1	1	1	0	10
OG0007570	2	2	1	1	1	2	1	10
OG0007571	2	4	1	1	1	0	1	10
OG0007572	1	4	1	1	1	1	1	10
OG0007573	3	2	1	1	1	1	1	10
OG0007574	1	4	1	1	1	1	1	10
OG0007575	2	2	1	1	1	2	1	10
OG0007576	2	3	1	1	1	1	1	10
OG0007577	3	3	1	1	1	0	1	10
OG0007578	2	3	1	1	1	1	1	10
OG0007579	2	3	1	1	1	1	1	10
OG0007580	2	3	1	1	1	1	1	10
OG0007581	2	3	1	1	1	1	1	10
OG0007582	3	2	1	1	1	1	1	10
OG0007583	2	3	1	1	1	1	1	10
OG0007584	1	4	1	1	1	1	1	10
OG0007585	1	3	1	1	1	2	1	10
OG0007586	2	3	1	1	1	1	1	10
OG0007587	2	4	1	1	1	0	1	10
OG0007588	2	3	1	1	1	1	1	10
OG0007589	1	5	1	1	1	1	0	10
OG0007590	1	4	1	1	1	1	1	10
OG0007591	1	4	1	1	1	1	1	10
OG0007592	2	3	1	1	1	1	1	10
OG0007593	1	3	1	1	1	2	1	10
OG0007594	2	4	1	1	1	0	1	10
OG0007595	2	3	1	1	1	1	1	10
OG0007596	3	2	1	1	1	1	1	10
OG0007597	1	4	1	1	1	1	1	10
OG0007598	2	3	1	1	1	1	1	10
OG0007599	2	5	1	1	0	0	1	10
OG0007600	2	3	1	1	1	1	1	10
OG0007601	3	3	1	1	1	0	1	10
OG0007602	2	3	1	1	1	1	1	10
OG0007603	3	2	1	1	1	1	1	10
OG0007604	2	3	1	1	1	1	1	10
OG0007605	2	3	1	1	1	1	1	10
OG0007606	1	3	1	1	2	1	1	10
OG0007607	2	3	1	1	1	1	1	10
OG0007608	2	3	1	1	1	1	1	10
OG0007609	2	3	1	1	1	1	1	10
OG0007610	2	3	1	1	1	1	1	10
OG0007611	2	3	1	1	1	1	1	10
OG0007612	4	2	1	1	1	0	1	10
OG0007613	2	3	1	1	1	1	1	10
OG0007614	2	2	2	1	1	1	1	10
OG0007615	2	3	1	1	1	1	1	10
OG0007616	2	3	1	1	1	1	1	10
OG0007617	2	3	1	1	1	1	1	10
OG0007618	2	3	1	1	1	1	1	10
OG0007619	2	3	1	1	1	1	1	10
OG0007620	2	3	1	1	1	1	1	10
OG0007621	2	3	1	1	1	1	1	10
OG0007622	2	3	1	1	1	1	1	10
OG0007623	2	3	1	1	1	1	1	10
OG0007624	2	3	1	1	1	1	1	10
OG0007625	1	2	2	2	1	1	1	10
OG0007626	2	3	1	1	1	1	1	10
OG0007627	1	4	1	1	1	1	1	10
OG0007628	2	3	1	1	1	1	1	10
OG0007629	2	3	1	1	1	1	1	10
OG0007630	2	3	1	1	1	1	1	10
OG0007631	2	3	1	1	1	1	1	10
OG0007632	2	3	1	1	1	1	1	10
OG0007633	2	3	1	1	1	1	1	10
OG0007634	3	2	1	1	1	1	1	10
OG0007635	2	3	1	1	1	1	1	10
OG0007636	2	3	1	1	1	1	1	10
OG0007637	2	3	1	1	1	1	1	10
OG0007638	1	5	1	1	0	1	1	10
OG0007639	2	3	1	1	1	1	1	10
OG0007640	2	3	1	1	1	1	1	10
OG0007641	10	0	0	0	0	0	0	10
OG0007642	1	4	1	1	1	1	1	10
OG0007643	2	3	1	1	1	1	1	10
OG0007644	2	3	1	1	1	1	1	10
OG0007645	2	3	1	1	1	1	1	10
OG0007646	2	3	1	1	1	1	1	10
OG0007647	3	2	1	1	1	1	1	10
OG0007648	3	2	1	1	1	1	1	10
OG0007649	1	4	1	1	1	1	1	10
OG0007650	2	3	1	1	1	1	1	10
OG0007651	2	2	1	1	2	1	1	10
OG0007652	1	4	1	1	1	1	1	10
OG0007653	2	3	1	1	1	1	1	10
OG0007654	2	4	1	1	1	1	0	10
OG0007655	1	3	1	1	1	1	2	10
OG0007656	2	3	1	1	1	1	1	10
OG0007657	3	2	1	1	1	1	1	10
OG0007658	2	3	1	1	1	1	1	10
OG0007659	2	3	1	1	1	1	1	10
OG0007660	2	3	1	1	1	1	1	10
OG0007661	2	3	1	1	1	1	1	10
OG0007662	2	3	1	1	1	1	1	10
OG0007663	2	3	1	1	1	1	1	10
OG0007664	2	2	1	1	1	1	2	10
OG0007665	3	3	1	0	1	1	1	10
OG0007666	1	4	1	1	1	1	1	10
OG0007667	2	3	1	1	1	1	1	10
OG0007668	2	3	1	1	1	1	1	10
OG0007669	2	3	1	1	1	1	1	10
OG0007670	4	3	1	0	1	0	1	10
OG0007671	1	4	1	1	1	1	1	10
OG0007672	2	3	1	1	1	1	1	10
OG0007673	2	3	1	1	1	1	1	10
OG0007674	2	3	1	1	1	1	1	10
OG0007675	2	4	1	1	1	1	0	10
OG0007676	2	3	1	1	1	1	1	10
OG0007677	2	3	1	1	1	1	1	10
OG0007678	2	3	1	1	1	1	1	10
OG0007679	10	0	0	0	0	0	0	10
OG0007680	2	3	1	1	1	1	1	10
OG0007681	2	3	1	1	1	1	1	10
OG0007682	3	3	1	0	1	1	1	10
OG0007683	2	4	1	1	1	1	0	10
OG0007684	2	3	1	1	1	1	1	10
OG0007685	2	2	2	1	1	1	1	10
OG0007686	2	4	1	1	1	1	0	10
OG0007687	2	3	1	1	1	1	1	10
OG0007688	1	4	1	1	2	1	0	10
OG0007689	2	3	1	1	1	1	1	10
OG0007690	2	3	1	1	1	1	1	10
OG0007691	1	3	1	2	1	0	2	10
OG0007692	2	3	1	1	1	1	1	10
OG0007693	2	3	1	1	1	1	1	10
OG0007694	1	4	1	1	1	1	1	10
OG0007695	2	2	1	1	1	2	1	10
OG0007696	2	3	1	1	1	1	1	10
OG0007697	3	2	1	1	1	1	1	10
OG0007698	2	3	1	1	1	1	1	10
OG0007699	2	3	1	1	1	1	1	10
OG0007700	1	5	1	1	1	1	0	10
OG0007701	10	0	0	0	0	0	0	10
OG0007702	2	4	1	1	1	1	0	10
OG0007703	1	4	1	1	1	1	1	10
OG0007704	1	3	1	1	1	2	1	10
OG0007705	1	4	1	1	1	1	1	10
OG0007706	3	2	1	1	1	1	1	10
OG0007707	2	3	1	1	1	1	1	10
OG0007708	2	3	1	1	1	1	1	10
OG0007709	2	3	1	1	1	1	1	10
OG0007710	2	3	1	1	1	1	1	10
OG0007711	1	4	1	1	1	1	1	10
OG0007712	2	4	1	1	1	1	0	10
OG0007713	2	3	1	1	1	1	1	10
OG0007714	2	3	1	1	1	1	1	10
OG0007715	1	4	1	1	1	1	1	10
OG0007716	3	2	1	1	1	1	1	10
OG0007717	2	3	1	1	1	1	1	10
OG0007718	1	4	1	1	1	1	1	10
OG0007719	2	3	1	1	1	1	1	10
OG0007720	2	3	1	1	1	1	1	10
OG0007721	2	3	1	1	1	1	1	10
OG0007722	1	4	1	1	1	1	1	10
OG0007723	2	3	1	1	1	1	1	10
OG0007724	2	4	1	1	1	1	0	10
OG0007725	2	3	1	1	1	1	1	10
OG0007726	1	4	1	1	1	1	1	10
OG0007727	2	3	1	1	1	1	1	10
OG0007728	1	3	1	1	1	2	1	10
OG0007729	2	3	1	1	1	1	1	10
OG0007730	2	3	1	1	1	1	1	10
OG0007731	10	0	0	0	0	0	0	10
OG0007732	2	3	1	1	1	1	1	10
OG0007733	2	3	1	1	1	1	1	10
OG0007734	2	3	1	1	1	1	1	10
OG0007735	1	4	1	1	1	1	1	10
OG0007736	2	3	1	1	1	1	1	10
OG0007737	2	3	1	1	1	1	1	10
OG0007738	2	3	1	1	1	1	1	10
OG0007739	2	3	1	1	1	1	1	10
OG0007740	1	4	1	1	1	1	1	10
OG0007741	2	3	1	1	1	1	1	10
OG0007742	1	3	2	1	1	1	1	10
OG0007743	2	3	1	1	1	1	1	10
OG0007744	2	3	1	1	1	1	1	10
OG0007745	2	3	1	1	1	1	1	10
OG0007746	2	3	1	1	1	1	1	10
OG0007747	2	3	1	1	1	1	1	10
OG0007748	2	3	1	1	1	1	1	10
OG0007749	2	3	1	1	1	1	1	10
OG0007750	2	3	1	1	1	1	1	10
OG0007751	2	3	1	1	1	1	1	10
OG0007752	2	3	1	1	1	1	1	10
OG0007753	3	2	1	1	1	1	1	10
OG0007754	2	3	1	1	1	1	1	10
OG0007755	3	2	1	1	1	1	1	10
OG0007756	2	3	1	1	1	1	1	10
OG0007757	1	4	1	1	1	1	1	10
OG0007758	1	5	1	1	1	0	1	10
OG0007759	2	3	1	1	1	1	1	10
OG0007760	2	3	1	1	1	1	1	10
OG0007761	1	4	1	1	1	1	1	10
OG0007762	2	3	1	1	1	1	1	10
OG0007763	2	3	1	1	1	1	1	10
OG0007764	2	4	1	1	1	0	1	10
OG0007765	2	1	3	1	1	1	1	10
OG0007766	2	3	1	1	1	1	1	10
OG0007767	2	3	1	1	1	1	1	10
OG0007768	2	3	1	1	1	1	1	10
OG0007769	2	3	1	1	1	1	1	10
OG0007770	2	3	1	1	1	1	1	10
OG0007771	2	3	1	1	1	1	1	10
OG0007772	3	3	1	1	1	0	1	10
OG0007773	10	0	0	0	0	0	0	10
OG0007774	3	2	1	1	1	1	1	10
OG0007775	2	3	1	1	1	1	1	10
OG0007776	1	4	1	1	1	1	1	10
OG0007777	2	3	1	1	1	1	1	10
OG0007778	2	4	1	1	0	1	1	10
OG0007779	3	3	1	1	1	0	1	10
OG0007780	2	3	1	1	1	1	1	10
OG0007781	2	3	1	1	1	1	1	10
OG0007782	1	3	1	1	1	2	1	10
OG0007783	2	3	1	1	1	1	1	10
OG0007784	2	4	1	1	1	1	0	10
OG0007785	2	3	1	1	1	1	1	10
OG0007786	2	1	1	1	1	1	3	10
OG0007787	1	4	1	1	1	1	1	10
OG0007788	2	3	1	1	1	1	1	10
OG0007789	2	3	1	1	1	1	1	10
OG0007790	2	3	1	1	1	1	1	10
OG0007791	2	2	1	1	1	1	2	10
OG0007792	1	4	1	1	1	1	1	10
OG0007793	2	3	1	1	1	1	1	10
OG0007794	2	3	1	1	1	1	1	10
OG0007795	2	3	1	1	1	1	1	10
OG0007796	2	3	1	1	1	1	1	10
OG0007797	2	3	1	1	1	1	1	10
OG0007798	2	3	1	1	1	1	1	10
OG0007799	2	3	1	1	1	1	1	10
OG0007800	2	3	1	1	1	1	1	10
OG0007801	2	2	1	1	1	2	1	10
OG0007802	2	4	1	1	1	1	0	10
OG0007803	3	2	1	1	1	1	1	10
OG0007804	1	4	1	1	1	1	1	10
OG0007805	1	4	1	1	1	1	1	10
OG0007806	2	4	1	1	1	1	0	10
OG0007807	2	3	1	1	1	0	2	10
OG0007808	2	3	1	1	1	1	1	10
OG0007809	2	3	1	1	1	1	1	10
OG0007810	3	2	1	1	1	1	1	10
OG0007811	2	4	1	1	1	0	1	10
OG0007812	2	3	1	1	1	1	1	10
OG0007813	1	4	1	1	1	1	1	10
OG0007814	3	2	1	1	1	1	1	10
OG0007815	2	2	2	1	1	1	1	10
OG0007816	1	4	1	1	1	1	1	10
OG0007817	2	3	1	1	1	1	1	10
OG0007818	2	3	1	1	1	1	1	10
OG0007819	2	4	1	1	1	1	0	10
OG0007820	1	4	1	1	1	1	1	10
OG0007821	2	3	1	1	1	1	1	10
OG0007822	10	0	0	0	0	0	0	10
OG0007823	2	3	1	1	1	1	1	10
OG0007824	1	4	1	1	1	1	1	10
OG0007825	2	3	1	1	1	1	1	10
OG0007826	2	3	1	1	1	1	1	10
OG0007827	2	3	1	1	1	1	1	10
OG0007828	2	2	1	1	1	1	2	10
OG0007829	2	3	1	1	1	1	1	10
OG0007830	2	2	1	1	1	1	2	10
OG0007831	2	3	1	1	1	1	1	10
OG0007832	2	3	1	1	1	1	1	10
OG0007833	1	4	1	1	1	1	1	10
OG0007834	2	3	1	1	1	1	1	10
OG0007835	2	3	1	1	1	1	1	10
OG0007836	2	3	1	1	1	1	1	10
OG0007837	2	4	1	1	1	0	1	10
OG0007838	1	4	1	1	1	1	1	10
OG0007839	3	2	1	1	1	1	1	10
OG0007840	2	3	1	1	1	1	1	10
OG0007841	2	3	1	1	1	1	1	10
OG0007842	3	2	1	1	1	1	1	10
OG0007843	2	3	1	1	1	1	1	10
OG0007844	1	4	1	1	1	1	1	10
OG0007845	2	3	1	1	1	1	1	10
OG0007846	10	0	0	0	0	0	0	10
OG0007847	3	2	1	1	1	1	1	10
OG0007848	3	3	0	1	1	1	1	10
OG0007849	3	3	1	1	1	1	0	10
OG0007850	2	3	1	1	1	1	1	10
OG0007851	2	2	1	1	1	2	1	10
OG0007852	2	3	1	1	1	1	1	10
OG0007853	2	3	1	1	1	1	1	10
OG0007854	1	3	2	1	1	1	1	10
OG0007855	2	3	1	1	1	1	1	10
OG0007856	3	3	1	1	1	0	1	10
OG0007857	2	3	1	1	1	1	1	10
OG0007858	2	3	1	1	1	1	1	10
OG0007859	1	3	1	1	1	1	2	10
OG0007860	2	2	1	1	2	1	1	10
OG0007861	2	2	2	1	1	1	1	10
OG0007862	2	3	1	1	1	1	1	10
OG0007863	1	4	1	1	1	1	1	10
OG0007864	2	3	1	1	1	1	1	10
OG0007865	2	4	1	0	1	1	1	10
OG0007866	2	3	1	1	1	1	1	10
OG0007867	2	3	1	1	1	1	1	10
OG0007868	2	3	1	1	1	1	1	10
OG0007869	1	4	1	1	1	1	1	10
OG0007870	1	3	1	1	1	2	1	10
OG0007871	2	3	1	1	1	1	1	10
OG0007872	2	3	1	1	1	1	1	10
OG0007873	2	3	1	1	1	1	1	10
OG0007874	1	2	1	1	1	2	2	10
OG0007875	2	3	1	1	1	1	1	10
OG0007876	3	2	1	1	1	1	1	10
OG0007877	2	3	1	1	1	1	1	10
OG0007878	2	3	1	1	1	1	1	10
OG0007879	1	4	1	1	1	1	1	10
OG0007880	2	4	1	1	1	1	0	10
OG0007881	1	3	2	1	1	1	1	10
OG0007882	2	3	1	1	1	1	1	10
OG0007883	2	3	1	1	1	1	1	10
OG0007884	1	3	1	1	1	1	2	10
OG0007885	1	4	1	1	1	1	1	10
OG0007886	2	3	1	1	1	1	1	10
OG0007887	2	3	1	1	1	1	1	10
OG0007888	2	3	1	1	1	1	1	10
OG0007889	3	2	1	1	1	1	1	10
OG0007890	1	4	1	1	1	1	1	10
OG0007891	3	3	1	1	1	1	0	10
OG0007892	2	4	2	1	0	1	0	10
OG0007893	1	4	1	1	1	1	1	10
OG0007894	2	3	1	1	1	1	1	10
OG0007895	2	3	1	1	1	1	1	10
OG0007896	2	3	1	1	1	1	1	10
OG0007897	1	4	1	1	1	1	1	10
OG0007898	2	3	1	1	1	1	1	10
OG0007899	2	2	2	1	1	1	1	10
OG0007900	1	4	1	1	1	1	1	10
OG0007901	2	3	1	1	1	1	1	10
OG0007902	2	3	1	1	1	1	1	10
OG0007903	2	3	1	1	1	1	1	10
OG0007904	2	3	1	1	1	1	1	10
OG0007905	2	3	1	1	1	1	1	10
OG0007906	2	3	1	1	1	1	1	10
OG0007907	3	2	1	1	1	1	1	10
OG0007908	1	5	1	1	0	1	1	10
OG0007909	1	3	1	1	1	1	2	10
OG0007910	3	2	1	1	1	1	1	10
OG0007911	1	4	1	1	1	1	1	10
OG0007912	2	3	1	1	1	1	1	10
OG0007913	2	3	1	1	1	1	1	10
OG0007914	2	3	1	1	1	1	1	10
OG0007915	2	3	1	1	1	1	1	10
OG0007916	3	3	1	1	1	1	0	10
OG0007917	2	3	1	1	1	1	1	10
OG0007918	2	3	1	1	1	1	1	10
OG0007919	2	3	1	1	1	1	1	10
OG0007920	2	3	1	1	1	1	1	10
OG0007921	2	4	1	0	1	1	1	10
OG0007922	1	2	1	2	2	1	1	10
OG0007923	1	3	2	1	1	1	1	10
OG0007924	3	2	1	1	1	1	1	10
OG0007925	2	3	1	1	1	1	1	10
OG0007926	2	3	1	1	1	1	1	10
OG0007927	2	3	2	1	0	0	2	10
OG0007928	2	3	1	1	1	1	1	10
OG0007929	2	3	1	1	1	1	1	10
OG0007930	2	2	1	2	1	1	1	10
OG0007931	1	4	1	1	1	1	1	10
OG0007932	2	3	1	1	1	1	1	10
OG0007933	2	2	1	1	1	2	1	10
OG0007934	3	2	1	1	1	1	1	10
OG0007935	2	3	1	1	1	1	1	10
OG0007936	2	3	1	1	1	1	1	10
OG0007937	1	3	1	1	1	2	1	10
OG0007938	2	3	1	1	1	1	1	10
OG0007939	2	3	1	1	1	1	1	10
OG0007940	2	3	1	1	1	1	1	10
OG0007941	2	3	1	1	1	1	1	10
OG0007942	2	4	1	1	1	0	1	10
OG0007943	2	3	1	1	1	1	1	10
OG0007944	2	3	1	1	1	1	1	10
OG0007945	2	4	1	1	1	1	0	10
OG0007946	1	4	1	1	1	1	1	10
OG0007947	2	3	1	1	1	1	1	10
OG0007948	2	3	1	1	1	1	1	10
OG0007949	1	4	1	1	1	1	1	10
OG0007950	2	2	1	0	1	1	3	10
OG0007951	1	4	1	1	1	1	1	10
OG0007952	2	3	1	1	1	1	1	10
OG0007953	1	4	1	1	1	1	1	10
OG0007954	2	3	1	1	1	2	0	10
OG0007955	2	3	1	1	1	1	1	10
OG0007956	2	3	1	1	1	1	1	10
OG0007957	2	4	1	1	1	1	0	10
OG0007958	2	2	1	1	1	1	2	10
OG0007959	2	3	1	1	1	1	1	10
OG0007960	2	4	1	1	1	1	0	10
OG0007961	2	3	1	1	1	1	1	10
OG0007962	2	3	1	1	1	1	1	10
OG0007963	2	3	1	1	1	1	1	10
OG0007964	2	3	1	1	1	1	1	10
OG0007965	2	3	1	1	1	1	1	10
OG0007966	2	3	1	1	1	1	1	10
OG0007967	1	3	1	1	1	1	2	10
OG0007968	2	2	2	1	1	1	1	10
OG0007969	2	3	1	1	1	1	1	10
OG0007970	2	3	1	1	1	1	1	10
OG0007971	1	4	1	1	1	1	1	10
OG0007972	3	2	1	1	1	1	1	10
OG0007973	1	4	1	1	1	1	1	10
OG0007974	2	3	1	1	1	1	1	10
OG0007975	1	3	2	1	1	1	1	10
OG0007976	1	4	1	1	1	1	1	10
OG0007977	2	3	1	1	1	1	1	10
OG0007978	3	2	1	1	1	1	1	10
OG0007979	2	3	1	1	1	1	1	10
OG0007980	2	2	1	1	1	2	1	10
OG0007981	2	3	1	1	1	1	1	10
OG0007982	2	3	1	1	1	1	1	10
OG0007983	3	2	1	1	1	1	1	10
OG0007984	2	3	1	1	1	1	1	10
OG0007985	2	3	1	1	1	1	1	10
OG0007986	2	3	1	1	1	1	1	10
OG0007987	1	4	1	1	1	1	1	10
OG0007988	2	3	1	1	1	1	1	10
OG0007989	2	3	1	1	1	1	1	10
OG0007990	2	3	1	1	1	1	1	10
OG0007991	2	3	1	1	1	1	1	10
OG0007992	2	3	1	1	1	1	1	10
OG0007993	1	4	1	1	1	1	1	10
OG0007994	2	3	1	1	1	1	1	10
OG0007995	2	3	1	1	1	1	1	10
OG0007996	2	3	1	1	1	1	1	10
OG0007997	2	3	1	1	1	1	1	10
OG0007998	2	3	1	1	1	1	1	10
OG0007999	2	2	1	1	1	1	2	10
OG0008000	2	3	1	1	1	1	1	10
OG0008001	2	2	1	1	1	1	2	10
OG0008002	2	3	1	1	1	1	1	10
OG0008003	2	3	1	1	1	1	1	10
OG0008004	2	4	1	1	0	1	1	10
OG0008005	2	3	1	1	1	1	1	10
OG0008006	3	3	1	1	1	0	1	10
OG0008007	2	3	1	1	1	1	1	10
OG0008008	1	4	1	1	1	1	1	10
OG0008009	1	4	1	1	1	1	1	10
OG0008010	1	3	1	1	1	1	2	10
OG0008011	2	3	1	1	1	1	1	10
OG0008012	1	3	1	1	1	1	2	10
OG0008013	2	3	1	1	1	1	1	10
OG0008014	2	3	1	1	1	1	1	10
OG0008015	2	3	1	1	1	1	1	10
OG0008016	1	4	1	1	1	1	1	10
OG0008017	1	4	1	1	1	1	1	10
OG0008018	2	3	1	1	1	1	1	10
OG0008019	2	3	1	1	1	1	1	10
OG0008020	2	3	1	1	1	1	1	10
OG0008021	2	3	1	1	1	1	1	10
OG0008022	1	4	1	1	1	1	1	10
OG0008023	2	2	2	1	1	1	1	10
OG0008024	2	2	1	1	2	1	1	10
OG0008025	2	3	1	1	1	1	1	10
OG0008026	3	4	1	1	0	0	1	10
OG0008027	2	3	1	1	1	1	1	10
OG0008028	1	4	1	1	1	1	1	10
OG0008029	2	3	1	1	1	1	1	10
OG0008030	1	4	1	1	1	1	1	10
OG0008031	2	3	1	1	1	1	1	10
OG0008032	2	3	1	1	1	1	1	10
OG0008033	2	3	1	1	1	1	1	10
OG0008034	2	3	1	1	1	1	1	10
OG0008035	2	3	1	1	1	1	1	10
OG0008036	2	3	1	1	1	1	1	10
OG0008037	2	3	2	1	1	0	1	10
OG0008038	6	0	0	2	0	2	0	10
OG0008039	1	4	1	1	1	1	1	10
OG0008040	2	2	1	1	1	2	1	10
OG0008041	2	3	1	1	1	1	1	10
OG0008042	2	3	1	1	1	1	1	10
OG0008043	1	4	1	1	1	1	1	10
OG0008044	2	3	1	1	1	1	1	10
OG0008045	2	4	1	1	1	1	0	10
OG0008046	2	3	1	1	1	1	1	10
OG0008047	2	3	1	1	1	1	1	10
OG0008048	1	4	1	1	1	1	1	10
OG0008049	1	4	1	1	1	1	1	10
OG0008050	2	1	1	1	1	2	2	10
OG0008051	1	4	1	2	1	0	1	10
OG0008052	1	4	1	1	1	1	1	10
OG0008053	2	3	1	1	1	1	1	10
OG0008054	2	3	1	1	1	1	1	10
OG0008055	1	4	1	1	1	1	1	10
OG0008056	1	4	1	1	1	1	1	10
OG0008057	2	3	1	1	1	1	1	10
OG0008058	2	3	1	1	1	1	1	10
OG0008059	2	3	1	1	1	1	1	10
OG0008060	2	3	1	1	1	1	1	10
OG0008061	3	3	1	1	0	1	1	10
OG0008062	2	3	1	1	1	0	2	10
OG0008063	1	3	2	1	1	1	1	10
OG0008064	2	3	1	1	1	1	1	10
OG0008065	2	4	1	1	1	0	1	10
OG0008066	2	3	1	1	1	1	1	10
OG0008067	2	3	1	1	1	1	1	10
OG0008068	1	4	1	1	1	1	1	10
OG0008069	1	3	1	1	2	1	1	10
OG0008070	2	3	1	1	1	1	1	10
OG0008071	2	3	1	1	1	1	1	10
OG0008072	2	3	1	1	1	1	1	10
OG0008073	2	3	1	1	1	0	2	10
OG0008074	2	3	1	1	1	1	1	10
OG0008075	2	3	1	1	1	1	1	10
OG0008076	2	3	1	1	1	1	1	10
OG0008077	9	1	0	0	0	0	0	10
OG0008078	1	3	1	1	2	1	1	10
OG0008079	2	3	1	1	1	1	1	10
OG0008080	1	4	1	1	1	1	1	10
OG0008081	3	2	2	1	0	1	1	10
OG0008082	2	3	1	1	1	1	1	10
OG0008083	2	3	1	1	1	1	1	10
OG0008084	1	4	1	1	1	1	1	10
OG0008085	1	4	1	1	1	1	1	10
OG0008086	2	3	1	1	1	1	1	10
OG0008087	2	1	1	1	1	2	2	10
OG0008088	2	3	1	1	1	1	1	10
OG0008089	2	3	1	1	1	1	1	10
OG0008090	1	4	1	1	1	1	1	10
OG0008091	2	3	1	1	1	1	1	10
OG0008092	2	3	1	1	1	1	1	10
OG0008093	2	3	1	1	1	1	1	10
OG0008094	2	3	1	1	1	1	1	10
OG0008095	2	2	2	1	1	1	1	10
OG0008096	1	4	1	1	1	1	1	10
OG0008097	2	3	1	1	1	1	1	10
OG0008098	2	3	1	1	1	1	1	10
OG0008099	2	4	1	1	1	1	0	10
OG0008100	2	4	1	1	1	1	0	10
OG0008101	2	3	1	1	1	1	1	10
OG0008102	3	3	1	1	0	1	1	10
OG0008103	2	3	1	1	1	1	1	10
OG0008104	2	2	1	1	1	1	2	10
OG0008105	2	3	2	1	0	1	1	10
OG0008106	1	3	1	1	1	1	2	10
OG0008107	2	4	1	1	1	1	0	10
OG0008108	1	2	1	1	1	1	3	10
OG0008109	2	2	1	1	1	2	1	10
OG0008110	1	4	1	1	1	1	1	10
OG0008111	1	4	1	1	1	1	1	10
OG0008112	1	4	1	1	1	1	1	10
OG0008113	1	4	1	1	1	1	1	10
OG0008114	4	1	1	1	1	1	1	10
OG0008115	2	3	1	1	1	1	1	10
OG0008116	2	3	1	1	1	1	1	10
OG0008117	1	3	2	1	1	1	1	10
OG0008118	2	3	1	1	1	1	1	10
OG0008119	2	3	1	1	1	1	1	10
OG0008120	2	3	1	1	1	1	1	10
OG0008121	3	3	1	1	0	1	1	10
OG0008122	1	3	1	1	2	1	1	10
OG0008123	3	2	1	1	1	1	1	10
OG0008124	2	2	1	1	1	1	2	10
OG0008125	5	2	1	1	1	0	0	10
OG0008126	2	3	1	1	1	1	1	10
OG0008127	2	3	1	1	1	1	1	10
OG0008128	2	3	1	1	1	1	1	10
OG0008129	2	3	1	1	1	1	1	10
OG0008130	2	3	1	1	1	1	1	10
OG0008131	2	3	1	1	1	1	1	10
OG0008132	2	3	1	1	1	1	1	10
OG0008133	3	2	1	1	1	1	1	10
OG0008134	2	3	1	1	1	1	1	10
OG0008135	2	3	1	1	1	1	1	10
OG0008136	5	3	1	0	0	0	1	10
OG0008137	2	3	1	1	1	1	1	10
OG0008138	2	3	1	1	1	1	1	10
OG0008139	3	2	1	1	1	1	1	10
OG0008140	2	3	1	1	1	1	1	10
OG0008141	2	3	1	1	1	1	1	10
OG0008142	2	2	1	1	1	1	2	10
OG0008143	3	2	1	1	1	1	1	10
OG0008144	2	3	1	1	1	1	1	10
OG0008145	1	4	1	1	1	1	1	10
OG0008146	2	3	1	1	1	1	1	10
OG0008147	2	3	1	1	1	1	1	10
OG0008148	2	3	1	1	1	1	1	10
OG0008149	2	3	1	1	1	1	1	10
OG0008150	2	3	1	1	1	1	1	10
OG0008151	2	3	1	1	1	1	1	10
OG0008152	2	2	1	1	2	1	1	10
OG0008153	1	4	2	1	1	1	0	10
OG0008154	2	4	1	1	1	0	1	10
OG0008155	2	3	1	1	1	1	1	10
OG0008156	2	3	1	1	1	1	1	10
OG0008157	2	3	1	1	1	1	1	10
OG0008158	2	4	1	1	1	1	0	10
OG0008159	2	2	1	1	2	1	1	10
OG0008160	1	4	1	1	1	1	1	10
OG0008161	2	2	2	1	1	1	1	10
OG0008162	2	3	1	1	1	1	1	10
OG0008163	2	3	1	1	1	1	1	10
OG0008164	3	2	1	1	1	1	1	10
OG0008165	2	3	1	1	1	1	1	10
OG0008166	3	2	1	1	1	1	1	10
OG0008167	1	3	1	1	1	1	2	10
OG0008168	2	3	1	1	1	1	1	10
OG0008169	2	3	1	1	1	1	1	10
OG0008170	3	2	1	1	1	1	1	10
OG0008171	2	3	1	1	1	1	1	10
OG0008172	2	3	1	1	1	1	1	10
OG0008173	3	1	1	2	1	0	2	10
OG0008174	2	3	1	1	1	1	1	10
OG0008175	2	3	1	1	1	1	1	10
OG0008176	1	1	1	2	1	1	3	10
OG0008177	2	3	1	1	1	1	1	10
OG0008178	1	4	1	1	1	1	1	10
OG0008179	3	2	1	1	1	1	1	10
OG0008180	1	4	1	1	1	1	1	10
OG0008181	3	3	1	1	1	0	1	10
OG0008182	1	4	1	1	1	1	1	10
OG0008183	2	4	1	0	1	1	1	10
OG0008184	2	3	1	1	1	1	1	10
OG0008185	2	2	2	1	1	1	1	10
OG0008186	2	3	1	1	1	1	1	10
OG0008187	2	3	1	1	1	1	1	10
OG0008188	2	2	1	1	2	1	1	10
OG0008189	2	3	1	1	1	1	1	10
OG0008190	1	4	1	1	1	1	1	10
OG0008191	2	3	1	1	1	1	1	10
OG0008192	3	2	1	1	1	1	1	10
OG0008193	2	3	1	1	1	1	1	10
OG0008194	2	2	1	2	0	2	1	10
OG0008195	2	3	1	1	1	1	1	10
OG0008196	2	3	1	1	1	1	1	10
OG0008197	2	2	1	1	3	0	1	10
OG0008198	2	3	1	1	1	1	1	10
OG0008199	1	4	1	1	1	1	1	10
OG0008200	2	3	1	1	1	1	1	10
OG0008201	2	3	1	1	1	1	1	10
OG0008202	2	3	1	1	1	1	1	10
OG0008203	2	3	1	1	1	1	1	10
OG0008204	2	4	1	1	1	0	1	10
OG0008205	1	4	1	1	1	1	1	10
OG0008206	2	3	1	1	1	1	1	10
OG0008207	2	3	1	1	1	1	1	10
OG0008208	2	3	1	1	1	1	1	10
OG0008209	1	4	1	1	1	1	1	10
OG0008210	2	4	1	1	1	1	0	10
OG0008211	2	2	2	1	1	1	1	10
OG0008212	2	3	1	1	1	1	1	10
OG0008213	2	3	1	1	1	1	1	10
OG0008214	2	3	1	1	1	1	1	10
OG0008215	2	2	1	1	1	1	2	10
OG0008216	2	3	1	1	1	1	1	10
OG0008217	3	2	2	1	1	0	1	10
OG0008218	2	3	1	1	1	1	1	10
OG0008219	2	3	1	1	1	1	1	10
OG0008220	2	3	1	1	1	1	1	10
OG0008221	2	3	1	1	1	1	1	10
OG0008222	2	3	1	1	1	1	1	10
OG0008223	2	4	1	1	1	0	1	10
OG0008224	2	3	1	1	1	1	1	10
OG0008225	3	3	1	0	1	1	1	10
OG0008226	2	3	1	1	1	1	1	10
OG0008227	2	2	1	1	1	1	2	10
OG0008228	1	4	1	1	1	1	1	10
OG0008229	1	4	1	1	1	1	1	10
OG0008230	2	3	1	1	1	1	1	10
OG0008231	2	3	1	1	1	1	1	10
OG0008232	2	3	1	1	1	1	1	10
OG0008233	2	3	1	1	1	1	1	10
OG0008234	2	3	1	1	1	1	1	10
OG0008235	3	3	1	1	1	1	0	10
OG0008236	2	3	1	1	1	1	1	10
OG0008237	2	3	1	1	1	1	1	10
OG0008238	2	3	1	1	1	1	1	10
OG0008239	2	3	1	1	1	1	1	10
OG0008240	2	4	1	1	1	0	1	10
OG0008241	1	4	1	1	1	1	1	10
OG0008242	2	3	1	1	1	1	1	10
OG0008243	3	2	1	1	1	1	1	10
OG0008244	2	3	1	1	1	1	1	10
OG0008245	2	3	1	1	1	1	1	10
OG0008246	2	3	1	1	1	1	1	10
OG0008247	2	3	1	1	1	1	1	10
OG0008248	2	3	1	1	1	1	1	10
OG0008249	2	3	1	1	1	1	1	10
OG0008250	2	3	1	1	1	1	1	10
OG0008251	3	2	1	1	1	1	1	10
OG0008252	2	4	1	1	1	1	0	10
OG0008253	2	3	1	1	1	1	1	10
OG0008254	1	3	1	1	1	1	2	10
OG0008255	2	3	1	1	1	1	1	10
OG0008256	1	4	1	1	1	1	1	10
OG0008257	2	3	1	1	1	1	1	10
OG0008258	1	4	1	1	1	1	1	10
OG0008259	2	3	1	1	1	1	1	10
OG0008260	2	3	1	1	1	1	1	10
OG0008261	1	1	1	2	1	0	4	10
OG0008262	2	3	1	1	1	1	1	10
OG0008263	2	3	1	1	1	1	1	10
OG0008264	1	4	1	1	1	1	1	10
OG0008265	2	3	1	1	1	1	1	10
OG0008266	2	4	1	1	1	1	0	10
OG0008267	2	4	1	1	1	0	1	10
OG0008268	2	3	1	1	1	1	1	10
OG0008269	2	3	1	1	1	1	1	10
OG0008270	2	3	1	1	1	1	1	10
OG0008271	3	1	1	1	1	2	1	10
OG0008272	3	2	1	1	1	1	1	10
OG0008273	1	3	2	1	1	1	1	10
OG0008274	2	2	2	1	1	1	1	10
OG0008275	2	3	1	1	1	1	1	10
OG0008276	2	3	1	1	1	1	1	10
OG0008277	1	4	1	1	1	1	1	10
OG0008278	2	3	1	1	1	1	1	10
OG0008279	2	3	1	1	1	1	1	10
OG0008280	7	2	0	0	0	0	1	10
OG0008281	1	4	1	1	1	1	1	10
OG0008282	2	3	1	1	1	1	1	10
OG0008283	2	3	1	1	1	1	1	10
OG0008284	2	3	1	1	1	1	1	10
OG0008285	2	3	1	1	1	1	1	10
OG0008286	2	3	1	1	1	1	1	10
OG0008287	2	4	1	1	1	1	0	10
OG0008288	1	4	1	1	1	1	1	10
OG0008289	1	3	1	1	1	1	2	10
OG0008290	3	3	1	1	1	0	1	10
OG0008291	2	2	1	1	1	1	2	10
OG0008292	1	4	1	1	1	1	1	10
OG0008293	2	3	1	1	1	1	1	10
OG0008294	2	3	1	1	1	1	1	10
OG0008295	1	4	1	1	1	1	1	10
OG0008296	1	2	1	1	1	2	2	10
OG0008297	2	1	2	1	1	2	1	10
OG0008298	3	2	1	1	1	1	1	10
OG0008299	1	4	1	1	1	1	1	10
OG0008300	2	3	1	1	1	1	1	10
OG0008301	4	2	1	1	0	1	1	10
OG0008302	1	4	1	1	1	1	1	10
OG0008303	2	3	1	1	1	1	1	10
OG0008304	2	4	1	1	1	1	0	10
OG0008305	3	2	1	1	1	1	1	10
OG0008306	2	3	1	1	1	1	1	10
OG0008307	2	3	1	1	1	1	1	10
OG0008308	2	3	1	1	1	1	1	10
OG0008309	2	3	1	1	1	1	1	10
OG0008310	2	4	1	1	0	1	1	10
OG0008311	2	3	1	1	1	1	1	10
OG0008312	2	3	1	1	1	1	1	10
OG0008313	1	4	1	1	1	1	1	10
OG0008314	2	4	1	1	0	1	1	10
OG0008315	2	3	1	1	1	1	1	10
OG0008316	2	3	1	1	1	1	1	10
OG0008317	2	4	1	1	0	1	1	10
OG0008318	3	2	1	1	1	1	1	10
OG0008319	2	3	1	1	1	1	1	10
OG0008320	1	4	1	1	1	1	1	10
OG0008321	1	4	1	1	1	1	1	10
OG0008322	2	2	1	1	2	1	1	10
OG0008323	2	4	1	1	1	0	1	10
OG0008324	2	4	1	1	0	1	1	10
OG0008325	2	3	1	1	1	1	1	10
OG0008326	2	3	1	1	1	1	1	10
OG0008327	2	3	1	1	1	1	1	10
OG0008328	2	4	1	1	1	0	1	10
OG0008329	2	2	3	0	0	2	1	10
OG0008330	2	3	1	1	1	1	1	10
OG0008331	2	3	1	1	1	1	1	10
OG0008332	5	2	1	1	0	0	1	10
OG0008333	1	2	2	1	2	1	1	10
OG0008334	2	3	1	1	1	1	1	10
OG0008335	2	3	1	1	1	1	1	10
OG0008336	2	2	3	1	1	1	0	10
OG0008337	2	3	1	1	1	1	1	10
OG0008338	2	3	1	1	1	1	1	10
OG0008339	2	3	1	1	1	1	1	10
OG0008340	2	2	1	2	1	1	1	10
OG0008341	3	2	1	1	1	1	1	10
OG0008342	2	3	1	1	1	1	1	10
OG0008343	2	3	1	1	1	1	1	10
OG0008344	5	1	1	1	0	1	1	10
OG0008345	3	2	1	1	1	1	1	10
OG0008346	1	4	1	1	1	1	1	10
OG0008347	1	4	1	1	1	1	1	10
OG0008348	2	3	1	1	1	0	2	10
OG0008349	2	3	1	1	1	1	1	10
OG0008350	2	3	1	1	1	1	1	10
OG0008351	2	3	1	1	0	2	1	10
OG0008352	2	3	1	1	1	1	1	10
OG0008353	1	3	1	1	1	2	1	10
OG0008354	2	3	1	1	1	1	1	10
OG0008355	1	4	1	1	1	1	1	10
OG0008356	3	2	1	1	1	1	1	10
OG0008357	3	2	1	1	1	1	1	10
OG0008358	1	4	1	1	1	1	1	10
OG0008359	2	3	1	1	1	1	1	10
OG0008360	2	3	1	1	1	1	1	10
OG0008361	2	3	1	1	1	1	1	10
OG0008362	2	3	1	1	1	1	1	10
OG0008363	2	3	1	1	1	1	1	10
OG0008364	2	4	1	1	1	0	1	10
OG0008365	3	2	1	1	1	1	1	10
OG0008366	1	4	1	1	1	1	1	10
OG0008367	2	3	1	1	1	1	1	10
OG0008368	2	3	1	1	0	2	1	10
OG0008369	1	4	1	1	1	1	1	10
OG0008370	2	2	2	1	1	1	1	10
OG0008371	2	3	1	1	1	1	1	10
OG0008372	2	3	1	1	1	1	1	10
OG0008373	2	2	1	1	1	1	2	10
OG0008374	2	3	1	1	1	1	1	10
OG0008375	2	3	1	1	1	1	1	10
OG0008376	2	3	1	1	1	1	1	10
OG0008377	1	5	1	1	1	1	0	10
OG0008378	1	4	1	1	1	1	1	10
OG0008379	2	3	1	1	1	1	1	10
OG0008380	2	3	1	1	1	1	1	10
OG0008381	2	3	1	1	1	1	1	10
OG0008382	2	4	1	1	1	0	1	10
OG0008383	1	4	1	1	1	1	1	10
OG0008384	1	4	1	1	1	1	1	10
OG0008385	1	3	1	1	1	1	2	10
OG0008386	2	3	1	1	1	1	1	10
OG0008387	2	3	1	1	1	1	1	10
OG0008388	1	4	1	1	1	1	1	10
OG0008389	2	3	1	1	1	1	1	10
OG0008390	1	3	2	0	0	2	2	10
OG0008391	1	4	1	1	1	1	1	10
OG0008392	3	2	1	1	1	1	1	10
OG0008393	1	4	1	1	1	1	1	10
OG0008394	3	3	1	0	1	1	1	10
OG0008395	2	3	1	1	1	1	1	10
OG0008396	2	3	1	1	1	1	1	10
OG0008397	1	3	1	1	1	2	1	10
OG0008398	2	3	1	1	1	1	1	10
OG0008399	2	3	1	1	1	1	1	10
OG0008400	2	3	1	1	1	1	1	10
OG0008401	2	3	1	1	1	1	1	10
OG0008402	2	3	1	1	1	1	1	10
OG0008403	2	2	1	1	1	2	1	10
OG0008404	1	4	1	1	1	1	1	10
OG0008405	2	3	1	1	1	1	1	10
OG0008406	1	3	1	2	1	1	1	10
OG0008407	2	3	1	1	1	1	1	10
OG0008408	1	4	1	1	1	1	1	10
OG0008409	2	3	1	1	1	1	1	10
OG0008410	2	3	1	1	0	1	2	10
OG0008411	2	3	1	1	1	1	1	10
OG0008412	1	4	1	1	1	1	1	10
OG0008413	2	3	1	1	1	1	1	10
OG0008414	2	3	1	1	1	1	1	10
OG0008415	2	3	1	1	1	1	1	10
OG0008416	3	2	1	1	1	1	1	10
OG0008417	1	4	1	1	1	1	1	10
OG0008418	2	4	1	1	1	1	0	10
OG0008419	1	4	1	1	1	1	1	10
OG0008420	1	4	1	1	1	1	1	10
OG0008421	2	3	1	1	1	1	1	10
OG0008422	1	4	1	1	1	1	1	10
OG0008423	2	3	1	1	1	1	1	10
OG0008424	2	3	1	1	1	1	1	10
OG0008425	2	3	1	1	1	1	1	10
OG0008426	2	3	1	1	1	1	1	10
OG0008427	2	3	2	1	0	1	1	10
OG0008428	2	2	1	1	1	1	2	10
OG0008429	2	3	1	1	1	0	2	10
OG0008430	2	3	1	1	1	1	1	10
OG0008431	2	3	1	1	1	1	1	10
OG0008432	2	3	1	1	1	1	1	10
OG0008433	2	3	1	1	1	1	1	10
OG0008434	2	3	1	1	1	1	1	10
OG0008435	2	3	1	1	1	1	1	10
OG0008436	2	3	1	1	1	1	1	10
OG0008437	2	3	1	1	1	1	1	10
OG0008438	2	3	1	1	1	1	1	10
OG0008439	3	2	1	1	1	1	1	10
OG0008440	2	3	1	1	1	1	1	10
OG0008441	2	3	1	1	1	1	1	10
OG0008442	2	3	1	1	1	1	1	10
OG0008443	2	3	1	1	1	1	1	10
OG0008444	1	4	1	1	1	1	1	10
OG0008445	2	3	1	0	2	1	1	10
OG0008446	2	3	1	1	1	1	1	10
OG0008447	1	4	1	1	1	1	1	10
OG0008448	2	3	1	1	1	1	1	10
OG0008449	2	3	1	1	1	1	1	10
OG0008450	1	2	1	1	1	2	2	10
OG0008451	2	2	0	1	1	1	3	10
OG0008452	1	4	1	1	1	1	1	10
OG0008453	1	4	1	1	1	1	1	10
OG0008454	2	3	1	1	1	1	1	10
OG0008455	2	3	1	1	1	1	1	10
OG0008456	2	3	1	1	1	1	1	10
OG0008457	2	3	1	1	1	1	1	10
OG0008458	1	4	1	1	1	1	1	10
OG0008459	1	4	1	1	1	1	1	10
OG0008460	2	3	1	1	1	1	1	10
OG0008461	2	4	1	1	1	0	1	10
OG0008462	2	3	1	1	1	1	1	10
OG0008463	2	3	1	0	1	0	3	10
OG0008464	2	3	1	1	1	1	1	10
OG0008465	3	2	1	1	1	1	1	10
OG0008466	1	4	1	1	1	1	1	10
OG0008467	1	3	2	1	1	1	1	10
OG0008468	2	4	1	1	1	0	1	10
OG0008469	3	2	1	1	1	1	1	10
OG0008470	2	3	1	1	1	1	1	10
OG0008471	2	3	1	1	1	1	1	10
OG0008472	3	2	1	1	1	1	1	10
OG0008473	2	3	1	1	1	1	1	10
OG0008474	2	3	1	1	1	1	1	10
OG0008475	4	1	1	1	1	1	1	10
OG0008476	1	5	1	1	0	1	1	10
OG0008477	2	3	1	1	1	1	1	10
OG0008478	2	3	1	1	1	1	1	10
OG0008479	2	3	1	1	1	1	1	10
OG0008480	2	4	1	1	0	1	1	10
OG0008481	2	3	1	1	1	1	1	10
OG0008482	2	3	1	1	1	1	1	10
OG0008483	1	4	1	1	1	1	1	10
OG0008484	2	3	1	1	1	1	1	10
OG0008485	2	2	1	1	2	1	1	10
OG0008486	1	4	1	1	1	1	1	10
OG0008487	2	3	1	1	1	1	1	10
OG0008488	2	3	1	1	1	1	1	10
OG0008489	2	3	1	1	1	1	1	10
OG0008490	2	2	1	1	1	2	1	10
OG0008491	2	3	1	1	1	1	1	10
OG0008492	2	3	1	1	1	1	1	10
OG0008493	3	2	1	1	1	0	2	10
OG0008494	2	3	1	1	1	1	1	10
OG0008495	2	3	1	1	1	1	1	10
OG0008496	2	3	1	1	1	1	1	10
OG0008497	2	3	1	1	1	1	1	10
OG0008498	2	3	1	1	1	1	1	10
OG0008499	2	3	1	1	1	1	1	10
OG0008500	2	3	1	1	1	1	1	10
OG0008501	2	3	1	1	1	1	1	10
OG0008502	2	3	1	1	1	1	1	10
OG0008503	1	3	2	1	1	1	1	10
OG0008504	2	3	1	1	1	1	1	10
OG0008505	2	3	1	1	1	1	1	10
OG0008506	2	3	1	1	1	1	1	10
OG0008507	1	4	1	1	1	1	1	10
OG0008508	2	3	1	1	1	1	1	10
OG0008509	1	4	1	1	1	1	1	10
OG0008510	2	3	1	1	1	1	1	10
OG0008511	2	3	1	1	1	1	1	10
OG0008512	2	4	1	1	1	1	0	10
OG0008513	2	3	1	1	1	1	1	10
OG0008514	2	2	2	1	1	1	1	10
OG0008515	3	2	1	1	1	1	1	10
OG0008516	2	3	1	1	1	1	1	10
OG0008517	2	3	1	1	1	1	1	10
OG0008518	2	4	1	1	1	0	1	10
OG0008519	2	3	1	1	1	1	1	10
OG0008520	2	3	1	1	1	1	1	10
OG0008521	1	4	1	0	0	1	3	10
OG0008522	2	3	1	1	1	1	1	10
OG0008523	2	3	1	1	1	1	1	10
OG0008524	2	3	1	1	1	1	1	10
OG0008525	2	3	1	1	1	1	1	10
OG0008526	1	4	1	1	1	1	1	10
OG0008527	2	3	1	1	1	1	1	10
OG0008528	2	3	1	1	1	1	1	10
OG0008529	2	2	1	2	1	1	1	10
OG0008530	2	3	1	1	1	1	1	10
OG0008531	1	4	1	1	1	1	1	10
OG0008532	2	3	1	1	1	1	1	10
OG0008533	2	3	1	1	1	1	1	10
OG0008534	2	4	1	1	1	1	0	10
OG0008535	2	4	1	1	1	0	1	10
OG0008536	2	4	1	1	1	0	1	10
OG0008537	2	3	1	1	1	1	1	10
OG0008538	2	3	1	1	1	1	1	10
OG0008539	2	3	2	1	1	0	1	10
OG0008540	2	3	1	1	1	1	1	10
OG0008541	2	4	1	0	1	1	1	10
OG0008542	2	3	1	1	1	1	1	10
OG0008543	2	3	1	1	1	1	1	10
OG0008544	2	3	1	1	1	1	1	10
OG0008545	2	3	1	1	1	1	1	10
OG0008546	2	3	1	1	1	1	1	10
OG0008547	2	3	1	1	1	1	1	10
OG0008548	2	4	1	1	1	1	0	10
OG0008549	1	5	1	1	1	1	0	10
OG0008550	1	4	1	1	1	1	1	10
OG0008551	2	2	2	1	1	1	1	10
OG0008552	3	2	1	1	1	1	1	10
OG0008553	2	3	1	1	1	0	2	10
OG0008554	2	3	1	1	1	1	1	10
OG0008555	2	3	1	1	1	1	1	10
OG0008556	2	3	1	1	1	1	1	10
OG0008557	1	4	1	1	1	1	1	10
OG0008558	2	3	1	1	1	1	1	10
OG0008559	2	3	1	1	1	1	1	10
OG0008560	3	3	1	1	1	0	1	10
OG0008561	2	3	1	1	1	1	1	10
OG0008562	2	3	1	1	1	1	1	10
OG0008563	2	3	1	1	1	1	1	10
OG0008564	2	2	1	1	2	1	1	10
OG0008565	2	4	1	1	1	0	1	10
OG0008566	2	4	1	1	1	0	1	10
OG0008567	2	3	1	1	1	1	1	10
OG0008568	2	3	1	1	1	1	1	10
OG0008569	1	4	1	0	1	1	2	10
OG0008570	2	3	1	1	1	1	1	10
OG0008571	2	3	1	1	1	1	1	10
OG0008572	1	4	1	1	1	1	1	10
OG0008573	1	4	1	1	1	1	1	10
OG0008574	2	3	1	1	1	1	1	10
OG0008575	1	4	1	1	1	1	1	10
OG0008576	2	3	1	1	1	1	1	10
OG0008577	2	3	1	1	1	1	1	10
OG0008578	2	3	1	1	1	1	1	10
OG0008579	2	5	1	0	1	0	1	10
OG0008580	2	4	1	1	0	1	1	10
OG0008581	2	3	1	1	1	1	1	10
OG0008582	4	1	1	1	1	1	1	10
OG0008583	2	3	1	1	1	1	1	10
OG0008584	2	4	0	1	1	1	1	10
OG0008585	3	2	1	1	1	1	1	10
OG0008586	1	4	1	1	1	1	1	10
OG0008587	2	3	1	1	1	1	1	10
OG0008588	1	3	1	1	1	1	2	10
OG0008589	2	3	1	1	1	1	1	10
OG0008590	2	3	1	1	1	1	1	10
OG0008591	1	4	1	1	1	1	1	10
OG0008592	2	4	1	1	1	1	0	10
OG0008593	1	4	1	1	1	1	1	10
OG0008594	2	3	1	1	1	1	1	10
OG0008595	1	4	1	1	1	1	1	10
OG0008596	2	3	1	1	1	1	1	10
OG0008597	2	3	1	1	1	1	1	10
OG0008598	2	4	1	1	1	0	1	10
OG0008599	2	3	1	1	1	1	1	10
OG0008600	1	4	1	1	1	1	1	10
OG0008601	1	4	1	1	1	1	1	10
OG0008602	2	3	1	1	1	1	1	10
OG0008603	2	3	1	1	1	1	1	10
OG0008604	2	3	1	1	1	1	1	10
OG0008605	2	2	1	1	1	2	1	10
OG0008606	2	3	1	1	1	1	1	10
OG0008607	2	4	1	1	1	1	0	10
OG0008608	2	3	1	1	1	1	1	10
OG0008609	2	3	1	1	1	1	1	10
OG0008610	1	4	1	1	1	1	1	10
OG0008611	2	3	1	1	1	1	1	10
OG0008612	2	3	1	1	1	1	1	10
OG0008613	3	3	1	1	1	0	1	10
OG0008614	3	3	1	1	1	0	1	10
OG0008615	2	4	1	1	1	0	1	10
OG0008616	3	2	1	1	1	1	1	10
OG0008617	2	3	1	1	1	1	1	10
OG0008618	2	3	1	1	1	1	1	10
OG0008619	2	3	1	1	1	1	1	10
OG0008620	2	3	1	1	1	1	1	10
OG0008621	2	2	1	1	1	1	2	10
OG0008622	1	4	1	1	1	1	1	10
OG0008623	2	4	1	1	1	1	0	10
OG0008624	2	3	1	1	1	1	1	10
OG0008625	2	3	1	1	1	1	1	10
OG0008626	2	3	1	1	1	1	1	10
OG0008627	2	4	1	1	0	1	1	10
OG0008628	2	4	1	1	1	0	1	10
OG0008629	2	3	1	1	1	1	1	10
OG0008630	1	4	1	1	1	1	1	10
OG0008631	2	2	2	1	1	1	1	10
OG0008632	1	3	2	1	1	1	1	10
OG0008633	1	3	2	1	1	1	1	10
OG0008634	2	3	1	1	1	1	1	10
OG0008635	2	3	1	1	1	1	1	10
OG0008636	1	4	1	1	1	1	1	10
OG0008637	2	4	1	1	1	0	1	10
OG0008638	2	3	1	1	1	1	1	10
OG0008639	3	3	1	1	1	0	1	10
OG0008640	2	3	1	1	1	1	1	10
OG0008641	1	3	2	1	1	1	1	10
OG0008642	2	3	1	1	1	1	1	10
OG0008643	1	4	1	2	1	0	1	10
OG0008644	3	3	1	1	1	0	1	10
OG0008645	2	3	1	1	1	1	1	10
OG0008646	2	3	1	1	1	1	1	10
OG0008647	2	3	1	1	1	1	1	10
OG0008648	2	3	1	1	1	1	1	10
OG0008649	2	3	1	1	1	1	1	10
OG0008650	1	3	1	2	1	0	2	10
OG0008651	1	3	1	1	1	1	2	10
OG0008652	2	3	1	1	1	1	1	10
OG0008653	2	3	1	1	1	1	1	10
OG0008654	2	3	1	1	1	1	1	10
OG0008655	1	4	1	1	1	1	1	10
OG0008656	3	4	1	0	0	1	1	10
OG0008657	2	2	1	1	1	2	1	10
OG0008658	2	2	1	1	1	1	2	10
OG0008659	2	3	1	1	1	1	1	10
OG0008660	2	3	1	1	1	1	1	10
OG0008661	2	3	1	1	1	1	1	10
OG0008662	1	2	2	1	1	1	2	10
OG0008663	2	3	1	1	1	1	1	10
OG0008664	2	4	1	1	1	0	1	10
OG0008665	2	3	1	1	1	1	1	10
OG0008666	2	3	1	1	1	1	1	10
OG0008667	2	3	1	1	1	1	1	10
OG0008668	2	2	1	1	1	1	2	10
OG0008669	2	4	1	0	1	1	1	10
OG0008670	2	4	1	1	0	1	1	10
OG0008671	2	3	1	1	1	1	1	10
OG0008672	2	3	1	1	1	1	1	10
OG0008673	2	3	1	1	1	1	1	10
OG0008674	1	4	1	1	1	1	1	10
OG0008675	1	4	1	1	1	1	1	10
OG0008676	2	3	1	1	1	1	1	10
OG0008677	2	3	1	1	1	1	1	10
OG0008678	2	3	1	1	1	1	1	10
OG0008679	1	5	1	1	1	0	1	10
OG0008680	2	3	1	1	1	1	1	10
OG0008681	2	3	1	1	1	1	1	10
OG0008682	2	3	1	1	1	1	1	10
OG0008683	2	3	1	1	1	1	1	10
OG0008684	1	2	2	1	1	1	2	10
OG0008685	2	3	1	1	1	1	1	10
OG0008686	2	5	0	1	1	1	0	10
OG0008687	3	2	1	1	1	1	1	10
OG0008688	2	3	1	1	1	1	1	10
OG0008689	2	3	1	1	1	1	1	10
OG0008690	2	3	1	1	1	1	1	10
OG0008691	1	3	1	1	1	1	2	10
OG0008692	2	3	1	1	1	1	1	10
OG0008693	2	3	1	1	1	1	1	10
OG0008694	2	3	1	1	1	1	1	10
OG0008695	2	3	1	1	1	1	1	10
OG0008696	3	3	1	1	0	1	1	10
OG0008697	2	3	1	1	1	1	1	10
OG0008698	1	4	1	1	1	1	1	10
OG0008699	1	3	2	1	1	1	1	10
OG0008700	2	3	1	1	1	1	1	10
OG0008701	2	3	1	1	1	1	1	10
OG0008702	2	3	1	1	1	1	1	10
OG0008703	2	3	1	1	1	1	1	10
OG0008704	2	3	1	1	1	1	1	10
OG0008705	2	1	1	1	1	2	2	10
OG0008706	2	3	1	1	1	1	1	10
OG0008707	2	3	1	1	1	1	1	10
OG0008708	1	4	1	1	1	1	1	10
OG0008709	2	4	1	0	1	1	1	10
OG0008710	2	3	1	1	1	1	1	10
OG0008711	3	2	1	1	1	1	1	10
OG0008712	1	4	1	1	1	1	1	10
OG0008713	2	3	1	1	1	1	1	10
OG0008714	2	3	1	1	1	1	1	10
OG0008715	2	3	1	1	1	1	1	10
OG0008716	2	4	1	1	1	0	1	10
OG0008717	1	4	1	0	1	1	2	10
OG0008718	2	3	1	1	1	1	1	10
OG0008719	2	2	1	1	1	1	2	10
OG0008720	2	3	1	1	1	1	1	10
OG0008721	2	2	2	1	1	1	1	10
OG0008722	2	3	1	1	1	1	1	10
OG0008723	1	4	1	1	1	1	1	10
OG0008724	1	4	2	0	1	1	1	10
OG0008725	2	4	1	1	1	0	1	10
OG0008726	2	3	1	1	1	1	1	10
OG0008727	2	3	1	1	1	1	1	10
OG0008728	2	3	1	1	1	1	1	10
OG0008729	1	3	1	1	1	2	1	10
OG0008730	1	4	1	1	1	1	1	10
OG0008731	2	3	1	1	1	1	1	10
OG0008732	2	3	1	1	1	1	1	10
OG0008733	2	3	1	1	1	1	1	10
OG0008734	2	3	1	1	1	1	1	10
OG0008735	1	4	1	1	1	1	1	10
OG0008736	1	1	2	2	1	0	3	10
OG0008737	1	4	1	1	1	1	1	10
OG0008738	2	3	1	1	1	1	1	10
OG0008739	2	3	1	1	1	1	1	10
OG0008740	1	4	1	1	1	1	1	10
OG0008741	2	3	1	1	1	1	1	10
OG0008742	2	3	1	1	1	1	1	10
OG0008743	2	2	1	1	2	1	1	10
OG0008744	2	3	1	1	1	1	1	10
OG0008745	2	3	1	1	1	1	1	10
OG0008746	1	5	0	1	2	0	1	10
OG0008747	2	3	1	1	1	1	1	10
OG0008748	1	4	1	1	1	1	1	10
OG0008749	2	3	1	1	1	1	1	10
OG0008750	1	4	1	1	1	1	1	10
OG0008751	2	3	1	1	1	1	1	10
OG0008752	2	3	1	1	1	1	1	10
OG0008753	2	3	1	1	1	1	1	10
OG0008754	3	1	1	2	1	1	1	10
OG0008755	1	4	1	1	1	1	1	10
OG0008756	1	4	1	1	1	1	1	10
OG0008757	2	2	2	1	1	1	1	10
OG0008758	1	4	1	1	1	1	1	10
OG0008759	2	4	1	1	0	1	1	10
OG0008760	1	3	1	1	1	1	2	10
OG0008761	1	4	1	1	1	1	1	10
OG0008762	2	4	1	1	1	0	1	10
OG0008763	2	3	1	1	1	1	1	10
OG0008764	2	3	1	1	1	1	1	10
OG0008765	2	3	1	1	1	1	1	10
OG0008766	2	3	1	1	1	1	1	10
OG0008767	2	2	1	1	1	1	2	10
OG0008768	2	3	1	1	1	1	1	10
OG0008769	2	3	1	1	1	1	1	10
OG0008770	2	3	1	1	1	1	1	10
OG0008771	2	3	1	1	1	1	1	10
OG0008772	5	0	1	1	1	1	1	10
OG0008773	3	3	1	0	1	1	1	10
OG0008774	2	3	1	1	1	1	1	10
OG0008775	2	3	1	0	2	1	1	10
OG0008776	2	4	1	1	1	1	0	10
OG0008777	2	3	1	1	1	1	1	10
OG0008778	2	3	1	1	1	1	1	10
OG0008779	2	3	1	1	1	1	1	10
OG0008780	2	4	1	1	1	0	1	10
OG0008781	2	3	1	1	1	1	1	10
OG0008782	2	1	2	2	1	1	1	10
OG0008783	3	2	1	1	1	1	1	10
OG0008784	2	3	1	1	1	1	1	10
OG0008785	2	3	1	1	1	1	1	10
OG0008786	2	3	1	1	1	1	1	10
OG0008787	2	4	1	1	1	0	1	10
OG0008788	2	3	1	1	1	1	1	10
OG0008789	1	3	1	1	0	2	2	10
OG0008790	1	4	1	1	1	1	1	10
OG0008791	2	2	1	2	1	1	1	10
OG0008792	2	3	1	1	1	1	1	10
OG0008793	2	3	1	1	1	1	1	10
OG0008794	1	4	1	1	1	1	1	10
OG0008795	2	3	1	1	1	1	1	10
OG0008796	1	4	1	1	1	1	1	10
OG0008797	2	3	1	1	1	1	1	10
OG0008798	2	3	1	1	1	1	1	10
OG0008799	2	3	1	1	1	1	1	10
OG0008800	2	3	1	1	1	1	1	10
OG0008801	2	3	1	1	1	1	1	10
OG0008802	2	3	1	1	1	1	1	10
OG0008803	1	4	1	1	1	1	1	10
OG0008804	2	5	1	0	0	1	1	10
OG0008805	2	4	1	0	1	1	1	10
OG0008806	1	4	1	1	1	1	1	10
OG0008807	2	3	1	1	1	1	1	10
OG0008808	2	2	1	1	1	1	2	10
OG0008809	1	3	1	1	1	2	1	10
OG0008810	2	3	1	1	1	1	1	10
OG0008811	2	3	1	1	1	1	1	10
OG0008812	2	3	1	1	1	1	1	10
OG0008813	2	3	1	1	1	1	1	10
OG0008814	1	7	0	0	0	2	0	10
OG0008815	2	3	1	1	1	1	1	10
OG0008816	2	3	1	1	1	1	1	10
OG0008817	2	4	1	1	0	1	1	10
OG0008818	3	2	1	1	1	1	1	10
OG0008819	2	3	1	1	1	1	1	10
OG0008820	2	3	1	1	1	1	1	10
OG0008821	1	4	1	1	1	1	1	10
OG0008822	1	4	1	1	1	1	1	10
OG0008823	3	2	1	1	1	1	1	10
OG0008824	2	3	1	1	1	1	1	10
OG0008825	2	3	1	1	1	1	1	10
OG0008826	1	4	1	1	1	1	1	10
OG0008827	2	3	1	1	1	1	1	10
OG0008828	2	3	1	1	1	1	1	10
OG0008829	2	3	1	1	1	1	1	10
OG0008830	1	5	1	1	1	1	0	10
OG0008831	1	4	1	1	1	1	1	10
OG0008832	2	3	2	1	1	1	0	10
OG0008833	2	3	1	1	1	1	1	10
OG0008834	2	3	1	1	1	1	1	10
OG0008835	2	4	1	1	1	0	1	10
OG0008836	2	3	1	1	1	1	1	10
OG0008837	2	3	1	1	1	1	1	10
OG0008838	3	2	1	1	1	1	1	10
OG0008839	2	3	1	1	1	1	1	10
OG0008840	1	8	1	0	0	0	0	10
OG0008841	2	3	1	1	1	1	1	10
OG0008842	2	3	1	1	1	1	1	10
OG0008843	2	3	1	1	1	1	1	10
OG0008844	2	3	1	1	1	1	1	10
OG0008845	2	3	1	1	1	1	1	10
OG0008846	2	3	1	1	1	1	1	10
OG0008847	2	3	1	1	1	1	1	10
OG0008848	2	3	1	1	1	1	1	10
OG0008849	2	3	1	1	1	1	1	10
OG0008850	2	3	1	1	1	1	1	10
OG0008851	2	3	1	1	1	1	1	10
OG0008852	2	3	1	1	1	1	1	10
OG0008853	2	4	1	1	1	1	0	10
OG0008854	2	3	1	1	0	2	1	10
OG0008855	1	4	1	1	1	1	1	10
OG0008856	2	1	1	1	1	2	2	10
OG0008857	2	3	1	1	1	1	1	10
OG0008858	1	3	1	2	0	2	1	10
OG0008859	2	3	1	1	1	1	1	10
OG0008860	1	4	1	1	1	1	1	10
OG0008861	3	2	1	1	1	1	1	10
OG0008862	2	3	1	1	1	1	1	10
OG0008863	1	3	1	1	2	1	1	10
OG0008864	1	4	1	1	1	1	1	10
OG0008865	2	2	1	1	2	1	1	10
OG0008866	2	3	1	1	1	1	1	10
OG0008867	3	3	1	1	1	1	0	10
OG0008868	2	3	1	1	1	1	1	10
OG0008869	2	3	1	1	1	1	1	10
OG0008870	2	5	1	1	1	0	0	10
OG0008871	2	3	1	1	1	1	1	10
OG0008872	3	3	1	1	0	1	1	10
OG0008873	2	3	1	1	1	1	1	10
OG0008874	2	3	1	1	1	1	1	10
OG0008875	2	3	1	1	1	1	1	10
OG0008876	4	1	1	1	1	1	1	10
OG0008877	1	4	1	1	1	1	1	10
OG0008878	2	3	1	1	1	1	1	10
OG0008879	2	3	1	1	1	1	1	10
OG0008880	2	3	1	1	1	1	1	10
OG0008881	2	3	1	1	1	1	1	10
OG0008882	3	2	1	1	1	1	1	10
OG0008883	2	3	1	1	1	1	1	10
OG0008884	2	3	1	1	1	1	1	10
OG0008885	2	3	1	1	1	1	1	10
OG0008886	2	3	1	1	1	1	1	10
OG0008887	2	3	1	1	1	1	1	10
OG0008888	2	1	3	1	1	1	1	10
OG0008889	2	3	1	1	1	1	1	10
OG0008890	2	3	1	1	1	1	1	10
OG0008891	2	3	1	1	1	1	1	10
OG0008892	1	5	1	1	0	1	1	10
OG0008893	2	3	1	1	1	1	1	10
OG0008894	1	3	1	1	1	1	2	10
OG0008895	1	5	1	0	1	1	1	10
OG0008896	2	3	1	1	1	1	1	10
OG0008897	2	3	1	1	1	1	1	10
OG0008898	2	2	1	1	1	1	2	10
OG0008899	1	4	1	1	1	1	1	10
OG0008900	1	4	1	1	1	1	1	10
OG0008901	2	3	1	1	1	1	1	10
OG0008902	1	4	1	1	1	1	1	10
OG0008903	3	2	1	1	1	1	1	10
OG0008904	2	3	1	1	1	1	1	10
OG0008905	2	3	1	1	1	1	1	10
OG0008906	2	3	1	1	1	1	1	10
OG0008907	1	4	1	1	1	1	1	10
OG0008908	2	3	1	1	1	1	1	10
OG0008909	2	3	1	1	1	1	1	10
OG0008910	2	3	1	1	1	1	1	10
OG0008911	2	3	1	1	1	1	1	10
OG0008912	1	4	1	1	1	1	1	10
OG0008913	2	4	1	0	1	1	1	10
OG0008914	1	4	1	1	1	1	1	10
OG0008915	2	3	1	1	1	1	1	10
OG0008916	1	4	1	1	1	1	1	10
OG0008917	2	3	1	1	1	1	1	10
OG0008918	1	4	1	1	1	1	1	10
OG0008919	2	3	1	1	1	1	1	10
OG0008920	1	4	1	1	1	1	1	10
OG0008921	1	4	1	1	1	1	1	10
OG0008922	2	3	1	1	1	1	1	10
OG0008923	4	1	1	1	1	1	1	10
OG0008924	2	3	1	1	1	1	1	10
OG0008925	2	3	1	1	1	1	1	10
OG0008926	2	3	1	1	1	1	1	10
OG0008927	1	4	1	1	1	1	1	10
OG0008928	2	3	1	1	1	1	1	10
OG0008929	2	3	1	1	1	1	1	10
OG0008930	2	3	1	1	1	1	1	10
OG0008931	1	4	1	1	1	1	1	10
OG0008932	2	3	1	1	1	1	1	10
OG0008933	1	3	1	1	1	2	1	10
OG0008934	2	3	1	1	1	1	1	10
OG0008935	2	3	1	1	1	1	1	10
OG0008936	2	3	1	1	1	1	1	10
OG0008937	3	5	1	0	0	0	1	10
OG0008938	1	4	1	1	1	1	1	10
OG0008939	2	3	1	1	1	1	1	10
OG0008940	2	3	1	1	1	1	1	10
OG0008941	2	3	1	1	1	1	1	10
OG0008942	3	2	1	1	1	1	1	10
OG0008943	2	4	1	1	1	1	0	10
OG0008944	2	3	1	1	1	1	1	10
OG0008945	2	3	1	1	1	1	1	10
OG0008946	2	3	1	1	1	1	1	10
OG0008947	2	3	1	1	1	1	1	10
OG0008948	2	3	1	1	1	1	1	10
OG0008949	2	3	1	1	1	1	1	10
OG0008950	2	4	1	1	1	1	0	10
OG0008951	2	3	1	1	1	1	1	10
OG0008952	1	4	1	1	1	1	1	10
OG0008953	1	3	0	1	1	1	3	10
OG0008954	2	3	1	1	1	1	1	10
OG0008955	4	1	1	1	1	1	1	10
OG0008956	2	3	1	1	1	1	1	10
OG0008957	3	4	1	0	1	0	1	10
OG0008958	2	3	1	1	1	1	1	10
OG0008959	2	3	1	1	1	1	1	10
OG0008960	2	3	1	1	1	1	1	10
OG0008961	2	3	1	1	1	1	1	10
OG0008962	2	3	1	1	1	1	1	10
OG0008963	2	3	1	1	1	1	1	10
OG0008964	2	3	1	1	1	1	1	10
OG0008965	1	4	1	1	1	1	1	10
OG0008966	2	3	1	1	1	1	1	10
OG0008967	2	3	1	1	1	1	1	10
OG0008968	1	4	1	1	1	1	1	10
OG0008969	2	3	1	1	1	1	1	10
OG0008970	1	4	1	1	1	1	1	10
OG0008971	2	3	1	1	1	1	1	10
OG0008972	1	5	1	1	1	1	0	10
OG0008973	2	3	1	1	1	1	1	10
OG0008974	2	4	1	1	1	0	1	10
OG0008975	2	4	1	1	0	1	1	10
OG0008976	3	3	1	1	1	1	0	10
OG0008977	3	2	1	1	1	1	1	10
OG0008978	3	2	1	1	1	1	1	10
OG0008979	2	2	2	1	1	1	1	10
OG0008980	2	3	1	1	1	1	1	10
OG0008981	3	2	1	1	1	1	1	10
OG0008982	2	3	1	1	1	1	1	10
OG0008983	2	3	1	1	1	1	1	10
OG0008984	2	3	1	1	1	1	1	10
OG0008985	1	4	1	1	1	1	1	10
OG0008986	3	2	1	1	1	1	1	10
OG0008987	2	3	1	1	1	1	1	10
OG0008988	2	3	1	1	1	1	1	10
OG0008989	2	3	1	1	1	1	1	10
OG0008990	2	3	1	1	1	1	1	10
OG0008991	1	5	1	1	1	1	0	10
OG0008992	2	3	1	1	1	1	1	10
OG0008993	2	3	1	1	1	1	1	10
OG0008994	1	3	1	2	1	1	1	10
OG0008995	2	2	1	1	1	1	2	10
OG0008996	1	4	1	1	1	1	1	10
OG0008997	2	3	1	1	1	1	1	10
OG0008998	3	3	1	1	1	1	0	10
OG0008999	2	3	1	1	1	1	1	10
OG0009000	2	3	1	1	1	1	1	10
OG0009001	1	4	1	1	1	1	1	10
OG0009002	2	2	1	1	1	1	2	10
OG0009003	1	4	1	1	1	1	1	10
OG0009004	2	3	1	1	1	1	1	10
OG0009005	2	3	1	1	1	1	1	10
OG0009006	1	4	1	1	1	1	1	10
OG0009007	2	3	2	1	1	0	1	10
OG0009008	2	3	1	1	1	1	1	10
OG0009009	2	3	1	1	1	1	1	10
OG0009010	2	3	1	1	1	1	1	10
OG0009011	2	3	2	1	1	1	0	10
OG0009012	2	3	1	1	1	1	1	10
OG0009013	2	3	1	1	1	1	1	10
OG0009014	2	3	1	1	1	1	1	10
OG0009015	2	3	1	1	1	1	1	10
OG0009016	2	3	1	1	1	1	1	10
OG0009017	1	4	1	1	1	1	1	10
OG0009018	2	3	1	1	1	1	1	10
OG0009019	2	3	1	1	1	1	1	10
OG0009020	2	3	1	1	1	1	1	10
OG0009021	1	4	1	1	1	1	1	10
OG0009022	2	4	1	1	0	1	1	10
OG0009023	2	3	1	1	1	1	1	10
OG0009024	2	3	1	1	1	0	2	10
OG0009025	1	4	1	1	1	1	1	10
OG0009026	2	3	1	1	1	1	1	10
OG0009027	2	3	1	1	1	1	1	10
OG0009028	2	4	1	1	0	1	1	10
OG0009029	2	3	1	1	1	1	1	10
OG0009030	1	4	1	1	1	1	1	10
OG0009031	2	4	1	1	1	0	1	10
OG0009032	1	4	1	1	1	1	1	10
OG0009033	1	3	1	2	1	1	1	10
OG0009034	1	4	1	1	1	1	1	10
OG0009035	2	4	1	1	0	1	1	10
OG0009036	2	4	1	1	0	1	1	10
OG0009037	2	3	1	1	1	1	1	10
OG0009038	2	1	1	1	1	2	2	10
OG0009039	2	3	1	1	1	1	1	10
OG0009040	1	4	1	1	1	1	1	10
OG0009041	1	4	1	1	1	1	1	10
OG0009042	2	3	1	1	1	1	1	10
OG0009043	1	3	1	1	1	1	2	10
OG0009044	2	3	1	1	1	1	1	10
OG0009045	2	3	1	1	1	1	1	10
OG0009046	2	3	1	1	1	1	1	10
OG0009047	2	3	1	1	1	1	1	10
OG0009048	2	4	1	1	1	1	0	10
OG0009049	1	4	1	1	1	1	1	10
OG0009050	2	3	1	1	1	1	1	10
OG0009051	1	3	2	1	1	1	1	10
OG0009052	2	3	1	1	1	1	1	10
OG0009053	2	3	1	1	1	1	1	10
OG0009054	2	3	1	1	1	1	1	10
OG0009055	1	4	1	1	1	1	1	10
OG0009056	1	4	1	1	1	1	1	10
OG0009057	2	3	1	1	1	1	1	10
OG0009058	1	3	1	1	1	1	2	10
OG0009059	2	3	1	1	1	1	1	10
OG0009060	2	2	1	1	2	1	1	10
OG0009061	2	3	1	1	1	1	1	10
OG0009062	2	3	1	1	1	1	1	10
OG0009063	2	3	1	1	1	1	1	10
OG0009064	2	3	1	1	1	1	1	10
OG0009065	2	3	1	1	1	1	1	10
OG0009066	3	3	1	1	1	1	0	10
OG0009067	2	3	1	1	1	1	1	10
OG0009068	2	3	1	1	1	1	1	10
OG0009069	1	4	1	1	1	1	1	10
OG0009070	1	4	1	1	1	1	1	10
OG0009071	2	4	1	1	1	0	1	10
OG0009072	1	4	1	1	1	1	1	10
OG0009073	1	4	1	1	1	1	1	10
OG0009074	2	3	1	1	1	1	1	10
OG0009075	2	3	1	1	1	1	1	10
OG0009076	1	4	1	1	1	1	1	10
OG0009077	1	3	1	1	1	2	1	10
OG0009078	3	3	1	1	1	1	0	10
OG0009079	2	3	1	1	1	1	1	10
OG0009080	2	3	1	1	1	1	1	10
OG0009081	2	4	1	0	1	1	1	10
OG0009082	2	2	1	1	1	1	2	10
OG0009083	2	3	1	1	1	1	1	10
OG0009084	2	2	1	1	1	1	2	10
OG0009085	2	3	1	1	1	1	1	10
OG0009086	2	3	1	1	1	1	1	10
OG0009087	2	3	1	1	1	1	1	10
OG0009088	2	4	1	0	1	1	1	10
OG0009089	1	4	1	1	1	1	1	10
OG0009090	1	3	2	0	2	1	1	10
OG0009091	1	4	1	1	1	1	1	10
OG0009092	1	5	1	1	0	1	1	10
OG0009093	1	4	1	1	1	1	1	10
OG0009094	2	3	1	1	1	1	1	10
OG0009095	2	2	1	1	1	1	2	10
OG0009096	1	4	1	1	1	1	1	10
OG0009097	2	3	1	1	1	1	1	10
OG0009098	1	4	1	1	1	1	1	10
OG0009099	2	3	1	1	1	1	1	10
OG0009100	2	3	1	1	1	1	1	10
OG0009101	5	1	2	0	1	0	1	10
OG0009102	2	3	1	1	1	1	1	10
OG0009103	1	4	1	1	1	1	1	10
OG0009104	2	3	1	1	1	1	1	10
OG0009105	2	3	1	1	1	1	1	10
OG0009106	3	1	1	1	1	2	1	10
OG0009107	2	3	1	1	1	1	1	10
OG0009108	2	3	1	1	1	1	1	10
OG0009109	2	3	1	1	1	1	1	10
OG0009110	2	2	2	2	0	0	2	10
OG0009111	2	3	1	1	1	1	1	10
OG0009112	1	4	1	1	1	1	1	10
OG0009113	2	3	1	1	1	1	1	10
OG0009114	2	3	1	1	1	1	1	10
OG0009115	2	3	1	1	1	1	1	10
OG0009116	2	2	1	2	1	0	2	10
OG0009117	2	3	1	1	1	1	1	10
OG0009118	2	4	1	1	1	1	0	10
OG0009119	1	4	2	0	1	1	1	10
OG0009120	3	2	1	1	1	1	1	10
OG0009121	2	5	0	1	0	1	1	10
OG0009122	2	3	1	1	1	1	1	10
OG0009123	2	3	1	1	1	1	1	10
OG0009124	2	3	1	1	1	1	1	10
OG0009125	1	1	1	1	2	3	1	10
OG0009126	2	3	1	1	1	1	1	10
OG0009127	1	4	1	1	1	1	1	10
OG0009128	10	0	0	0	0	0	0	10
OG0009129	1	4	1	1	1	1	1	10
OG0009130	1	3	1	1	1	2	1	10
OG0009131	2	3	1	1	1	1	1	10
OG0009132	2	3	1	1	1	1	1	10
OG0009133	2	3	1	1	1	1	1	10
OG0009134	2	3	1	1	1	1	1	10
OG0009135	2	3	1	1	1	1	1	10
OG0009136	2	3	1	1	1	1	1	10
OG0009137	2	3	1	1	1	1	1	10
OG0009138	2	2	1	1	1	1	2	10
OG0009139	1	4	1	1	1	1	1	10
OG0009140	2	2	1	1	1	1	2	10
OG0009141	1	4	1	1	1	1	1	10
OG0009142	1	4	1	1	1	1	1	10
OG0009143	2	3	1	1	1	1	1	10
OG0009144	2	3	1	1	1	1	1	10
OG0009145	3	3	1	1	0	1	1	10
OG0009146	2	3	1	1	1	1	1	10
OG0009147	2	3	1	2	0	0	2	10
OG0009148	4	2	1	1	1	1	0	10
OG0009149	2	4	1	1	0	1	1	10
OG0009150	1	4	1	1	1	1	1	10
OG0009151	2	3	1	1	1	1	1	10
OG0009152	2	3	1	1	1	1	1	10
OG0009153	2	3	1	1	1	1	1	10
OG0009154	2	3	1	1	1	1	1	10
OG0009155	1	4	1	1	1	1	1	10
OG0009156	2	3	1	1	1	1	1	10
OG0009157	2	2	1	1	1	2	1	10
OG0009158	2	3	1	1	1	0	2	10
OG0009159	1	4	1	1	1	1	1	10
OG0009160	2	3	1	1	1	1	1	10
OG0009161	3	2	1	1	1	1	1	10
OG0009162	2	3	1	1	1	1	1	10
OG0009163	2	5	1	1	0	0	1	10
OG0009164	1	4	1	1	1	1	1	10
OG0009165	1	4	1	1	1	1	1	10
OG0009166	2	3	1	1	1	1	1	10
OG0009167	1	4	1	1	1	1	1	10
OG0009168	2	3	1	1	1	1	1	10
OG0009169	2	3	1	1	1	1	1	10
OG0009170	1	4	1	1	1	1	1	10
OG0009171	2	3	1	1	1	1	1	10
OG0009172	2	3	1	1	1	1	1	10
OG0009173	2	3	1	1	1	1	1	10
OG0009174	2	2	1	2	1	1	1	10
OG0009175	1	1	2	1	2	1	2	10
OG0009176	2	3	1	1	1	1	1	10
OG0009177	2	2	1	1	2	1	1	10
OG0009178	3	2	1	1	1	1	1	10
OG0009179	2	3	1	1	1	1	1	10
OG0009180	2	2	1	1	1	1	2	10
OG0009181	3	3	1	1	1	1	0	10
OG0009182	2	3	1	1	1	1	1	10
OG0009183	2	3	1	1	1	1	1	10
OG0009184	1	4	1	1	0	1	2	10
OG0009185	3	1	1	2	1	1	1	10
OG0009186	2	3	1	1	1	1	1	10
OG0009187	1	4	1	1	1	1	1	10
OG0009188	1	4	1	1	1	1	1	10
OG0009189	2	3	1	1	1	1	1	10
OG0009190	2	3	1	1	1	0	2	10
OG0009191	2	3	1	1	1	1	1	10
OG0009192	2	3	1	1	1	1	1	10
OG0009193	2	3	1	0	2	1	1	10
OG0009194	1	4	1	1	1	1	1	10
OG0009195	2	3	1	1	1	1	1	10
OG0009196	2	3	1	1	1	1	1	10
OG0009197	2	3	1	1	1	1	1	10
OG0009198	1	5	1	1	1	1	0	10
OG0009199	2	3	1	1	1	1	1	10
OG0009200	2	3	1	1	1	1	1	10
OG0009201	2	3	1	1	1	1	1	10
OG0009202	2	2	2	1	1	1	1	10
OG0009203	1	4	1	1	1	1	1	10
OG0009204	2	3	1	1	1	1	1	10
OG0009205	1	4	1	1	1	1	1	10
OG0009206	1	5	1	1	0	1	1	10
OG0009207	2	3	1	1	1	1	1	10
OG0009208	2	3	1	1	1	1	1	10
OG0009209	2	3	1	1	1	1	1	10
OG0009210	2	3	1	1	1	1	1	10
OG0009211	2	3	1	1	1	1	1	10
OG0009212	1	3	1	1	2	1	1	10
OG0009213	1	4	1	1	1	1	1	10
OG0009214	1	5	1	1	1	0	1	10
OG0009215	2	3	1	1	1	1	1	10
OG0009216	2	4	1	0	1	1	1	10
OG0009217	2	3	1	1	1	1	1	10
OG0009218	1	4	1	1	1	1	1	10
OG0009219	2	3	1	1	1	1	1	10
OG0009220	1	5	1	1	0	1	1	10
OG0009221	1	3	1	1	1	2	1	10
OG0009222	2	3	1	1	1	1	1	10
OG0009223	1	4	1	1	1	1	1	10
OG0009224	2	3	1	1	1	1	1	10
OG0009225	2	3	1	1	1	1	1	10
OG0009226	2	3	1	1	1	1	1	10
OG0009227	1	4	1	1	1	1	1	10
OG0009228	1	4	1	1	1	1	1	10
OG0009229	1	4	1	1	1	1	1	10
OG0009230	2	3	1	1	1	1	1	10
OG0009231	2	3	1	1	1	1	1	10
OG0009232	2	3	1	1	1	1	1	10
OG0009233	2	3	1	1	1	1	1	10
OG0009234	3	3	1	1	1	1	0	10
OG0009235	1	4	1	1	1	1	1	10
OG0009236	1	4	1	1	1	1	1	10
OG0009237	2	3	1	1	1	1	1	10
OG0009238	2	3	1	1	1	1	1	10
OG0009239	2	3	1	1	1	1	1	10
OG0009240	1	3	1	3	1	0	1	10
OG0009241	3	2	1	1	1	1	1	10
OG0009242	1	4	1	1	1	1	1	10
OG0009243	2	2	2	1	1	1	1	10
OG0009244	1	1	1	1	1	2	3	10
OG0009245	1	5	1	1	1	0	1	10
OG0009246	2	4	1	1	1	0	1	10
OG0009247	2	3	1	1	1	1	1	10
OG0009248	2	3	1	1	1	1	1	10
OG0009249	1	3	1	1	1	1	2	10
OG0009250	1	5	1	0	1	1	1	10
OG0009251	3	3	1	1	0	1	1	10
OG0009252	2	3	1	1	1	1	1	10
OG0009253	2	3	1	1	1	1	1	10
OG0009254	1	3	2	1	1	1	1	10
OG0009255	1	4	1	1	1	1	1	10
OG0009256	2	3	1	1	1	1	1	10
OG0009257	1	3	1	1	1	1	2	10
OG0009258	2	3	1	1	1	1	1	10
OG0009259	2	3	1	1	1	1	1	10
OG0009260	1	4	1	1	1	1	1	10
OG0009261	2	3	1	1	1	1	1	10
OG0009262	1	2	2	1	1	2	1	10
OG0009263	2	3	1	1	1	1	1	10
OG0009264	1	4	1	1	1	1	1	10
OG0009265	2	3	1	1	1	1	1	10
OG0009266	2	3	1	1	1	1	1	10
OG0009267	2	3	1	1	1	1	1	10
OG0009268	2	3	1	1	1	1	1	10
OG0009269	2	3	1	1	1	1	1	10
OG0009270	2	3	1	1	1	1	1	10
OG0009271	2	4	1	1	1	1	0	10
OG0009272	2	3	1	1	1	1	1	10
OG0009273	2	3	1	1	1	1	1	10
OG0009274	1	3	1	1	1	1	2	10
OG0009275	2	3	1	1	1	1	1	10
OG0009276	2	3	1	1	1	1	1	10
OG0009277	2	3	1	1	1	1	1	10
OG0009278	2	4	1	1	0	1	1	10
OG0009279	2	3	1	1	1	1	1	10
OG0009280	2	3	1	1	1	1	1	10
OG0009281	2	3	1	1	1	1	1	10
OG0009282	2	3	1	1	1	1	1	10
OG0009283	1	4	1	1	1	1	1	10
OG0009284	3	2	1	1	1	1	1	10
OG0009285	1	5	1	0	1	1	1	10
OG0009286	2	3	1	1	1	1	1	10
OG0009287	1	4	1	1	1	1	1	10
OG0009288	2	3	2	1	2	0	0	10
OG0009289	1	4	1	1	1	1	1	10
OG0009290	1	3	2	1	1	1	1	10
OG0009291	4	4	0	0	1	0	1	10
OG0009292	1	4	1	1	1	1	1	10
OG0009293	2	3	1	1	1	1	1	10
OG0009294	2	3	1	1	1	1	1	10
OG0009295	2	3	1	1	1	1	1	10
OG0009296	2	3	1	1	1	1	1	10
OG0009297	2	3	1	1	1	1	1	10
OG0009298	2	3	1	1	1	1	1	10
OG0009299	2	3	1	1	1	1	1	10
OG0009300	1	4	1	1	1	1	1	10
OG0009301	2	3	1	1	1	1	1	10
OG0009302	1	3	1	0	2	2	1	10
OG0009303	2	3	1	1	1	1	1	10
OG0009304	1	3	1	1	1	1	2	10
OG0009305	2	3	1	1	1	1	1	10
OG0009306	1	4	1	1	1	1	1	10
OG0009307	1	4	1	1	1	1	1	10
OG0009308	2	3	1	1	1	1	1	10
OG0009309	2	3	1	1	1	1	1	10
OG0009310	2	3	1	1	1	1	1	10
OG0009311	2	3	1	1	1	1	1	10
OG0009312	1	4	1	1	1	1	1	10
OG0009313	2	2	1	2	1	1	1	10
OG0009314	1	4	1	1	1	1	1	10
OG0009315	1	4	1	1	1	1	1	10
OG0009316	1	4	1	1	1	1	1	10
OG0009317	2	3	1	1	1	1	1	10
OG0009318	2	3	1	1	1	1	1	10
OG0009319	2	3	1	1	1	1	1	10
OG0009320	2	3	1	1	1	1	1	10
OG0009321	2	3	1	1	1	1	1	10
OG0009322	2	2	1	1	2	1	1	10
OG0009323	2	3	1	1	1	1	1	10
OG0009324	2	3	1	1	1	1	1	10
OG0009325	1	4	1	1	1	1	1	10
OG0009326	2	3	1	1	1	1	1	10
OG0009327	2	3	1	1	1	1	1	10
OG0009328	2	3	1	1	1	1	1	10
OG0009329	2	3	1	1	1	1	1	10
OG0009330	1	4	1	1	1	1	1	10
OG0009331	2	3	1	1	1	1	1	10
OG0009332	2	3	1	1	1	1	1	10
OG0009333	2	4	1	1	1	0	1	10
OG0009334	2	3	1	1	1	1	1	10
OG0009335	2	4	1	1	1	0	1	10
OG0009336	1	4	1	1	1	1	1	10
OG0009337	2	2	1	1	1	1	2	10
OG0009338	2	3	1	1	1	1	1	10
OG0009339	2	3	1	1	1	1	1	10
OG0009340	1	4	1	1	1	1	1	10
OG0009341	2	3	1	1	1	1	1	10
OG0009342	2	3	1	1	1	1	1	10
OG0009343	2	3	1	1	1	1	1	10
OG0009344	1	3	1	1	1	2	1	10
OG0009345	1	4	1	1	1	1	1	10
OG0009346	1	4	1	1	1	1	1	10
OG0009347	1	3	1	1	1	2	1	10
OG0009348	1	5	1	1	1	0	1	10
OG0009349	3	3	1	0	1	1	1	10
OG0009350	2	3	1	1	1	1	1	10
OG0009351	2	3	1	1	1	1	1	10
OG0009352	2	5	1	1	0	0	1	10
OG0009353	1	3	1	1	2	1	1	10
OG0009354	2	4	1	1	1	1	0	10
OG0009355	1	4	1	1	1	1	1	10
OG0009356	2	3	1	1	1	1	1	10
OG0009357	1	4	1	1	1	1	1	10
OG0009358	2	3	1	1	1	1	1	10
OG0009359	3	2	1	1	1	1	1	10
OG0009360	2	3	1	1	1	1	1	10
OG0009361	2	3	1	1	1	1	1	10
OG0009362	2	3	1	1	1	1	1	10
OG0009363	2	3	1	1	1	1	1	10
OG0009364	2	3	1	1	1	0	2	10
OG0009365	1	5	1	1	0	1	1	10
OG0009366	1	4	1	1	1	1	1	10
OG0009367	1	3	2	1	1	1	1	10
OG0009368	1	4	1	1	1	1	1	10
OG0009369	1	4	1	1	1	1	1	10
OG0009370	2	3	1	1	1	1	1	10
OG0009371	2	2	1	1	2	1	1	10
OG0009372	1	4	1	1	1	0	2	10
OG0009373	2	3	1	1	1	1	1	10
OG0009374	2	2	2	1	1	1	1	10
OG0009375	1	3	1	1	0	1	3	10
OG0009376	2	3	1	1	1	1	1	10
OG0009377	1	4	2	1	1	1	0	10
OG0009378	2	3	1	1	1	1	1	10
OG0009379	1	4	1	1	1	1	1	10
OG0009380	2	3	1	1	1	0	2	10
OG0009381	1	4	1	1	0	1	2	10
OG0009382	2	3	1	1	1	1	1	10
OG0009383	1	4	1	1	1	1	1	10
OG0009384	2	3	1	1	1	1	1	10
OG0009385	1	4	1	1	1	1	1	10
OG0009386	1	2	1	1	1	2	2	10
OG0009387	2	3	1	1	1	1	1	10
OG0009388	2	3	1	1	1	1	1	10
OG0009389	1	3	1	1	1	1	2	10
OG0009390	2	3	1	1	1	1	1	10
OG0009391	2	3	1	1	1	1	1	10
OG0009392	1	4	1	1	1	1	1	10
OG0009393	1	4	1	1	1	1	1	10
OG0009394	2	2	1	2	1	1	1	10
OG0009395	1	3	1	1	1	2	1	10
OG0009396	2	3	1	1	1	1	1	10
OG0009397	2	3	1	1	1	1	1	10
OG0009398	2	3	1	1	1	1	1	10
OG0009399	2	4	1	1	1	0	1	10
OG0009400	1	4	1	1	1	1	1	10
OG0009401	2	3	1	1	1	0	2	10
OG0009402	1	4	1	1	1	1	1	10
OG0009403	2	3	1	1	1	1	1	10
OG0009404	2	3	1	1	1	1	1	10
OG0009405	2	3	1	1	1	1	1	10
OG0009406	2	3	1	1	1	1	1	10
OG0009407	2	3	1	1	0	1	2	10
OG0009408	3	2	1	1	1	1	1	10
OG0009409	2	4	1	1	1	1	0	10
OG0009410	2	3	1	1	1	1	1	10
OG0009411	2	3	1	1	1	1	1	10
OG0009412	2	3	1	1	1	1	1	10
OG0009413	2	3	1	1	1	1	1	10
OG0009414	2	3	1	1	1	1	1	10
OG0009415	2	3	1	1	1	1	1	10
OG0009416	1	4	1	1	1	1	1	10
OG0009417	1	4	1	1	1	1	1	10
OG0009418	2	2	0	1	1	0	4	10
OG0009419	2	2	1	1	1	1	2	10
OG0009420	1	4	1	1	1	1	1	10
OG0009421	1	4	1	1	2	0	1	10
OG0009422	1	3	1	1	1	1	2	10
OG0009423	1	4	1	1	1	1	1	10
OG0009424	1	4	1	1	0	2	1	10
OG0009425	2	3	1	1	1	1	1	10
OG0009426	2	4	1	1	0	1	1	10
OG0009427	2	3	1	1	1	1	1	10
OG0009428	1	4	1	1	1	1	1	10
OG0009429	1	4	1	1	1	0	2	10
OG0009430	2	3	1	1	1	1	1	10
OG0009431	1	4	1	1	1	1	1	10
OG0009432	1	3	1	1	2	1	1	10
OG0009433	2	2	1	1	2	1	1	10
OG0009434	1	4	1	1	1	1	1	10
OG0009435	1	4	1	1	1	1	1	10
OG0009436	1	4	1	1	1	1	1	10
OG0009437	1	4	1	1	1	1	1	10
OG0009438	1	4	1	1	1	1	1	10
OG0009439	2	3	1	1	1	1	1	10
OG0009440	2	3	1	1	1	1	1	10
OG0009441	1	3	1	1	1	1	2	10
OG0009442	2	3	1	1	1	1	1	10
OG0009443	2	3	1	1	1	1	1	10
OG0009444	2	4	1	1	1	1	0	10
OG0009445	2	3	1	1	1	1	1	10
OG0009446	2	3	1	1	1	1	1	10
OG0009447	2	3	1	1	1	1	1	10
OG0009448	1	4	1	1	1	1	1	10
OG0009449	2	4	1	1	1	1	0	10
OG0009450	2	3	1	1	1	1	1	10
OG0009451	2	3	1	1	1	1	1	10
OG0009452	1	4	1	1	1	1	1	10
OG0009453	2	2	1	1	1	1	2	10
OG0009454	2	3	1	1	1	1	1	10
OG0009455	3	3	3	1	0	0	0	10
OG0009456	1	4	1	1	1	1	1	10
OG0009457	1	4	2	0	2	1	0	10
OG0009458	2	3	1	1	1	1	1	10
OG0009459	2	4	1	1	1	1	0	10
OG0009460	1	4	1	1	1	1	1	10
OG0009461	2	3	1	1	1	1	1	10
OG0009462	1	4	1	1	1	1	1	10
OG0009463	1	4	1	1	1	1	1	10
OG0009464	2	3	1	1	1	1	1	10
OG0009465	2	3	1	1	1	1	1	10
OG0009466	2	4	1	0	1	1	1	10
OG0009467	1	4	1	1	1	1	1	10
OG0009468	1	4	1	1	1	1	1	10
OG0009469	1	4	1	1	1	1	1	10
OG0009470	2	3	1	1	1	1	1	10
OG0009471	2	4	1	1	1	0	1	10
OG0009472	2	3	1	1	1	1	1	10
OG0009473	2	3	1	1	1	1	1	10
OG0009474	2	3	1	1	1	1	1	10
OG0009475	1	4	1	1	1	1	1	10
OG0009476	2	3	1	1	1	1	1	10
OG0009477	2	3	1	1	1	1	1	10
OG0009478	1	4	1	1	1	1	1	10
OG0009479	3	2	1	1	1	1	1	10
OG0009480	1	4	1	1	1	0	2	10
OG0009481	2	3	1	1	1	1	1	10
OG0009482	2	3	1	1	1	1	1	10
OG0009483	2	3	1	1	1	1	1	10
OG0009484	1	2	2	1	2	1	1	10
OG0009485	2	3	1	1	1	1	1	10
OG0009486	1	3	2	1	1	1	1	10
OG0009487	1	4	1	1	1	1	1	10
OG0009488	2	3	1	1	1	1	1	10
OG0009489	1	1	2	1	2	2	1	10
OG0009490	1	3	1	1	1	2	1	10
OG0009491	2	3	1	1	1	1	1	10
OG0009492	2	3	1	1	1	1	1	10
OG0009493	2	2	2	1	1	1	1	10
OG0009494	1	3	1	2	1	1	1	10
OG0009495	2	3	1	1	1	1	1	10
OG0009496	2	3	1	1	1	1	1	10
OG0009497	2	3	1	1	1	1	1	10
OG0009498	2	2	2	1	1	1	1	10
OG0009499	2	3	1	1	1	1	1	10
OG0009500	2	3	1	1	1	1	1	10
OG0009501	1	4	1	1	1	1	1	10
OG0009502	1	4	1	1	1	1	1	10
OG0009503	2	3	1	1	1	1	1	10
OG0009504	2	3	1	1	1	1	1	10
OG0009505	2	4	1	1	1	1	0	10
OG0009506	1	4	1	1	1	1	1	10
OG0009507	1	3	1	1	1	2	1	10
OG0009508	2	3	1	1	1	1	1	10
OG0009509	2	3	1	1	1	1	1	10
OG0009510	2	4	1	1	1	0	1	10
OG0009511	2	3	1	1	1	1	1	10
OG0009512	2	3	1	1	1	1	1	10
OG0009513	2	3	1	1	1	1	1	10
OG0009514	2	4	1	1	1	1	0	10
OG0009515	1	4	1	1	1	1	1	10
OG0009516	1	4	1	1	1	1	1	10
OG0009517	1	4	1	1	1	1	1	10
OG0009518	2	3	1	1	1	1	1	10
OG0009519	2	4	1	1	0	1	1	10
OG0009520	2	3	1	1	1	1	1	10
OG0009521	2	3	1	1	1	1	1	10
OG0009522	2	3	1	1	1	1	1	10
OG0009523	2	4	1	0	1	1	1	10
OG0009524	2	3	1	1	1	1	1	10
OG0009525	2	3	1	1	1	1	1	10
OG0009526	2	3	1	1	1	1	1	10
OG0009527	2	3	1	1	1	1	1	10
OG0009528	1	4	1	1	1	1	1	10
OG0009529	1	4	1	1	1	1	1	10
OG0009530	1	4	1	1	1	1	1	10
OG0009531	2	3	1	1	1	1	1	10
OG0009532	1	3	1	1	1	2	1	10
OG0009533	2	3	1	1	1	1	1	10
OG0009534	1	4	1	1	1	1	1	10
OG0009535	1	4	1	1	1	1	1	10
OG0009536	1	4	1	1	1	1	1	10
OG0009537	2	3	1	1	1	1	1	10
OG0009538	2	4	1	1	1	1	0	10
OG0009539	2	3	1	1	1	1	1	10
OG0009540	2	3	1	1	1	1	1	10
OG0009541	1	4	1	1	1	1	1	10
OG0009542	1	3	4	0	0	0	2	10
OG0009543	2	3	1	1	1	1	1	10
OG0009544	2	4	1	1	0	1	1	10
OG0009545	2	3	1	0	2	1	1	10
OG0009546	1	3	1	1	1	1	2	10
OG0009547	2	3	1	1	1	1	1	10
OG0009548	2	3	1	1	1	1	1	10
OG0009549	2	3	1	1	1	1	1	10
OG0009550	2	3	1	1	1	1	1	10
OG0009551	2	3	1	1	1	1	1	10
OG0009552	2	3	1	1	1	1	1	10
OG0009553	2	2	1	1	1	1	2	10
OG0009554	1	4	1	1	1	1	1	10
OG0009555	2	3	1	1	1	1	1	10
OG0009556	1	4	1	1	1	1	1	10
OG0009557	1	4	1	1	1	1	1	10
OG0009558	1	3	2	1	1	1	1	10
OG0009559	1	4	1	1	1	1	1	10
OG0009560	2	3	1	1	1	1	1	10
OG0009561	2	3	1	1	1	1	1	10
OG0009562	1	2	1	1	4	0	1	10
OG0009563	2	3	1	1	1	1	1	10
OG0009564	2	4	1	1	1	1	0	10
OG0009565	2	3	1	1	1	1	1	10
OG0009566	2	3	1	1	1	1	1	10
OG0009567	2	5	1	0	0	0	2	10
OG0009568	3	2	1	1	1	1	1	10
OG0009569	2	3	1	1	1	1	1	10
OG0009570	2	3	1	1	1	1	1	10
OG0009571	2	3	1	1	1	1	1	10
OG0009572	2	3	1	1	1	1	1	10
OG0009573	1	3	1	2	1	1	1	10
OG0009574	2	3	1	1	1	1	1	10
OG0009575	2	3	1	1	1	1	1	10
OG0009576	1	2	1	2	1	2	1	10
OG0009577	2	3	1	1	1	1	1	10
OG0009578	1	4	1	1	1	1	1	10
OG0009579	2	3	1	1	1	1	1	10
OG0009580	2	3	1	1	1	1	1	10
OG0009581	1	3	2	1	1	1	1	10
OG0009582	2	3	1	1	1	1	1	10
OG0009583	4	3	1	1	0	0	1	10
OG0009584	1	4	1	1	1	1	1	10
OG0009585	2	3	1	1	1	1	1	10
OG0009586	2	4	1	1	0	1	1	10
OG0009587	1	4	1	1	1	1	1	10
OG0009588	2	3	0	1	1	1	2	10
OG0009589	2	4	1	1	0	1	1	10
OG0009590	2	3	1	1	1	1	1	10
OG0009591	1	3	1	1	1	1	2	10
OG0009592	2	4	1	1	1	0	1	10
OG0009593	2	4	1	1	1	1	0	10
OG0009594	2	3	1	1	1	1	1	10
OG0009595	1	4	1	1	1	0	2	10
OG0009596	2	3	1	1	1	1	1	10
OG0009597	1	4	1	1	1	1	1	10
OG0009598	2	3	0	1	2	1	1	10
OG0009599	2	3	1	1	1	1	1	10
OG0009600	2	3	1	1	1	1	1	10
OG0009601	1	4	1	1	1	1	1	10
OG0009602	3	3	1	1	1	0	1	10
OG0009603	2	3	1	1	1	1	1	10
OG0009604	2	3	1	1	1	1	1	10
OG0009605	1	3	1	2	1	1	1	10
OG0009606	2	3	1	1	1	1	1	10
OG0009607	1	5	1	1	1	1	0	10
OG0009608	1	4	1	1	1	1	1	10
OG0009609	2	3	1	1	1	1	1	10
OG0009610	1	4	1	1	1	1	1	10
OG0009611	2	3	1	1	1	1	1	10
OG0009612	2	3	1	1	1	1	1	10
OG0009613	1	4	1	1	1	1	1	10
OG0009614	1	4	1	1	1	1	1	10
OG0009615	2	3	1	1	1	1	1	10
OG0009616	2	3	1	1	1	1	1	10
OG0009617	1	4	1	1	1	1	1	10
OG0009618	2	3	1	1	1	1	1	10
OG0009619	2	3	1	1	1	1	1	10
OG0009620	2	3	1	1	1	1	1	10
OG0009621	2	3	1	1	1	1	1	10
OG0009622	1	3	1	1	1	2	1	10
OG0009623	2	2	1	1	1	2	1	10
OG0009624	2	3	1	1	1	1	1	10
OG0009625	2	4	1	1	1	1	0	10
OG0009626	1	4	1	1	1	1	1	10
OG0009627	2	3	1	1	1	1	1	10
OG0009628	2	3	1	1	1	1	1	10
OG0009629	2	3	1	1	1	1	1	10
OG0009630	2	3	1	1	1	1	1	10
OG0009631	2	3	1	1	1	1	1	10
OG0009632	1	3	1	0	2	0	3	10
OG0009633	2	3	1	1	1	1	1	10
OG0009634	2	2	1	1	1	1	2	10
OG0009635	1	4	1	1	1	1	1	10
OG0009636	1	4	1	1	1	1	1	10
OG0009637	1	4	1	1	1	1	1	10
OG0009638	1	2	3	1	1	1	1	10
OG0009639	2	4	1	1	1	1	0	10
OG0009640	2	4	1	1	1	0	1	10
OG0009641	2	3	1	1	1	1	1	10
OG0009642	1	4	1	1	1	1	1	10
OG0009643	1	4	1	1	1	1	1	10
OG0009644	2	3	1	1	1	1	1	10
OG0009645	3	2	1	1	1	1	1	10
OG0009646	1	4	1	1	1	1	1	10
OG0009647	1	5	1	1	1	1	0	10
OG0009648	1	4	1	1	1	1	1	10
OG0009649	2	3	1	1	1	1	1	10
OG0009650	1	4	1	1	1	1	1	10
OG0009651	1	4	1	1	1	1	1	10
OG0009652	1	4	1	1	1	1	1	10
OG0009653	2	3	1	1	1	1	1	10
OG0009654	2	3	1	1	1	1	1	10
OG0009655	2	3	1	1	1	1	1	10
OG0009656	2	3	1	1	1	1	1	10
OG0009657	2	2	1	1	1	1	2	10
OG0009658	1	4	1	1	1	1	1	10
OG0009659	1	3	1	2	1	1	1	10
OG0009660	2	3	1	1	1	1	1	10
OG0009661	1	4	1	1	1	1	1	10
OG0009662	2	3	1	1	1	1	1	10
OG0009663	2	2	1	1	1	1	2	10
OG0009664	1	3	1	1	1	2	1	10
OG0009665	2	3	1	1	1	1	1	10
OG0009666	2	4	0	1	1	1	1	10
OG0009667	2	3	1	1	1	1	1	10
OG0009668	3	2	1	1	1	1	1	10
OG0009669	1	4	1	1	1	1	1	10
OG0009670	2	3	1	1	1	1	1	10
OG0009671	1	1	0	2	2	2	2	10
OG0009672	2	3	1	1	1	1	1	10
OG0009673	1	4	1	1	1	1	1	10
OG0009674	2	3	1	1	1	1	1	10
OG0009675	1	4	1	1	1	1	1	10
OG0009676	1	4	1	1	1	1	1	10
OG0009677	2	3	1	1	1	1	1	10
OG0009678	2	4	1	1	1	1	0	10
OG0009679	2	3	1	1	1	1	1	10
OG0009680	2	3	1	1	1	1	1	10
OG0009681	1	4	1	1	1	1	1	10
OG0009682	2	3	1	1	1	1	1	10
OG0009683	2	4	1	1	1	0	1	10
OG0009684	2	3	1	1	1	1	1	10
OG0009685	2	3	1	1	1	1	1	10
OG0009686	2	3	1	1	1	1	1	10
OG0009687	2	3	1	1	1	1	1	10
OG0009688	1	4	1	1	1	1	1	10
OG0009689	2	4	1	1	1	0	1	10
OG0009690	1	6	0	0	1	1	1	10
OG0009691	1	3	1	1	1	1	2	10
OG0009692	2	3	1	1	1	1	1	10
OG0009693	1	4	1	1	1	1	1	10
OG0009694	2	4	1	0	1	1	1	10
OG0009695	1	4	1	1	1	1	1	10
OG0009696	2	3	1	1	1	1	1	10
OG0009697	1	3	2	1	1	1	1	10
OG0009698	2	4	0	1	1	1	1	10
OG0009699	2	4	1	0	1	1	1	10
OG0009700	2	3	1	1	1	1	1	10
OG0009701	3	2	1	1	1	1	1	10
OG0009702	1	4	1	1	1	1	1	10
OG0009703	1	4	1	1	1	1	1	10
OG0009704	2	3	1	1	1	1	1	10
OG0009705	1	4	1	1	1	1	1	10
OG0009706	2	4	1	1	0	1	1	10
OG0009707	2	3	1	1	1	1	1	10
OG0009708	2	3	1	1	1	1	1	10
OG0009709	1	3	1	1	1	1	2	10
OG0009710	2	3	1	1	1	1	1	10
OG0009711	1	4	1	1	1	1	1	10
OG0009712	2	3	1	1	1	1	1	10
OG0009713	2	3	1	1	1	1	1	10
OG0009714	1	4	3	0	1	0	1	10
OG0009715	1	4	1	1	1	1	1	10
OG0009716	1	4	1	1	1	1	1	10
OG0009717	2	3	1	1	1	1	1	10
OG0009718	2	3	1	1	1	1	1	10
OG0009719	2	4	1	1	1	0	1	10
OG0009720	2	3	1	1	1	1	1	10
OG0009721	2	3	1	1	1	1	1	10
OG0009722	1	4	1	1	1	1	1	10
OG0009723	1	4	1	1	1	1	1	10
OG0009724	2	3	1	1	1	1	1	10
OG0009725	1	4	1	1	1	1	1	10
OG0009726	3	2	1	1	1	1	1	10
OG0009727	2	4	1	1	1	1	0	10
OG0009728	3	2	1	1	1	1	1	10
OG0009729	1	4	1	1	1	1	1	10
OG0009730	2	4	1	1	1	0	1	10
OG0009731	1	4	1	1	1	1	1	10
OG0009732	2	4	1	1	0	1	1	10
OG0009733	2	3	1	1	1	1	1	10
OG0009734	2	3	1	1	1	1	1	10
OG0009735	1	4	1	1	1	1	1	10
OG0009736	2	3	1	1	1	1	1	10
OG0009737	2	3	1	1	1	1	1	10
OG0009738	2	3	1	1	1	1	1	10
OG0009739	2	3	1	1	1	1	1	10
OG0009740	1	4	1	1	1	1	1	10
OG0009741	1	5	1	1	1	0	1	10
OG0009742	2	3	1	1	1	1	1	10
OG0009743	2	2	1	1	1	2	1	10
OG0009744	1	3	1	1	1	1	2	10
OG0009745	1	4	1	1	1	1	1	10
OG0009746	2	3	1	1	1	1	1	10
OG0009747	2	3	1	1	1	1	1	10
OG0009748	2	3	1	1	1	1	1	10
OG0009749	2	3	1	1	1	1	1	10
OG0009750	2	3	1	1	1	1	1	10
OG0009751	2	3	1	1	1	1	1	10
OG0009752	1	4	1	1	1	1	1	10
OG0009753	2	3	1	1	1	1	1	10
OG0009754	2	3	1	1	1	1	1	10
OG0009755	2	3	1	1	1	1	1	10
OG0009756	1	4	1	1	1	1	1	10
OG0009757	1	3	1	1	1	1	2	10
OG0009758	2	4	1	2	0	0	1	10
OG0009759	2	3	1	1	1	1	1	10
OG0009760	1	3	1	2	1	1	1	10
OG0009761	2	3	1	1	1	1	1	10
OG0009762	2	3	1	1	1	1	1	10
OG0009763	1	4	1	1	1	1	1	10
OG0009764	2	3	1	1	1	1	1	10
OG0009765	1	4	1	1	1	1	1	10
OG0009766	1	4	1	1	1	1	1	10
OG0009767	2	3	1	1	1	1	1	10
OG0009768	2	2	1	2	1	1	1	10
OG0009769	2	3	1	1	1	1	1	10
OG0009770	1	4	1	1	1	1	1	10
OG0009771	1	4	1	1	1	1	1	10
OG0009772	2	3	1	1	1	1	1	10
OG0009773	1	4	1	1	1	1	1	10
OG0009774	2	3	1	1	1	1	1	10
OG0009775	2	3	1	1	1	1	1	10
OG0009776	2	3	1	1	1	1	1	10
OG0009777	3	2	1	1	1	1	1	10
OG0009778	2	3	1	1	1	1	1	10
OG0009779	2	3	1	1	1	1	1	10
OG0009780	2	3	1	1	1	1	1	10
OG0009781	1	4	1	1	1	1	1	10
OG0009782	1	4	1	1	1	1	1	10
OG0009783	1	4	1	1	1	1	1	10
OG0009784	1	4	2	1	0	1	1	10
OG0009785	2	2	1	1	2	1	1	10
OG0009786	2	3	1	1	1	1	1	10
OG0009787	2	3	1	1	1	0	2	10
OG0009788	2	3	1	1	1	1	1	10
OG0009789	2	3	1	1	1	1	1	10
OG0009790	1	4	1	1	1	1	1	10
OG0009791	2	3	1	1	1	1	1	10
OG0009792	1	4	1	1	1	1	1	10
OG0009793	3	2	1	1	1	1	1	10
OG0009794	1	3	1	1	1	1	2	10
OG0009795	2	3	1	1	1	1	1	10
OG0009796	1	2	1	1	2	1	2	10
OG0009797	1	3	2	1	1	1	1	10
OG0009798	1	4	1	1	1	1	1	10
OG0009799	2	3	1	1	1	1	1	10
OG0009800	1	4	1	1	1	1	1	10
OG0009801	2	3	1	1	1	1	1	10
OG0009802	1	3	2	1	1	1	1	10
OG0009803	2	3	1	1	1	1	1	10
OG0009804	1	3	1	1	1	2	1	10
OG0009805	2	3	1	1	1	1	1	10
OG0009806	2	3	1	1	1	1	1	10
OG0009807	2	4	1	1	0	1	1	10
OG0009808	1	4	1	1	1	1	1	10
OG0009809	2	3	1	1	1	1	1	10
OG0009810	3	2	1	1	1	1	1	10
OG0009811	2	3	1	1	1	1	1	10
OG0009812	2	3	1	1	1	1	1	10
OG0009813	2	3	1	1	1	1	1	10
OG0009814	1	4	1	1	1	1	1	10
OG0009815	2	3	1	1	1	1	1	10
OG0009816	2	3	1	1	1	1	1	10
OG0009817	1	4	1	1	1	1	1	10
OG0009818	1	4	1	1	1	1	1	10
OG0009819	1	4	1	1	1	1	1	10
OG0009820	2	3	1	1	1	1	1	10
OG0009821	1	4	1	1	1	1	1	10
OG0009822	2	4	1	1	1	0	1	10
OG0009823	3	3	1	1	1	1	0	10
OG0009824	2	4	1	1	1	1	0	10
OG0009825	1	4	1	1	1	1	1	10
OG0009826	1	4	1	1	1	1	1	10
OG0009827	1	4	1	1	1	1	1	10
OG0009828	2	3	1	1	1	1	1	10
OG0009829	2	3	3	1	0	0	1	10
OG0009830	3	2	1	1	1	1	1	10
OG0009831	1	3	1	1	1	2	1	10
OG0009832	1	1	0	0	0	0	8	10
OG0009833	1	4	1	1	1	1	1	10
OG0009834	1	4	1	1	1	1	1	10
OG0009835	1	4	1	1	1	1	1	10
OG0009836	1	4	1	1	1	1	1	10
OG0009837	1	2	1	2	2	1	1	10
OG0009838	1	4	1	1	1	1	1	10
OG0009839	2	3	1	1	1	1	1	10
OG0009840	2	3	1	1	1	1	1	10
OG0009841	1	4	1	1	1	1	1	10
OG0009842	2	3	1	1	1	1	1	10
OG0009843	2	3	1	1	1	1	1	10
OG0009844	2	3	1	1	1	1	1	10
OG0009845	2	3	1	1	1	1	1	10
OG0009846	2	3	1	1	1	1	1	10
OG0009847	2	3	1	1	1	1	1	10
OG0009848	1	3	1	1	1	1	2	10
OG0009849	2	3	1	1	1	1	1	10
OG0009850	2	3	1	1	1	1	1	10
OG0009851	2	3	1	1	1	1	1	10
OG0009852	1	4	1	1	1	1	1	10
OG0009853	1	3	1	2	1	1	1	10
OG0009854	1	3	1	1	2	1	1	10
OG0009855	1	4	1	1	1	1	1	10
OG0009856	1	4	1	1	1	1	1	10
OG0009857	1	3	1	2	1	1	1	10
OG0009858	1	4	1	1	1	1	1	10
OG0009859	2	3	1	1	1	1	1	10
OG0009860	1	4	1	1	1	1	1	10
OG0009861	2	3	1	1	1	1	1	10
OG0009862	2	3	1	1	1	1	1	10
OG0009863	2	3	1	1	1	1	1	10
OG0009864	1	4	1	1	1	1	1	10
OG0009865	2	3	1	1	1	1	1	10
OG0009866	2	3	1	1	1	1	1	10
OG0009867	2	3	1	1	1	1	1	10
OG0009868	2	3	1	1	1	1	1	10
OG0009869	2	3	1	1	1	1	1	10
OG0009870	2	2	1	1	1	1	2	10
OG0009871	2	3	1	1	1	1	1	10
OG0009872	1	3	2	1	1	1	1	10
OG0009873	1	4	1	1	1	1	1	10
OG0009874	1	4	1	1	1	1	1	10
OG0009875	1	3	1	1	1	1	2	10
OG0009876	2	3	1	1	1	1	1	10
OG0009877	2	3	1	1	1	1	1	10
OG0009878	2	4	1	1	1	0	1	10
OG0009879	1	3	1	1	1	1	2	10
OG0009880	2	3	1	1	1	1	1	10
OG0009881	1	4	1	1	1	1	1	10
OG0009882	1	4	1	1	1	1	1	10
OG0009883	1	4	1	1	1	1	1	10
OG0009884	3	2	1	1	1	1	1	10
OG0009885	2	3	1	1	1	1	1	10
OG0009886	2	3	1	1	1	1	1	10
OG0009887	2	3	1	1	1	0	2	10
OG0009888	1	4	1	1	1	1	1	10
OG0009889	1	4	1	1	1	1	1	10
OG0009890	1	2	0	1	1	2	3	10
OG0009891	2	3	1	1	1	1	1	10
OG0009892	1	3	1	1	1	1	2	10
OG0009893	2	3	1	1	1	1	1	10
OG0009894	1	4	1	1	1	1	1	10
OG0009895	2	3	1	1	1	1	1	10
OG0009896	1	4	1	1	1	1	1	10
OG0009897	2	3	1	1	1	1	1	10
OG0009898	1	4	1	2	1	0	1	10
OG0009899	2	3	1	1	1	0	2	10
OG0009900	2	3	1	1	1	1	1	10
OG0009901	1	4	1	1	1	1	1	10
OG0009902	2	3	1	1	1	1	1	10
OG0009903	2	3	1	1	1	1	1	10
OG0009904	2	3	1	1	1	1	1	10
OG0009905	2	4	1	1	1	1	0	10
OG0009906	2	2	1	2	1	1	1	10
OG0009907	1	4	1	1	1	1	1	10
OG0009908	2	3	1	1	1	1	1	10
OG0009909	1	4	1	1	1	1	1	10
OG0009910	2	3	1	1	1	1	1	10
OG0009911	2	3	1	1	1	1	1	10
OG0009912	2	4	1	1	0	1	1	10
OG0009913	1	5	1	1	1	0	1	10
OG0009914	1	5	1	1	1	0	1	10
OG0009915	3	2	1	1	1	1	1	10
OG0009916	2	2	1	1	1	1	2	10
OG0009917	2	3	1	1	1	1	1	10
OG0009918	1	4	1	1	1	1	1	10
OG0009919	1	4	1	1	1	1	1	10
OG0009920	1	4	1	1	1	1	1	10
OG0009921	1	4	1	1	1	1	1	10
OG0009922	2	3	1	1	1	1	1	10
OG0009923	1	3	1	1	1	1	2	10
OG0009924	3	2	1	1	1	1	1	10
OG0009925	2	4	1	1	1	0	1	10
OG0009926	1	4	1	1	1	1	1	10
OG0009927	2	3	1	1	1	1	1	10
OG0009928	2	3	1	1	1	1	1	10
OG0009929	1	5	1	1	1	0	1	10
OG0009930	1	5	1	1	1	1	0	10
OG0009931	3	3	1	1	1	0	1	10
OG0009932	1	3	1	1	1	1	2	10
OG0009933	2	3	1	1	1	1	1	10
OG0009934	2	3	1	1	1	1	1	10
OG0009935	1	4	1	1	1	1	1	10
OG0009936	2	4	1	0	1	1	1	10
OG0009937	2	3	1	1	1	1	1	10
OG0009938	3	3	1	0	1	1	1	10
OG0009939	2	3	1	1	1	1	1	10
OG0009940	2	3	1	1	1	1	1	10
OG0009941	2	3	1	1	1	1	1	10
OG0009942	2	4	1	1	1	0	1	10
OG0009943	1	3	2	1	1	1	1	10
OG0009944	2	3	1	1	1	1	1	10
OG0009945	2	3	1	1	1	1	1	10
OG0009946	2	3	1	1	1	1	1	10
OG0009947	1	4	1	1	1	1	1	10
OG0009948	1	2	1	1	2	1	2	10
OG0009949	1	4	1	1	1	1	1	10
OG0009950	2	3	1	1	1	1	1	10
OG0009951	1	4	1	1	1	1	1	10
OG0009952	2	3	1	1	1	1	1	10
OG0009953	2	3	1	1	1	1	1	10
OG0009954	2	3	1	1	1	1	1	10
OG0009955	2	4	0	1	1	1	1	10
OG0009956	1	4	1	1	1	1	1	10
OG0009957	3	2	1	1	1	1	1	10
OG0009958	1	4	1	1	1	1	1	10
OG0009959	2	3	1	1	1	1	1	10
OG0009960	1	4	1	1	1	1	1	10
OG0009961	1	4	1	1	1	1	1	10
OG0009962	1	4	1	1	1	1	1	10
OG0009963	2	3	1	1	1	1	1	10
OG0009964	1	4	1	1	1	1	1	10
OG0009965	2	3	1	1	1	1	1	10
OG0009966	1	4	1	1	1	1	1	10
OG0009967	2	3	1	1	1	1	1	10
OG0009968	2	3	1	1	1	1	1	10
OG0009969	3	2	1	1	1	1	1	10
OG0009970	2	3	1	1	1	1	1	10
OG0009971	2	2	1	1	0	2	2	10
OG0009972	2	3	1	1	1	1	1	10
OG0009973	1	4	1	0	1	2	1	10
OG0009974	1	4	1	1	1	1	1	10
OG0009975	2	3	1	1	1	1	1	10
OG0009976	2	3	1	1	1	1	1	10
OG0009977	1	4	1	1	1	1	1	10
OG0009978	2	3	1	1	1	1	1	10
OG0009979	2	3	1	1	1	1	1	10
OG0009980	2	3	1	1	1	1	1	10
OG0009981	2	3	1	1	1	1	1	10
OG0009982	1	4	1	1	1	1	1	10
OG0009983	1	4	1	1	1	1	1	10
OG0009984	1	4	1	1	1	1	1	10
OG0009985	1	4	1	1	1	1	1	10
OG0009986	2	3	1	1	1	1	1	10
OG0009987	1	3	2	1	0	2	1	10
OG0009988	1	5	1	0	1	1	1	10
OG0009989	2	3	1	1	1	1	1	10
OG0009990	1	4	1	1	1	1	1	10
OG0009991	1	3	1	1	1	1	2	10
OG0009992	2	3	1	1	1	1	1	10
OG0009993	2	3	1	1	1	1	1	10
OG0009994	2	3	1	1	1	1	1	10
OG0009995	1	4	1	1	1	1	1	10
OG0009996	1	4	1	1	1	1	1	10
OG0009997	2	3	1	1	1	1	1	10
OG0009998	2	3	1	1	1	1	1	10
OG0009999	1	4	1	1	1	1	1	10
OG0010000	1	3	1	1	1	2	1	10
OG0010001	2	3	1	1	1	1	1	10
OG0010002	1	4	1	1	1	1	1	10
OG0010003	2	3	1	1	1	1	1	10
OG0010004	1	4	1	1	1	0	2	10
OG0010005	2	3	1	1	1	1	1	10
OG0010006	1	3	1	2	1	1	1	10
OG0010007	2	3	1	1	1	1	1	10
OG0010008	2	3	1	1	1	1	1	10
OG0010009	1	4	1	1	1	1	1	10
OG0010010	1	3	1	1	1	1	2	10
OG0010011	1	3	1	1	1	1	2	10
OG0010012	2	4	1	0	1	1	1	10
OG0010013	2	3	1	1	1	1	1	10
OG0010014	1	4	1	1	1	1	1	10
OG0010015	2	3	1	1	1	1	1	10
OG0010016	2	2	1	1	1	1	2	10
OG0010017	1	4	1	1	1	1	1	10
OG0010018	1	4	1	1	1	1	1	10
OG0010019	2	3	1	1	1	1	1	10
OG0010020	1	5	1	1	1	1	0	10
OG0010021	2	4	1	1	1	0	1	10
OG0010022	2	3	1	1	1	1	1	10
OG0010023	2	2	1	2	1	1	1	10
OG0010024	1	4	1	1	1	1	1	10
OG0010025	2	3	1	1	1	1	1	10
OG0010026	2	3	1	1	1	1	1	10
OG0010027	1	4	1	1	1	1	1	10
OG0010028	1	4	1	1	1	1	1	10
OG0010029	2	3	1	1	1	1	1	10
OG0010030	2	2	1	1	1	2	1	10
OG0010031	2	3	1	1	1	1	1	10
OG0010032	1	4	1	1	1	1	1	10
OG0010033	1	4	1	1	1	1	1	10
OG0010034	2	3	1	1	1	1	1	10
OG0010035	1	4	1	1	1	1	1	10
OG0010036	1	5	1	1	1	0	1	10
OG0010037	1	4	1	1	1	1	1	10
OG0010038	2	3	1	1	1	1	1	10
OG0010039	1	2	0	0	0	0	7	10
OG0010040	2	4	1	1	1	1	0	10
OG0010041	1	3	1	1	1	1	2	10
OG0010042	1	3	2	1	1	1	1	10
OG0010043	2	4	1	1	1	1	0	10
OG0010044	2	3	1	1	1	1	1	10
OG0010045	2	3	1	1	1	1	1	10
OG0010046	1	3	1	1	2	1	1	10
OG0010047	2	3	1	1	1	1	1	10
OG0010048	2	3	1	1	1	1	1	10
OG0010049	1	4	1	1	1	1	1	10
OG0010050	1	5	0	1	1	1	1	10
OG0010051	1	4	1	1	1	1	1	10
OG0010052	1	4	1	1	1	1	1	10
OG0010053	2	3	1	1	1	1	1	10
OG0010054	1	4	1	1	1	1	1	10
OG0010055	2	3	1	1	1	1	1	10
OG0010056	1	2	1	3	1	0	2	10
OG0010057	2	4	1	1	1	0	1	10
OG0010058	2	4	0	1	1	1	1	10
OG0010059	1	3	2	1	1	1	1	10
OG0010060	1	4	1	1	1	1	1	10
OG0010061	2	3	1	1	1	1	1	10
OG0010062	2	3	1	1	1	1	1	10
OG0010063	1	4	1	1	1	1	1	10
OG0010064	2	3	1	1	1	1	1	10
OG0010065	2	3	1	1	1	1	1	10
OG0010066	2	3	1	1	1	1	1	10
OG0010067	1	4	1	1	1	1	1	10
OG0010068	1	4	1	1	1	1	1	10
OG0010069	2	4	1	1	0	1	1	10
OG0010070	2	3	1	1	2	1	0	10
OG0010071	2	3	1	1	1	0	2	10
OG0010072	2	3	1	1	1	1	1	10
OG0010073	1	3	1	1	2	1	1	10
OG0010074	1	4	1	1	1	1	1	10
OG0010075	1	4	1	1	1	1	1	10
OG0010076	2	2	1	2	1	1	1	10
OG0010077	2	3	1	1	1	1	1	10
OG0010078	1	3	1	1	1	1	2	10
OG0010079	1	4	1	1	1	1	1	10
OG0010080	2	3	1	1	1	1	1	10
OG0010081	2	3	1	1	1	1	1	10
OG0010082	1	3	1	1	1	1	2	10
OG0010083	2	3	1	1	1	1	1	10
OG0010084	1	4	1	1	1	1	1	10
OG0010085	2	3	1	1	1	1	1	10
OG0010086	2	3	1	1	1	1	1	10
OG0010087	1	4	1	1	1	1	1	10
OG0010088	2	3	1	1	1	1	1	10
OG0010089	1	4	1	1	1	1	1	10
OG0010090	1	1	0	3	2	2	1	10
OG0010091	2	3	1	1	1	1	1	10
OG0010092	1	4	1	1	1	1	1	10
OG0010093	2	3	1	1	1	1	1	10
OG0010094	2	3	1	1	1	1	1	10
OG0010095	1	4	1	1	1	1	1	10
OG0010096	2	3	1	1	1	1	1	10
OG0010097	1	4	1	1	1	1	1	10
OG0010098	1	4	1	1	1	1	1	10
OG0010099	1	3	1	1	1	1	2	10
OG0010100	2	2	1	1	1	1	2	10
OG0010101	2	3	1	1	1	1	1	10
OG0010102	2	3	1	1	1	1	1	10
OG0010103	1	2	2	0	2	2	1	10
OG0010104	1	4	1	1	1	1	1	10
OG0010105	2	2	3	1	0	1	1	10
OG0010106	1	4	1	1	1	1	1	10
OG0010107	2	3	1	1	1	1	1	10
OG0010108	1	4	1	1	1	1	1	10
OG0010109	1	3	1	1	1	1	2	10
OG0010110	2	3	1	1	1	1	1	10
OG0010111	1	4	1	1	1	1	1	10
OG0010112	2	3	1	1	1	1	1	10
OG0010113	1	4	1	1	1	1	1	10
OG0010114	1	4	1	1	1	1	1	10
OG0010115	1	4	1	1	1	1	1	10
OG0010116	2	3	1	1	1	1	1	10
OG0010117	1	4	1	1	1	1	1	10
OG0010118	1	4	1	1	1	1	1	10
OG0010119	1	4	1	1	1	1	1	10
OG0010120	1	4	1	1	1	1	1	10
OG0010121	1	4	1	1	1	1	1	10
OG0010122	2	4	1	1	1	0	1	10
OG0010123	2	3	1	1	1	1	1	10
OG0010124	2	3	1	1	1	1	1	10
OG0010125	1	4	1	1	1	1	1	10
OG0010126	2	3	1	1	1	1	1	10
OG0010127	1	3	1	1	1	1	2	10
OG0010128	1	3	1	0	1	2	2	10
OG0010129	1	4	1	1	1	1	1	10
OG0010130	2	3	1	1	1	1	1	10
OG0010131	1	4	1	1	1	1	1	10
OG0010132	1	4	1	1	1	1	1	10
OG0010133	1	2	2	1	1	1	2	10
OG0010134	1	4	1	1	1	1	1	10
OG0010135	1	4	1	1	1	1	1	10
OG0010136	1	4	1	1	1	1	1	10
OG0010137	2	4	1	2	0	0	1	10
OG0010138	2	3	1	1	1	1	1	10
OG0010139	1	4	1	1	1	1	1	10
OG0010140	1	4	1	1	1	1	1	10
OG0010141	1	4	1	1	1	1	1	10
OG0010142	2	3	1	1	1	1	1	10
OG0010143	1	4	1	1	1	1	1	10
OG0010144	1	4	1	1	1	1	1	10
OG0010145	2	3	1	1	1	1	1	10
OG0010146	1	4	1	1	1	1	1	10
OG0010147	1	4	1	1	1	1	1	10
OG0010148	2	3	1	1	1	1	1	10
OG0010149	3	2	1	1	1	1	1	10
OG0010150	2	3	1	1	1	1	1	10
OG0010151	1	3	2	1	1	1	1	10
OG0010152	1	4	1	1	1	1	1	10
OG0010153	1	4	1	1	1	1	1	10
OG0010154	1	4	1	1	1	1	1	10
OG0010155	2	3	1	1	1	1	1	10
OG0010156	1	3	2	1	1	1	1	10
OG0010157	1	4	1	1	1	1	1	10
OG0010158	1	4	1	1	1	1	1	10
OG0010159	2	3	1	1	1	1	1	10
OG0010160	2	3	1	1	1	1	1	10
OG0010161	1	4	1	1	1	1	1	10
OG0010162	2	3	1	1	1	1	1	10
OG0010163	1	4	1	2	1	1	0	10
OG0010164	2	3	1	1	1	1	1	10
OG0010165	2	4	1	1	1	0	1	10
OG0010166	2	3	1	1	1	1	1	10
OG0010167	1	2	6	0	1	0	0	10
OG0010168	2	3	1	1	1	1	1	10
OG0010169	1	4	1	1	1	1	1	10
OG0010170	2	3	1	1	1	1	1	10
OG0010171	1	4	1	1	1	1	1	10
OG0010172	1	4	1	1	1	1	1	10
OG0010173	1	4	1	1	1	1	1	10
OG0010174	1	2	1	1	1	2	2	10
OG0010175	1	4	1	1	1	1	1	10
OG0010176	2	3	1	1	1	1	1	10
OG0010177	2	3	1	1	2	1	0	10
OG0010178	2	3	1	1	1	1	1	10
OG0010179	2	3	1	1	1	1	1	10
OG0010180	1	4	1	1	1	1	1	10
OG0010181	2	3	1	1	1	1	1	10
OG0010182	1	2	1	1	1	1	3	10
OG0010183	1	4	1	1	1	1	1	10
OG0010184	1	4	1	1	1	1	1	10
OG0010185	1	4	1	1	1	1	1	10
OG0010186	1	4	1	0	2	1	1	10
OG0010187	2	3	1	1	1	1	1	10
OG0010188	2	4	1	1	0	1	1	10
OG0010189	1	4	1	1	1	1	1	10
OG0010190	1	4	1	1	1	1	1	10
OG0010191	1	4	1	1	1	1	1	10
OG0010192	1	4	1	1	1	1	1	10
OG0010193	1	4	1	1	1	1	1	10
OG0010194	1	3	1	1	2	1	1	10
OG0010195	1	4	1	1	1	1	1	10
OG0010196	1	4	1	1	1	1	1	10
OG0010197	2	3	1	1	1	1	1	10
OG0010198	1	5	1	1	1	0	1	10
OG0010199	2	3	1	1	1	1	1	10
OG0010200	1	4	1	1	1	1	1	10
OG0010201	1	4	1	1	1	1	1	10
OG0010202	2	4	1	1	1	0	1	10
OG0010203	1	4	1	1	1	1	1	10
OG0010204	1	4	1	1	1	1	1	10
OG0010205	2	3	1	1	1	1	1	10
OG0010206	2	3	1	1	1	1	1	10
OG0010207	1	4	1	1	1	1	1	10
OG0010208	2	3	1	1	1	1	1	10
OG0010209	2	3	1	1	1	1	1	10
OG0010210	1	4	1	1	1	1	1	10
OG0010211	1	4	1	1	1	1	1	10
OG0010212	1	4	1	1	1	1	1	10
OG0010213	1	4	1	1	1	1	1	10
OG0010214	1	5	1	1	1	0	1	10
OG0010215	1	4	1	1	1	1	1	10
OG0010216	2	3	1	1	1	1	1	10
OG0010217	1	4	1	1	1	1	1	10
OG0010218	2	3	1	1	1	1	1	10
OG0010219	1	4	1	1	1	1	1	10
OG0010220	1	4	1	1	1	1	1	10
OG0010221	2	4	1	1	0	1	1	10
OG0010222	1	4	1	1	1	1	1	10
OG0010223	1	4	1	1	1	1	1	10
OG0010224	1	0	0	0	0	0	9	10
OG0010225	2	3	1	1	1	1	1	10
OG0010226	1	4	1	1	1	1	1	10
OG0010227	1	4	1	1	1	1	1	10
OG0010228	1	4	1	1	1	1	1	10
OG0010229	1	3	1	1	1	1	2	10
OG0010230	1	4	1	1	1	1	1	10
OG0010231	2	4	1	1	1	1	0	10
OG0010232	1	3	2	1	1	1	1	10
OG0010233	2	3	1	1	1	1	1	10
OG0010234	1	1	0	1	1	3	3	10
OG0010235	2	3	1	1	1	1	1	10
OG0010236	2	3	1	1	1	1	1	10
OG0010237	1	4	1	1	1	1	1	10
OG0010238	2	3	1	1	1	1	1	10
OG0010239	2	3	1	1	1	1	1	10
OG0010240	2	3	1	1	1	1	1	10
OG0010241	1	3	1	1	1	1	2	10
OG0010242	1	4	1	1	1	1	1	10
OG0010243	2	3	1	1	1	1	1	10
OG0010244	2	1	2	1	2	0	2	10
OG0010245	1	4	1	1	1	1	1	10
OG0010246	2	3	1	1	1	1	1	10
OG0010247	1	4	1	1	1	1	1	10
OG0010248	2	4	1	1	1	1	0	10
OG0010249	2	3	1	1	1	1	1	10
OG0010250	1	4	1	1	1	1	1	10
OG0010251	2	3	1	1	1	1	1	10
OG0010252	2	3	1	1	1	1	1	10
OG0010253	1	4	1	1	1	1	1	10
OG0010254	1	4	1	1	1	1	1	10
OG0010255	2	2	2	1	1	1	1	10
OG0010256	2	4	1	1	1	0	1	10
OG0010257	1	4	1	1	1	1	1	10
OG0010258	1	3	1	1	1	1	2	10
OG0010259	1	4	1	1	1	1	1	10
OG0010260	1	4	1	1	1	1	1	10
OG0010261	1	4	1	1	1	1	1	10
OG0010262	1	4	1	1	1	1	1	10
OG0010263	1	4	1	1	1	1	1	10
OG0010264	2	2	2	1	1	1	1	10
OG0010265	2	3	1	1	1	1	1	10
OG0010266	1	3	2	1	1	1	1	10
OG0010267	1	4	1	1	1	1	1	10
OG0010268	1	4	1	1	1	1	1	10
OG0010269	1	4	1	1	1	1	1	10
OG0010270	2	3	1	1	1	1	1	10
OG0010271	1	3	1	1	1	1	2	10
OG0010272	1	4	1	1	1	1	1	10
OG0010273	1	3	1	2	1	1	1	10
OG0010274	1	4	1	1	1	1	1	10
OG0010275	1	4	1	1	1	1	1	10
OG0010276	2	4	1	1	1	1	0	10
OG0010277	1	4	1	1	1	1	1	10
OG0010278	2	4	1	1	0	1	1	10
OG0010279	1	4	1	1	1	1	1	10
OG0010280	1	4	1	1	1	1	1	10
OG0010281	1	3	1	1	2	1	1	10
OG0010282	2	3	1	1	1	1	1	10
OG0010283	1	4	1	1	1	1	1	10
OG0010284	3	2	1	1	1	1	1	10
OG0010285	2	3	1	1	1	1	1	10
OG0010286	1	3	1	1	1	2	1	10
OG0010287	1	3	1	1	1	1	2	10
OG0010288	1	4	1	1	1	1	1	10
OG0010289	1	4	1	1	1	1	1	10
OG0010290	2	3	1	1	1	1	1	10
OG0010291	1	3	1	1	1	1	2	10
OG0010292	1	4	1	1	1	1	1	10
OG0010293	2	4	1	1	0	1	1	10
OG0010294	1	2	1	1	2	2	1	10
OG0010295	1	4	1	1	1	1	1	10
OG0010296	1	4	1	1	1	1	1	10
OG0010297	1	4	1	1	1	1	1	10
OG0010298	1	4	1	1	1	1	1	10
OG0010299	1	4	1	1	1	1	1	10
OG0010300	1	5	1	1	1	0	1	10
OG0010301	1	4	1	1	1	1	1	10
OG0010302	1	4	1	1	1	1	1	10
OG0010303	1	3	1	1	1	2	1	10
OG0010304	1	4	1	1	1	1	1	10
OG0010305	1	3	1	1	0	2	2	10
OG0010306	1	4	1	1	1	1	1	10
OG0010307	2	4	1	1	1	1	0	10
OG0010308	1	4	1	1	1	1	1	10
OG0010309	2	3	1	1	1	1	1	10
OG0010310	1	4	1	1	1	1	1	10
OG0010311	1	3	1	1	2	1	1	10
OG0010312	1	3	1	1	1	1	2	10
OG0010313	1	3	1	1	1	1	2	10
OG0010314	1	4	1	1	1	1	1	10
OG0010315	1	4	1	1	1	1	1	10
OG0010316	1	4	1	1	1	1	1	10
OG0010317	1	4	1	1	1	1	1	10
OG0010318	2	3	1	1	1	1	1	10
OG0010319	1	4	1	1	1	1	1	10
OG0010320	1	4	1	1	1	1	1	10
OG0010321	2	3	1	1	1	1	1	10
OG0010322	2	3	1	1	1	1	1	10
OG0010323	1	4	1	1	1	1	1	10
OG0010324	1	4	1	1	1	1	1	10
OG0010325	1	3	1	1	1	1	2	10
OG0010326	1	4	1	1	1	1	1	10
OG0010327	1	2	1	1	1	2	2	10
OG0010328	1	4	1	1	1	1	1	10
OG0010329	1	4	1	1	1	1	1	10
OG0010330	1	4	1	1	1	1	1	10
OG0010331	1	4	1	1	1	1	1	10
OG0010332	1	4	1	1	1	1	1	10
OG0010333	1	3	2	1	1	1	1	10
OG0010334	1	4	1	1	1	1	1	10
OG0010335	1	4	1	1	1	1	1	10
OG0010336	1	4	1	1	1	1	1	10
OG0010337	1	3	1	1	1	1	2	10
OG0010338	2	3	1	1	1	1	1	10
OG0010339	1	4	1	1	1	1	1	10
OG0010340	1	4	1	1	1	1	1	10
OG0010341	1	4	1	1	1	1	1	10
OG0010342	1	4	1	1	1	1	1	10
OG0010343	1	4	1	1	1	1	1	10
OG0010344	1	3	1	2	1	1	1	10
OG0010345	1	4	1	1	1	1	1	10
OG0010346	1	4	1	1	1	1	1	10
OG0010347	1	4	1	1	1	1	1	10
OG0010348	1	4	1	1	1	1	1	10
OG0010349	1	3	1	1	1	2	1	10
OG0010350	0	8	0	1	1	0	0	10
OG0010351	0	7	1	0	0	1	1	10
OG0010352	0	4	2	1	1	1	1	10
OG0010353	0	5	1	1	1	1	1	10
OG0010354	0	5	0	2	1	1	1	10
OG0010355	0	9	0	0	0	0	1	10
OG0010356	0	5	1	1	1	1	1	10
OG0010357	0	4	1	1	0	1	3	10
OG0010358	0	5	2	0	1	0	2	10
OG0010359	0	7	1	0	1	0	1	10
OG0010360	0	6	0	2	1	1	0	10
OG0010361	0	9	0	0	0	1	0	10
OG0010362	0	3	1	1	1	1	3	10
OG0010363	0	5	1	1	1	1	1	10
OG0010364	0	5	1	1	1	1	1	10
OG0010365	0	9	1	0	0	0	0	10
OG0010366	0	5	1	1	1	1	1	10
OG0010367	0	10	0	0	0	0	0	10
OG0010368	0	5	1	1	1	1	1	10
OG0010369	0	3	0	2	1	2	2	10
OG0010370	0	7	1	0	2	0	0	10
OG0010371	0	3	0	1	2	2	2	10
OG0010372	0	2	2	2	0	2	2	10
OG0010373	0	5	1	1	1	1	1	10
OG0010374	0	4	1	1	1	1	2	10
OG0010375	0	4	1	1	1	1	2	10
OG0010376	0	3	3	0	1	2	1	10
OG0010377	0	10	0	0	0	0	0	10
OG0010378	0	9	0	0	0	0	1	10
OG0010379	0	4	1	2	1	1	1	10
OG0010380	0	5	3	1	1	0	0	10
OG0010381	0	2	3	1	1	2	1	10
OG0010382	0	10	0	0	0	0	0	10
OG0010383	0	5	0	1	0	2	2	10
OG0010384	0	4	1	1	1	1	2	10
OG0010385	0	4	1	1	1	1	2	10
OG0010386	0	9	1	0	0	0	0	10
OG0010387	0	4	1	1	1	2	1	10
OG0010388	0	5	1	1	1	1	1	10
OG0010389	0	4	1	2	1	1	1	10
OG0010390	0	10	0	0	0	0	0	10
OG0010391	0	6	1	0	1	1	1	10
OG0010392	0	4	2	1	1	1	1	10
OG0010393	0	4	2	0	1	1	2	10
OG0010394	0	5	1	1	1	1	1	10
OG0010395	0	5	2	1	0	1	1	10
OG0010396	0	7	0	0	0	2	1	10
OG0010397	0	7	0	0	0	1	2	10
OG0010398	0	4	1	1	1	1	2	10
OG0010399	0	4	2	1	1	1	1	10
OG0010400	0	3	1	2	2	1	1	10
OG0010401	0	3	1	2	1	1	2	10
OG0010402	0	4	1	0	0	3	2	10
OG0010403	0	4	1	1	1	2	1	10
OG0010404	0	6	1	0	1	1	1	10
OG0010405	0	6	0	0	3	0	1	10
OG0010406	0	9	0	0	0	0	1	10
OG0010407	0	7	1	1	0	1	0	10
OG0010408	0	5	1	1	1	1	1	10
OG0010409	0	5	1	1	1	1	1	10
OG0010410	0	5	1	1	1	1	1	10
OG0010411	0	9	0	0	0	0	1	10
OG0010412	0	2	0	0	2	3	3	10
OG0010413	0	3	0	0	0	0	7	10
OG0010414	0	3	0	5	1	0	1	10
OG0010415	0	9	0	0	0	0	1	10
OG0010416	0	10	0	0	0	0	0	10
OG0010417	0	2	1	1	5	0	1	10
OG0010418	0	9	1	0	0	0	0	10
OG0010419	0	6	1	0	2	0	1	10
OG0010420	0	3	2	0	1	1	3	10
OG0010421	0	5	1	1	1	1	1	10
OG0010422	0	6	1	1	1	1	0	10
OG0010423	0	5	1	1	1	0	2	10
OG0010424	0	4	1	1	1	2	1	10
OG0010425	0	3	2	1	2	0	2	10
OG0010426	0	4	1	1	1	1	2	10
OG0010427	0	5	1	1	1	1	1	10
OG0010428	0	5	1	1	1	1	1	10
OG0010429	0	10	0	0	0	0	0	10
OG0010430	0	6	0	1	1	1	1	10
OG0010431	0	5	1	1	1	1	1	10
OG0010432	0	1	3	2	0	1	3	10
OG0010433	0	1	0	0	0	0	9	10
OG0010434	0	4	3	1	1	1	0	10
OG0010435	0	6	0	1	2	1	0	10
OG0010436	0	3	1	1	1	1	3	10
OG0010437	0	8	0	1	0	1	0	10
OG0010438	0	4	2	1	0	1	2	10
OG0010439	0	4	1	2	1	1	1	10
OG0010440	0	5	1	1	1	2	0	10
OG0010441	0	2	6	0	0	0	2	10
OG0010442	0	4	1	1	1	1	2	10
OG0010443	0	4	1	1	0	2	2	10
OG0010444	0	6	0	1	2	0	1	10
OG0010445	0	5	1	1	1	1	1	10
OG0010446	0	8	0	0	0	1	1	10
OG0010447	0	6	1	2	1	0	0	10
OG0010448	0	4	0	1	1	1	3	10
OG0010449	0	6	1	1	1	0	1	10
OG0010450	0	5	1	1	1	1	1	10
OG0010451	0	4	1	2	1	1	1	10
OG0010452	0	5	1	1	1	1	1	10
OG0010453	0	3	1	1	1	2	2	10
OG0010454	0	3	1	1	1	2	2	10
OG0010455	0	5	0	1	2	1	1	10
OG0010456	0	4	2	1	1	1	1	10
OG0010457	0	4	1	1	1	1	2	10
OG0010458	0	4	1	1	1	1	2	10
OG0010459	0	3	1	1	2	2	1	10
OG0010460	0	4	2	1	1	1	1	10
OG0010461	0	5	1	1	1	1	1	10
OG0010462	0	4	0	1	1	3	1	10
OG0010463	0	7	0	1	2	0	0	10
OG0010464	0	7	0	0	2	0	1	10
OG0010465	0	5	1	2	1	1	0	10
OG0010466	0	10	0	0	0	0	0	10
OG0010467	0	4	1	1	1	1	2	10
OG0010468	0	7	1	0	1	0	1	10
OG0010469	0	4	1	1	1	1	2	10
OG0010470	0	5	1	1	1	1	1	10
OG0010471	0	5	2	2	0	1	0	10
OG0010472	0	4	0	1	5	0	0	10
OG0010473	0	4	0	1	0	0	5	10
OG0010474	0	3	1	1	1	1	3	10
OG0010475	0	5	1	1	1	1	1	10
OG0010476	0	3	1	1	1	2	2	10
OG0010477	0	3	1	1	1	2	2	10
OG0010478	0	5	1	1	1	1	1	10
OG0010479	0	6	1	1	0	0	2	10
OG0010480	0	3	2	1	2	0	2	10
OG0010481	0	5	1	1	1	1	1	10
OG0010482	0	5	1	1	1	1	1	10
OG0010483	0	4	1	1	1	2	1	10
OG0010484	0	7	0	0	1	0	2	10
OG0010485	0	3	1	2	2	1	1	10
OG0010486	0	5	1	1	1	1	1	10
OG0010487	0	3	0	0	2	2	3	10
OG0010488	0	4	1	1	2	2	0	10
OG0010489	0	6	0	0	3	1	0	10
OG0010490	0	5	1	0	2	0	2	10
OG0010491	0	5	1	1	1	1	1	10
OG0010492	0	8	0	0	0	0	2	10
OG0010493	0	5	1	1	1	1	1	10
OG0010494	0	4	1	1	1	1	2	10
OG0010495	0	5	1	1	0	2	1	10
OG0010496	0	4	1	0	1	2	2	10
OG0010497	0	5	0	1	2	1	1	10
OG0010498	0	4	1	1	1	2	1	10
OG0010499	0	4	0	2	2	2	0	10
OG0010500	0	4	1	2	1	1	1	10
OG0010501	0	9	0	0	0	0	1	10
OG0010502	0	7	1	0	1	0	1	10
OG0010503	0	4	2	0	1	2	1	10
OG0010504	0	6	1	0	1	0	2	10
OG0010505	0	2	4	1	1	1	1	10
OG0010506	0	6	3	0	0	0	1	10
OG0010507	0	5	1	1	1	1	1	10
OG0010508	0	7	1	1	1	0	0	10
OG0010509	0	9	0	0	0	0	1	10
OG0010510	0	8	0	0	0	0	2	10
OG0010511	0	6	0	0	0	1	3	10
OG0010512	0	4	1	1	2	1	1	10
OG0010513	0	3	0	1	1	4	1	10
OG0010514	0	4	1	1	1	2	1	10
OG0010515	0	4	1	1	1	1	2	10
OG0010516	0	5	0	0	2	1	2	10
OG0010517	0	4	1	1	1	1	2	10
OG0010518	0	4	3	0	1	1	1	10
OG0010519	0	5	1	1	1	1	1	10
OG0010520	0	5	1	1	1	1	1	10
OG0010521	0	5	1	1	1	1	1	10
OG0010522	0	3	0	1	2	2	2	10
OG0010523	0	2	0	1	2	2	3	10
OG0010524	0	5	1	1	1	1	1	10
OG0010525	0	4	2	1	1	1	1	10
OG0010526	0	5	0	2	1	1	1	10
OG0010527	0	3	1	2	2	2	0	10
OG0010528	0	5	1	1	1	1	1	10
OG0010529	0	6	1	1	0	1	1	10
OG0010530	0	5	1	1	0	2	1	10
OG0010531	0	3	0	1	3	1	2	10
OG0010532	0	2	0	2	1	2	3	10
OG0010533	0	5	0	2	1	1	1	10
OG0010534	0	1	1	1	0	2	5	10
OG0010535	0	3	1	1	2	2	1	10
OG0010536	0	3	0	2	1	2	2	10
OG0010537	0	4	0	1	1	2	2	10
OG0010538	0	4	2	1	1	1	1	10
OG0010539	0	10	0	0	0	0	0	10
OG0010540	0	4	1	1	1	2	1	10
OG0010541	0	5	1	1	1	1	1	10
OG0010542	0	4	1	1	1	1	2	10
OG0010543	0	5	0	1	1	3	0	10
OG0010544	0	4	1	1	1	1	2	10
OG0010545	0	4	1	2	1	1	1	10
OG0010546	0	4	2	0	2	0	2	10
OG0010547	0	4	1	1	1	1	2	10
OG0010548	0	4	1	1	1	1	2	10
OG0010549	0	6	0	1	2	0	1	10
OG0010550	0	5	0	0	2	1	2	10
OG0010551	0	5	1	1	1	1	1	10
OG0010552	0	4	0	1	2	1	2	10
OG0010553	0	2	0	2	3	2	1	10
OG0010554	0	4	1	1	0	2	2	10
OG0010555	0	5	2	0	0	0	3	10
OG0010556	0	3	1	1	1	1	3	10
OG0010557	0	6	0	1	1	1	1	10
OG0010558	0	4	1	1	2	1	1	10
OG0010559	0	2	2	2	2	1	1	10
OG0010560	0	4	1	3	1	1	0	10
OG0010561	0	4	1	1	0	1	3	10
OG0010562	0	4	0	1	2	1	2	10
OG0010563	0	1	0	0	0	0	9	10
OG0010564	0	1	0	2	3	2	2	10
OG0010565	0	0	5	2	0	0	3	10
OG0010566	0	0	1	1	4	2	2	10
OG0010567	0	0	3	3	1	1	2	10
OG0010568	0	0	2	3	1	2	2	10
OG0010569	0	0	0	2	5	3	0	10
OG0010570	0	0	0	7	1	1	1	10
OG0010571	0	0	0	0	9	1	0	10
OG0010572	0	0	0	0	0	1	9	10
OG0010573	0	0	0	0	0	0	10	10
OG0010574	0	0	0	0	0	0	10	10
OG0010575	0	0	0	0	0	0	10	10
OG0010576	0	0	0	0	0	0	10	10
OG0010577	0	0	0	0	0	0	10	10
OG0010578	0	0	0	0	0	0	10	10
OG0010579	0	0	0	0	0	0	10	10
OG0010580	0	0	0	0	0	0	10	10
OG0010581	0	0	0	0	0	0	10	10
OG0010582	2	5	1	0	0	0	1	9
OG0010583	2	3	1	1	1	1	0	9
OG0010584	1	3	1	1	1	1	1	9
OG0010585	1	3	1	1	1	1	1	9
OG0010586	2	2	1	1	1	1	1	9
OG0010587	2	2	1	1	1	1	1	9
OG0010588	2	2	1	1	1	1	1	9
OG0010589	3	1	1	1	1	1	1	9
OG0010590	2	2	1	1	1	1	1	9
OG0010591	2	2	1	1	1	1	1	9
OG0010592	2	3	1	1	1	0	1	9
OG0010593	2	2	1	1	1	1	1	9
OG0010594	3	1	1	1	1	1	1	9
OG0010595	2	2	1	1	1	1	1	9
OG0010596	1	3	1	1	1	1	1	9
OG0010597	1	3	1	1	1	1	1	9
OG0010598	1	3	1	1	1	1	1	9
OG0010599	2	2	1	1	1	1	1	9
OG0010600	2	2	1	1	1	1	1	9
OG0010601	1	3	1	1	1	1	1	9
OG0010602	1	4	1	1	1	1	0	9
OG0010603	2	2	1	1	1	1	1	9
OG0010604	1	3	1	1	1	1	1	9
OG0010605	1	3	1	1	1	1	1	9
OG0010606	2	2	1	1	1	1	1	9
OG0010607	1	3	1	1	1	1	1	9
OG0010608	3	1	1	1	1	1	1	9
OG0010609	2	3	1	1	0	1	1	9
OG0010610	2	2	1	1	1	1	1	9
OG0010611	1	3	1	1	1	1	1	9
OG0010612	2	2	1	1	1	1	1	9
OG0010613	2	2	1	1	1	1	1	9
OG0010614	1	4	1	1	0	1	1	9
OG0010615	2	2	1	1	1	1	1	9
OG0010616	2	2	1	1	1	1	1	9
OG0010617	2	2	1	1	1	1	1	9
OG0010618	2	2	1	1	1	1	1	9
OG0010619	1	3	1	1	1	1	1	9
OG0010620	1	3	1	1	1	1	1	9
OG0010621	2	3	1	1	0	1	1	9
OG0010622	2	3	1	0	1	1	1	9
OG0010623	1	3	1	1	1	1	1	9
OG0010624	9	0	0	0	0	0	0	9
OG0010625	3	1	1	1	1	1	1	9
OG0010626	1	3	1	1	1	1	1	9
OG0010627	1	3	1	1	1	1	1	9
OG0010628	2	2	1	1	1	1	1	9
OG0010629	1	3	1	1	1	1	1	9
OG0010630	2	2	1	1	1	1	1	9
OG0010631	3	1	1	0	1	1	2	9
OG0010632	2	2	1	1	1	1	1	9
OG0010633	2	2	1	1	1	1	1	9
OG0010634	2	2	1	1	1	1	1	9
OG0010635	2	2	1	1	1	1	1	9
OG0010636	2	2	1	1	1	1	1	9
OG0010637	2	2	1	1	1	1	1	9
OG0010638	2	4	1	0	1	0	1	9
OG0010639	2	2	1	1	1	1	1	9
OG0010640	2	3	1	0	1	1	1	9
OG0010641	1	3	1	1	1	1	1	9
OG0010642	2	2	1	1	1	1	1	9
OG0010643	1	3	1	1	1	1	1	9
OG0010644	2	2	1	1	1	1	1	9
OG0010645	2	3	1	1	1	1	0	9
OG0010646	1	2	1	1	1	1	2	9
OG0010647	2	2	1	1	1	1	1	9
OG0010648	2	4	1	0	1	0	1	9
OG0010649	2	3	1	1	1	0	1	9
OG0010650	1	3	1	1	1	1	1	9
OG0010651	2	2	2	0	0	2	1	9
OG0010652	2	2	1	1	1	1	1	9
OG0010653	2	2	1	1	1	1	1	9
OG0010654	3	3	1	0	0	1	1	9
OG0010655	2	2	1	1	1	1	1	9
OG0010656	1	3	1	1	1	1	1	9
OG0010657	2	3	1	1	0	1	1	9
OG0010658	3	1	1	1	1	1	1	9
OG0010659	2	2	1	1	1	1	1	9
OG0010660	2	3	1	0	1	1	1	9
OG0010661	1	5	0	1	0	1	1	9
OG0010662	2	2	1	1	1	0	2	9
OG0010663	2	2	1	1	1	1	1	9
OG0010664	2	2	1	1	1	1	1	9
OG0010665	1	3	1	1	1	1	1	9
OG0010666	1	3	1	1	1	1	1	9
OG0010667	1	3	1	1	1	1	1	9
OG0010668	1	3	1	1	1	1	1	9
OG0010669	1	3	1	1	1	1	1	9
OG0010670	3	1	1	1	1	1	1	9
OG0010671	2	3	1	1	0	1	1	9
OG0010672	3	1	1	1	1	1	1	9
OG0010673	2	2	1	1	1	1	1	9
OG0010674	2	2	1	1	1	1	1	9
OG0010675	3	3	1	1	1	0	0	9
OG0010676	2	2	1	1	1	1	1	9
OG0010677	1	3	1	1	1	1	1	9
OG0010678	1	3	1	1	1	1	1	9
OG0010679	6	0	0	0	0	3	0	9
OG0010680	2	3	1	1	1	0	1	9
OG0010681	2	2	1	1	1	1	1	9
OG0010682	2	3	1	1	0	1	1	9
OG0010683	2	2	1	1	1	1	1	9
OG0010684	2	2	1	1	1	1	1	9
OG0010685	1	3	1	1	1	1	1	9
OG0010686	2	3	1	1	0	1	1	9
OG0010687	3	0	1	1	2	1	1	9
OG0010688	2	2	1	1	1	1	1	9
OG0010689	3	1	1	1	1	1	1	9
OG0010690	1	3	1	1	1	1	1	9
OG0010691	2	2	1	1	1	1	1	9
OG0010692	2	3	2	0	1	1	0	9
OG0010693	1	3	1	1	1	1	1	9
OG0010694	2	2	1	1	1	1	1	9
OG0010695	2	2	1	1	1	1	1	9
OG0010696	2	2	1	1	1	1	1	9
OG0010697	2	4	1	0	1	0	1	9
OG0010698	2	1	2	1	1	1	1	9
OG0010699	2	2	1	1	1	1	1	9
OG0010700	2	2	1	1	1	1	1	9
OG0010701	2	3	1	1	0	1	1	9
OG0010702	2	2	1	1	1	1	1	9
OG0010703	2	2	1	1	1	1	1	9
OG0010704	1	3	1	1	1	1	1	9
OG0010705	1	3	1	1	1	1	1	9
OG0010706	9	0	0	0	0	0	0	9
OG0010707	2	2	1	1	1	1	1	9
OG0010708	1	3	1	1	1	1	1	9
OG0010709	1	4	1	0	1	1	1	9
OG0010710	2	3	1	1	1	1	0	9
OG0010711	2	2	1	1	1	1	1	9
OG0010712	2	2	1	1	1	1	1	9
OG0010713	2	2	1	1	1	1	1	9
OG0010714	3	1	1	1	1	1	1	9
OG0010715	2	2	1	1	1	1	1	9
OG0010716	2	2	1	1	1	1	1	9
OG0010717	1	3	1	1	1	1	1	9
OG0010718	2	2	1	1	1	1	1	9
OG0010719	1	2	2	1	1	1	1	9
OG0010720	2	2	1	1	1	1	1	9
OG0010721	1	3	1	1	1	1	1	9
OG0010722	2	3	1	1	1	0	1	9
OG0010723	9	0	0	0	0	0	0	9
OG0010724	2	3	1	1	0	1	1	9
OG0010725	2	3	1	1	1	0	1	9
OG0010726	1	3	1	1	1	1	1	9
OG0010727	2	2	1	1	1	1	1	9
OG0010728	8	0	0	0	0	0	1	9
OG0010729	2	3	1	1	0	1	1	9
OG0010730	2	1	1	1	1	2	1	9
OG0010731	2	2	1	1	1	1	1	9
OG0010732	2	2	1	1	1	1	1	9
OG0010733	2	2	1	1	1	1	1	9
OG0010734	9	0	0	0	0	0	0	9
OG0010735	2	3	1	1	0	1	1	9
OG0010736	2	2	1	1	1	1	1	9
OG0010737	2	2	1	1	1	1	1	9
OG0010738	2	2	1	1	1	1	1	9
OG0010739	1	2	1	1	1	1	2	9
OG0010740	1	3	1	1	1	1	1	9
OG0010741	1	3	1	1	1	1	1	9
OG0010742	2	2	1	1	1	1	1	9
OG0010743	1	3	1	1	1	1	1	9
OG0010744	2	2	1	1	1	1	1	9
OG0010745	2	2	1	1	1	1	1	9
OG0010746	2	2	1	1	1	1	1	9
OG0010747	2	2	1	1	1	1	1	9
OG0010748	3	1	1	1	1	1	1	9
OG0010749	1	3	1	1	1	1	1	9
OG0010750	2	2	1	1	1	1	1	9
OG0010751	9	0	0	0	0	0	0	9
OG0010752	2	3	1	0	1	1	1	9
OG0010753	1	3	1	1	1	1	1	9
OG0010754	2	2	1	1	1	1	1	9
OG0010755	2	2	1	1	1	1	1	9
OG0010756	1	3	1	1	1	1	1	9
OG0010757	2	2	1	1	1	1	1	9
OG0010758	1	3	1	1	1	1	1	9
OG0010759	3	2	1	1	1	0	1	9
OG0010760	2	2	1	1	1	1	1	9
OG0010761	9	0	0	0	0	0	0	9
OG0010762	2	2	1	1	1	1	1	9
OG0010763	2	2	1	1	1	1	1	9
OG0010764	2	2	1	1	1	1	1	9
OG0010765	2	2	1	1	1	1	1	9
OG0010766	2	2	1	1	1	1	1	9
OG0010767	2	2	1	1	1	1	1	9
OG0010768	2	2	1	1	1	1	1	9
OG0010769	1	3	1	1	1	1	1	9
OG0010770	2	2	1	1	1	1	1	9
OG0010771	2	3	1	1	1	0	1	9
OG0010772	1	3	1	1	1	1	1	9
OG0010773	2	2	1	1	1	1	1	9
OG0010774	2	2	1	1	1	1	1	9
OG0010775	2	2	1	1	1	1	1	9
OG0010776	2	2	1	1	1	1	1	9
OG0010777	9	0	0	0	0	0	0	9
OG0010778	2	1	1	0	3	2	0	9
OG0010779	2	3	1	1	1	0	1	9
OG0010780	1	4	1	1	1	0	1	9
OG0010781	2	2	1	1	1	1	1	9
OG0010782	1	3	1	1	1	1	1	9
OG0010783	1	3	1	1	1	1	1	9
OG0010784	2	2	1	1	1	1	1	9
OG0010785	2	2	1	1	1	1	1	9
OG0010786	2	2	1	1	1	1	1	9
OG0010787	2	2	1	1	1	1	1	9
OG0010788	2	1	1	1	1	1	2	9
OG0010789	2	2	1	2	1	0	1	9
OG0010790	1	3	1	1	1	1	1	9
OG0010791	2	2	1	1	1	1	1	9
OG0010792	1	3	1	1	1	1	1	9
OG0010793	2	3	1	1	1	0	1	9
OG0010794	2	2	1	1	1	1	1	9
OG0010795	2	2	1	1	1	1	1	9
OG0010796	1	3	1	1	1	1	1	9
OG0010797	2	2	1	1	1	1	1	9
OG0010798	1	3	1	1	1	1	1	9
OG0010799	2	3	1	1	1	1	0	9
OG0010800	2	2	1	1	1	1	1	9
OG0010801	2	2	1	1	1	1	1	9
OG0010802	2	2	1	1	1	1	1	9
OG0010803	1	3	1	1	1	1	1	9
OG0010804	9	0	0	0	0	0	0	9
OG0010805	2	2	1	1	1	1	1	9
OG0010806	1	3	1	1	1	1	1	9
OG0010807	2	3	1	1	1	1	0	9
OG0010808	2	2	1	1	1	1	1	9
OG0010809	1	3	1	1	1	1	1	9
OG0010810	1	3	1	1	1	1	1	9
OG0010811	1	3	1	1	1	1	1	9
OG0010812	1	3	1	1	1	1	1	9
OG0010813	2	2	1	1	0	0	3	9
OG0010814	2	3	1	1	1	1	0	9
OG0010815	2	2	1	1	1	1	1	9
OG0010816	2	2	1	1	1	1	1	9
OG0010817	2	3	1	1	0	1	1	9
OG0010818	3	1	1	1	1	1	1	9
OG0010819	2	2	1	1	1	1	1	9
OG0010820	2	2	1	1	1	1	1	9
OG0010821	2	3	1	0	1	1	1	9
OG0010822	1	3	1	1	1	1	1	9
OG0010823	2	3	1	1	1	1	0	9
OG0010824	2	2	1	1	1	1	1	9
OG0010825	2	2	1	1	1	1	1	9
OG0010826	1	3	2	0	1	1	1	9
OG0010827	1	3	1	1	1	1	1	9
OG0010828	1	3	1	1	1	1	1	9
OG0010829	1	2	1	1	1	1	2	9
OG0010830	2	2	1	1	1	1	1	9
OG0010831	2	5	1	0	0	0	1	9
OG0010832	9	0	0	0	0	0	0	9
OG0010833	2	2	1	1	1	1	1	9
OG0010834	2	2	1	1	1	1	1	9
OG0010835	3	3	1	1	0	0	1	9
OG0010836	2	3	1	1	1	1	0	9
OG0010837	2	3	1	1	0	1	1	9
OG0010838	2	2	1	1	1	1	1	9
OG0010839	2	2	1	1	1	1	1	9
OG0010840	2	2	1	1	1	1	1	9
OG0010841	2	2	1	1	1	1	1	9
OG0010842	2	2	1	1	1	1	1	9
OG0010843	2	1	2	1	1	1	1	9
OG0010844	2	2	1	1	1	1	1	9
OG0010845	2	2	1	1	1	1	1	9
OG0010846	2	2	1	1	1	1	1	9
OG0010847	9	0	0	0	0	0	0	9
OG0010848	2	2	1	1	1	1	1	9
OG0010849	2	2	1	1	1	1	1	9
OG0010850	2	2	1	1	1	1	1	9
OG0010851	2	1	1	1	1	2	1	9
OG0010852	2	2	1	1	1	1	1	9
OG0010853	2	2	1	1	1	1	1	9
OG0010854	1	3	1	1	1	1	1	9
OG0010855	2	2	1	1	1	1	1	9
OG0010856	2	2	1	1	1	1	1	9
OG0010857	2	3	1	1	1	0	1	9
OG0010858	2	3	1	1	1	1	0	9
OG0010859	2	2	1	1	1	1	1	9
OG0010860	5	1	0	1	1	0	1	9
OG0010861	2	2	1	1	1	1	1	9
OG0010862	2	3	1	1	1	0	1	9
OG0010863	1	3	1	1	1	1	1	9
OG0010864	2	1	1	1	2	1	1	9
OG0010865	2	2	1	1	1	1	1	9
OG0010866	2	2	1	1	1	1	1	9
OG0010867	2	2	1	1	1	1	1	9
OG0010868	2	2	1	1	1	1	1	9
OG0010869	9	0	0	0	0	0	0	9
OG0010870	2	2	1	1	1	1	1	9
OG0010871	2	2	1	1	1	1	1	9
OG0010872	3	1	1	1	1	1	1	9
OG0010873	2	3	1	1	1	0	1	9
OG0010874	3	2	1	1	1	0	1	9
OG0010875	2	3	1	1	0	1	1	9
OG0010876	2	2	1	1	1	1	1	9
OG0010877	1	3	1	1	1	1	1	9
OG0010878	9	0	0	0	0	0	0	9
OG0010879	1	3	1	1	1	1	1	9
OG0010880	9	0	0	0	0	0	0	9
OG0010881	2	2	1	1	1	1	1	9
OG0010882	2	2	1	1	1	1	1	9
OG0010883	1	3	1	1	1	1	1	9
OG0010884	1	3	1	1	1	1	1	9
OG0010885	2	2	1	2	1	0	1	9
OG0010886	1	3	1	1	1	1	1	9
OG0010887	2	3	1	1	1	0	1	9
OG0010888	1	3	1	1	1	1	1	9
OG0010889	1	3	1	1	1	1	1	9
OG0010890	2	2	1	1	1	1	1	9
OG0010891	1	3	1	1	1	1	1	9
OG0010892	9	0	0	0	0	0	0	9
OG0010893	2	0	1	1	2	1	2	9
OG0010894	2	2	1	1	1	1	1	9
OG0010895	2	2	1	1	1	1	1	9
OG0010896	1	3	1	1	1	1	1	9
OG0010897	2	2	1	1	1	1	1	9
OG0010898	2	3	1	1	1	0	1	9
OG0010899	2	3	1	1	1	1	0	9
OG0010900	2	2	1	1	1	1	1	9
OG0010901	2	2	1	1	1	1	1	9
OG0010902	2	2	1	1	1	1	1	9
OG0010903	2	2	1	1	1	1	1	9
OG0010904	2	3	1	0	1	1	1	9
OG0010905	1	3	1	1	1	1	1	9
OG0010906	2	2	1	1	1	1	1	9
OG0010907	2	4	0	0	1	1	1	9
OG0010908	2	2	1	1	1	1	1	9
OG0010909	2	2	1	1	1	1	1	9
OG0010910	2	2	1	1	1	1	1	9
OG0010911	2	2	1	1	1	0	2	9
OG0010912	2	2	1	1	1	1	1	9
OG0010913	1	3	1	1	1	1	1	9
OG0010914	2	3	1	1	1	0	1	9
OG0010915	2	2	1	1	1	1	1	9
OG0010916	2	2	1	1	1	1	1	9
OG0010917	2	2	1	1	1	1	1	9
OG0010918	1	3	1	1	1	1	1	9
OG0010919	2	3	1	1	1	1	0	9
OG0010920	2	2	1	1	1	1	1	9
OG0010921	3	1	1	1	1	1	1	9
OG0010922	1	3	1	1	1	0	2	9
OG0010923	2	2	1	1	1	1	1	9
OG0010924	2	2	1	1	1	1	1	9
OG0010925	2	2	1	1	1	1	1	9
OG0010926	2	2	1	1	1	1	1	9
OG0010927	2	3	1	1	1	1	0	9
OG0010928	1	3	1	1	1	1	1	9
OG0010929	2	2	1	1	1	1	1	9
OG0010930	2	2	1	1	1	1	1	9
OG0010931	2	2	1	1	1	1	1	9
OG0010932	1	3	1	1	1	1	1	9
OG0010933	1	3	1	1	1	1	1	9
OG0010934	2	2	1	1	1	1	1	9
OG0010935	3	1	1	1	1	1	1	9
OG0010936	2	3	1	1	1	0	1	9
OG0010937	2	2	1	1	1	1	1	9
OG0010938	3	1	1	1	1	1	1	9
OG0010939	2	2	1	1	1	1	1	9
OG0010940	3	1	1	1	1	1	1	9
OG0010941	1	2	2	1	1	1	1	9
OG0010942	2	2	1	1	1	1	1	9
OG0010943	2	2	1	1	1	1	1	9
OG0010944	2	2	1	1	1	1	1	9
OG0010945	1	3	1	1	0	1	2	9
OG0010946	2	2	1	1	1	1	1	9
OG0010947	2	2	1	1	1	1	1	9
OG0010948	2	2	1	1	1	1	1	9
OG0010949	1	3	1	1	1	1	1	9
OG0010950	2	2	1	1	1	1	1	9
OG0010951	2	2	1	1	1	1	1	9
OG0010952	2	2	1	1	1	1	1	9
OG0010953	1	2	1	1	1	2	1	9
OG0010954	3	1	1	1	1	1	1	9
OG0010955	1	3	1	1	1	1	1	9
OG0010956	2	3	1	1	1	0	1	9
OG0010957	2	2	1	1	1	1	1	9
OG0010958	2	3	1	1	1	0	1	9
OG0010959	2	3	1	1	1	1	0	9
OG0010960	2	2	1	1	1	1	1	9
OG0010961	2	2	1	1	1	1	1	9
OG0010962	2	1	1	2	1	1	1	9
OG0010963	1	3	1	1	1	1	1	9
OG0010964	1	3	1	1	1	1	1	9
OG0010965	1	3	1	1	1	1	1	9
OG0010966	1	4	1	1	1	0	1	9
OG0010967	2	2	1	1	1	1	1	9
OG0010968	2	3	1	1	1	0	1	9
OG0010969	2	2	1	1	1	1	1	9
OG0010970	2	3	1	1	0	1	1	9
OG0010971	1	3	1	1	1	1	1	9
OG0010972	2	2	1	1	1	1	1	9
OG0010973	2	2	1	1	1	1	1	9
OG0010974	1	3	1	1	1	1	1	9
OG0010975	1	3	1	1	1	1	1	9
OG0010976	2	2	1	1	1	1	1	9
OG0010977	2	3	1	0	1	1	1	9
OG0010978	2	3	1	1	1	1	0	9
OG0010979	2	2	1	1	1	1	1	9
OG0010980	2	2	1	1	1	1	1	9
OG0010981	9	0	0	0	0	0	0	9
OG0010982	2	2	1	1	1	1	1	9
OG0010983	2	2	1	1	1	1	1	9
OG0010984	2	2	1	1	1	1	1	9
OG0010985	9	0	0	0	0	0	0	9
OG0010986	2	2	1	1	1	1	1	9
OG0010987	2	2	1	1	1	1	1	9
OG0010988	2	2	1	1	1	1	1	9
OG0010989	1	3	1	1	1	1	1	9
OG0010990	1	3	1	1	1	1	1	9
OG0010991	1	3	1	1	1	1	1	9
OG0010992	2	3	1	1	0	1	1	9
OG0010993	2	2	1	1	1	1	1	9
OG0010994	1	3	1	1	1	1	1	9
OG0010995	2	2	1	1	1	1	1	9
OG0010996	1	2	2	1	0	2	1	9
OG0010997	2	2	1	1	1	1	1	9
OG0010998	2	2	1	1	1	1	1	9
OG0010999	2	2	1	1	1	1	1	9
OG0011000	2	2	1	1	1	1	1	9
OG0011001	2	2	1	1	1	1	1	9
OG0011002	3	1	1	1	1	1	1	9
OG0011003	1	3	1	1	1	1	1	9
OG0011004	2	2	1	1	1	1	1	9
OG0011005	2	2	1	1	1	1	1	9
OG0011006	2	1	1	1	1	1	2	9
OG0011007	3	2	1	1	1	0	1	9
OG0011008	2	2	1	1	1	1	1	9
OG0011009	2	2	1	1	1	1	1	9
OG0011010	1	3	1	1	1	1	1	9
OG0011011	1	2	2	1	1	0	2	9
OG0011012	9	0	0	0	0	0	0	9
OG0011013	2	3	1	1	1	1	0	9
OG0011014	9	0	0	0	0	0	0	9
OG0011015	1	3	1	1	1	1	1	9
OG0011016	2	2	1	1	1	1	1	9
OG0011017	2	3	1	0	1	1	1	9
OG0011018	3	1	1	1	1	1	1	9
OG0011019	1	3	1	1	1	1	1	9
OG0011020	2	2	1	1	1	1	1	9
OG0011021	2	2	1	1	1	1	1	9
OG0011022	2	3	1	1	1	0	1	9
OG0011023	1	3	1	1	1	1	1	9
OG0011024	2	2	1	1	1	1	1	9
OG0011025	2	2	1	1	1	1	1	9
OG0011026	2	3	1	1	0	1	1	9
OG0011027	8	0	0	0	0	1	0	9
OG0011028	1	3	1	1	1	1	1	9
OG0011029	2	2	1	1	1	1	1	9
OG0011030	1	2	1	1	1	1	2	9
OG0011031	2	2	1	1	1	1	1	9
OG0011032	2	2	1	1	1	1	1	9
OG0011033	1	3	1	1	1	1	1	9
OG0011034	2	2	1	1	1	1	1	9
OG0011035	2	3	1	1	1	1	0	9
OG0011036	2	2	1	1	1	1	1	9
OG0011037	1	3	1	1	1	1	1	9
OG0011038	1	3	1	1	1	1	1	9
OG0011039	2	2	1	1	1	1	1	9
OG0011040	2	2	1	1	1	1	1	9
OG0011041	2	2	1	1	1	1	1	9
OG0011042	2	2	1	1	1	1	1	9
OG0011043	2	2	1	1	1	1	1	9
OG0011044	1	3	1	1	1	1	1	9
OG0011045	1	3	1	1	1	1	1	9
OG0011046	1	3	1	1	1	1	1	9
OG0011047	1	4	1	1	1	1	0	9
OG0011048	2	2	1	1	1	1	1	9
OG0011049	2	3	1	1	0	1	1	9
OG0011050	3	0	4	0	0	0	2	9
OG0011051	2	2	1	1	1	1	1	9
OG0011052	1	3	1	1	1	1	1	9
OG0011053	1	3	1	1	1	1	1	9
OG0011054	2	1	1	1	1	1	2	9
OG0011055	1	3	1	1	1	1	1	9
OG0011056	2	3	1	1	1	0	1	9
OG0011057	2	2	1	1	1	1	1	9
OG0011058	2	2	1	1	1	1	1	9
OG0011059	2	2	1	1	1	1	1	9
OG0011060	3	1	1	1	1	1	1	9
OG0011061	1	3	1	1	1	1	1	9
OG0011062	3	2	1	1	1	1	0	9
OG0011063	2	2	1	1	1	1	1	9
OG0011064	2	2	1	1	1	1	1	9
OG0011065	2	2	1	1	1	1	1	9
OG0011066	1	3	1	1	1	1	1	9
OG0011067	2	2	1	1	1	1	1	9
OG0011068	1	4	1	1	0	1	1	9
OG0011069	1	3	1	1	1	1	1	9
OG0011070	1	4	1	1	1	1	0	9
OG0011071	2	2	1	1	1	1	1	9
OG0011072	1	3	1	1	1	1	1	9
OG0011073	2	2	1	1	1	1	1	9
OG0011074	2	2	1	1	1	1	1	9
OG0011075	2	3	1	0	1	1	1	9
OG0011076	2	2	1	1	1	1	1	9
OG0011077	1	3	1	1	1	1	1	9
OG0011078	1	3	1	1	1	1	1	9
OG0011079	2	2	1	1	1	1	1	9
OG0011080	2	2	1	1	1	1	1	9
OG0011081	1	3	1	1	1	1	1	9
OG0011082	2	1	1	1	1	1	2	9
OG0011083	2	2	1	1	1	1	1	9
OG0011084	2	2	1	1	1	1	1	9
OG0011085	2	2	1	1	1	1	1	9
OG0011086	1	3	1	1	1	1	1	9
OG0011087	1	3	1	1	1	1	1	9
OG0011088	3	1	1	1	1	1	1	9
OG0011089	2	2	1	1	1	1	1	9
OG0011090	1	2	1	1	1	2	1	9
OG0011091	3	1	1	1	1	1	1	9
OG0011092	2	2	1	1	1	1	1	9
OG0011093	1	3	1	1	1	1	1	9
OG0011094	2	2	1	1	1	1	1	9
OG0011095	1	3	1	1	1	1	1	9
OG0011096	1	3	1	1	1	1	1	9
OG0011097	2	3	1	1	1	0	1	9
OG0011098	2	2	1	1	1	1	1	9
OG0011099	2	2	1	1	1	1	1	9
OG0011100	1	3	1	1	1	1	1	9
OG0011101	2	2	1	1	1	1	1	9
OG0011102	2	0	2	2	2	0	1	9
OG0011103	2	3	1	1	1	0	1	9
OG0011104	2	2	1	1	1	1	1	9
OG0011105	2	3	1	1	1	0	1	9
OG0011106	2	3	1	1	1	0	1	9
OG0011107	1	3	1	1	1	1	1	9
OG0011108	1	3	1	1	1	1	1	9
OG0011109	1	4	1	0	1	1	1	9
OG0011110	2	3	1	1	1	0	1	9
OG0011111	1	3	2	1	1	1	0	9
OG0011112	1	3	1	1	1	1	1	9
OG0011113	2	2	1	1	1	1	1	9
OG0011114	2	2	1	1	1	1	1	9
OG0011115	2	2	1	1	1	1	1	9
OG0011116	3	1	1	1	1	1	1	9
OG0011117	1	3	1	1	1	1	1	9
OG0011118	2	2	1	1	1	1	1	9
OG0011119	2	2	1	1	1	1	1	9
OG0011120	3	1	1	1	1	1	1	9
OG0011121	2	2	1	1	1	1	1	9
OG0011122	1	3	1	1	1	1	1	9
OG0011123	1	3	1	1	1	1	1	9
OG0011124	2	2	1	1	1	1	1	9
OG0011125	2	2	1	1	1	1	1	9
OG0011126	3	3	1	0	0	1	1	9
OG0011127	2	2	1	1	1	1	1	9
OG0011128	2	2	1	1	1	1	1	9
OG0011129	3	2	1	1	1	1	0	9
OG0011130	2	2	3	1	0	0	1	9
OG0011131	1	3	1	0	0	2	2	9
OG0011132	1	3	1	1	1	1	1	9
OG0011133	1	3	1	1	1	1	1	9
OG0011134	2	2	1	1	1	1	1	9
OG0011135	4	2	0	2	0	1	0	9
OG0011136	2	2	1	1	1	1	1	9
OG0011137	2	3	1	0	1	1	1	9
OG0011138	2	3	1	1	1	0	1	9
OG0011139	2	2	1	0	1	1	2	9
OG0011140	2	2	1	1	1	1	1	9
OG0011141	2	2	1	1	1	1	1	9
OG0011142	2	2	1	1	1	1	1	9
OG0011143	3	3	1	0	1	0	1	9
OG0011144	2	3	1	1	1	1	0	9
OG0011145	1	3	1	1	1	1	1	9
OG0011146	2	3	1	1	1	0	1	9
OG0011147	2	2	1	1	1	1	1	9
OG0011148	3	1	1	1	1	1	1	9
OG0011149	1	3	1	1	1	1	1	9
OG0011150	2	2	1	1	1	1	1	9
OG0011151	1	4	1	1	1	0	1	9
OG0011152	2	2	1	1	1	1	1	9
OG0011153	1	3	1	1	1	1	1	9
OG0011154	2	2	1	1	1	1	1	9
OG0011155	1	3	1	2	1	0	1	9
OG0011156	2	2	1	1	1	1	1	9
OG0011157	2	2	1	1	1	1	1	9
OG0011158	2	2	1	1	1	1	1	9
OG0011159	2	2	1	1	1	1	1	9
OG0011160	1	3	1	1	1	1	1	9
OG0011161	2	2	1	1	1	1	1	9
OG0011162	3	2	1	1	1	0	1	9
OG0011163	2	2	1	1	1	1	1	9
OG0011164	1	3	1	1	1	1	1	9
OG0011165	2	2	1	1	1	1	1	9
OG0011166	2	2	1	1	1	1	1	9
OG0011167	2	2	1	1	1	1	1	9
OG0011168	2	3	1	1	1	0	1	9
OG0011169	2	3	1	1	1	1	0	9
OG0011170	1	2	1	1	2	1	1	9
OG0011171	2	2	1	1	1	1	1	9
OG0011172	2	3	1	1	1	1	0	9
OG0011173	3	1	1	1	1	1	1	9
OG0011174	2	2	1	1	1	1	1	9
OG0011175	2	2	1	1	1	1	1	9
OG0011176	1	4	1	1	1	1	0	9
OG0011177	1	3	1	1	1	1	1	9
OG0011178	2	2	1	1	1	1	1	9
OG0011179	3	0	1	2	1	1	1	9
OG0011180	2	4	1	0	1	0	1	9
OG0011181	2	2	1	1	1	1	1	9
OG0011182	2	2	1	0	2	1	1	9
OG0011183	1	3	1	1	1	1	1	9
OG0011184	2	3	1	1	1	0	1	9
OG0011185	2	2	1	1	1	1	1	9
OG0011186	3	1	1	1	1	1	1	9
OG0011187	2	2	1	1	1	1	1	9
OG0011188	2	2	1	1	1	1	1	9
OG0011189	2	2	1	1	1	1	1	9
OG0011190	1	3	1	1	1	1	1	9
OG0011191	2	3	1	1	1	1	0	9
OG0011192	2	2	1	1	1	1	1	9
OG0011193	2	3	1	1	0	1	1	9
OG0011194	2	2	1	1	1	1	1	9
OG0011195	2	2	1	1	1	1	1	9
OG0011196	2	2	1	1	1	1	1	9
OG0011197	2	3	1	1	1	1	0	9
OG0011198	2	2	1	1	1	1	1	9
OG0011199	1	3	1	1	1	1	1	9
OG0011200	1	3	1	1	1	1	1	9
OG0011201	1	3	1	1	1	1	1	9
OG0011202	2	2	1	1	1	1	1	9
OG0011203	2	3	1	1	0	1	1	9
OG0011204	2	2	1	1	1	1	1	9
OG0011205	2	2	1	1	1	1	1	9
OG0011206	3	3	0	2	0	0	1	9
OG0011207	2	2	1	1	1	1	1	9
OG0011208	1	3	1	1	1	1	1	9
OG0011209	2	2	1	1	1	1	1	9
OG0011210	1	3	1	1	1	1	1	9
OG0011211	1	3	0	2	1	1	1	9
OG0011212	2	2	1	1	1	1	1	9
OG0011213	1	3	1	1	1	1	1	9
OG0011214	2	4	1	1	0	1	0	9
OG0011215	2	2	1	1	1	1	1	9
OG0011216	3	2	1	1	1	0	1	9
OG0011217	1	3	1	1	1	1	1	9
OG0011218	2	2	1	1	1	1	1	9
OG0011219	1	3	1	1	1	1	1	9
OG0011220	2	3	1	1	1	0	1	9
OG0011221	2	2	1	1	1	1	1	9
OG0011222	2	2	1	1	1	1	1	9
OG0011223	2	2	1	1	1	0	2	9
OG0011224	1	3	1	1	1	1	1	9
OG0011225	1	3	1	1	1	1	1	9
OG0011226	3	1	1	1	1	1	1	9
OG0011227	2	1	1	1	1	1	2	9
OG0011228	2	1	1	1	1	2	1	9
OG0011229	3	3	1	0	1	0	1	9
OG0011230	2	2	1	1	1	1	1	9
OG0011231	2	2	1	1	1	1	1	9
OG0011232	2	3	1	1	1	0	1	9
OG0011233	2	2	1	1	1	1	1	9
OG0011234	2	3	1	1	1	1	0	9
OG0011235	2	2	1	1	1	1	1	9
OG0011236	2	2	1	1	1	1	1	9
OG0011237	2	2	1	1	2	0	1	9
OG0011238	1	4	1	0	1	1	1	9
OG0011239	2	2	1	1	1	1	1	9
OG0011240	1	1	2	2	0	2	1	9
OG0011241	2	2	1	1	1	1	1	9
OG0011242	2	2	1	1	1	1	1	9
OG0011243	2	2	1	1	1	1	1	9
OG0011244	1	3	1	1	1	1	1	9
OG0011245	2	2	1	1	1	1	1	9
OG0011246	1	1	1	1	1	1	3	9
OG0011247	3	2	1	0	1	0	2	9
OG0011248	1	2	1	1	1	1	2	9
OG0011249	1	3	1	1	1	1	1	9
OG0011250	1	3	1	1	1	1	1	9
OG0011251	2	2	1	1	1	1	1	9
OG0011252	2	2	1	1	1	1	1	9
OG0011253	3	1	1	1	1	1	1	9
OG0011254	2	2	1	1	1	1	1	9
OG0011255	2	2	1	1	1	1	1	9
OG0011256	1	3	1	1	1	1	1	9
OG0011257	2	2	1	1	1	1	1	9
OG0011258	3	1	1	1	1	1	1	9
OG0011259	2	2	1	1	1	1	1	9
OG0011260	3	1	1	1	1	1	1	9
OG0011261	2	2	1	1	1	1	1	9
OG0011262	2	2	1	1	1	1	1	9
OG0011263	2	2	1	1	1	1	1	9
OG0011264	1	3	1	1	1	1	1	9
OG0011265	3	0	1	2	1	1	1	9
OG0011266	1	3	1	1	1	1	1	9
OG0011267	2	2	1	1	1	1	1	9
OG0011268	2	2	1	1	1	1	1	9
OG0011269	2	2	1	1	1	1	1	9
OG0011270	2	3	1	1	1	1	0	9
OG0011271	2	2	1	1	1	1	1	9
OG0011272	2	2	1	1	1	1	1	9
OG0011273	2	2	1	1	1	1	1	9
OG0011274	2	3	1	0	1	1	1	9
OG0011275	2	3	1	1	1	1	0	9
OG0011276	2	3	1	1	1	1	0	9
OG0011277	2	2	1	1	1	1	1	9
OG0011278	2	2	1	1	1	1	1	9
OG0011279	2	2	5	0	0	0	0	9
OG0011280	2	2	1	1	1	1	1	9
OG0011281	2	2	1	1	1	1	1	9
OG0011282	1	3	1	1	1	1	1	9
OG0011283	2	2	1	1	1	1	1	9
OG0011284	3	2	1	1	1	0	1	9
OG0011285	1	3	1	1	1	1	1	9
OG0011286	1	3	1	1	1	1	1	9
OG0011287	2	2	1	1	1	1	1	9
OG0011288	1	2	2	1	1	1	1	9
OG0011289	2	2	1	1	1	1	1	9
OG0011290	2	2	1	1	1	1	1	9
OG0011291	1	3	1	1	1	1	1	9
OG0011292	1	4	1	1	1	0	1	9
OG0011293	2	2	1	1	1	1	1	9
OG0011294	2	2	1	1	1	1	1	9
OG0011295	1	3	1	1	1	1	1	9
OG0011296	1	4	1	1	1	0	1	9
OG0011297	2	3	0	1	1	1	1	9
OG0011298	8	1	0	0	0	0	0	9
OG0011299	1	3	1	1	1	1	1	9
OG0011300	1	4	1	0	1	1	1	9
OG0011301	2	1	1	1	1	2	1	9
OG0011302	2	2	1	1	1	1	1	9
OG0011303	2	3	1	1	1	0	1	9
OG0011304	2	2	1	1	1	1	1	9
OG0011305	2	2	1	1	2	0	1	9
OG0011306	2	2	2	1	1	0	1	9
OG0011307	2	3	1	1	1	0	1	9
OG0011308	2	2	1	1	1	1	1	9
OG0011309	1	3	1	1	1	1	1	9
OG0011310	2	2	1	1	1	1	1	9
OG0011311	1	3	1	1	1	1	1	9
OG0011312	2	3	1	1	1	1	0	9
OG0011313	1	3	1	1	1	1	1	9
OG0011314	1	3	1	1	1	1	1	9
OG0011315	1	3	1	1	1	1	1	9
OG0011316	1	2	1	1	1	1	2	9
OG0011317	1	3	1	1	1	1	1	9
OG0011318	2	3	1	1	1	0	1	9
OG0011319	2	2	1	1	1	1	1	9
OG0011320	2	2	1	1	1	1	1	9
OG0011321	1	3	1	1	1	1	1	9
OG0011322	2	2	1	1	1	1	1	9
OG0011323	2	3	1	0	1	1	1	9
OG0011324	2	2	1	1	1	1	1	9
OG0011325	2	2	1	1	1	1	1	9
OG0011326	1	2	1	1	1	1	2	9
OG0011327	2	3	1	0	0	1	2	9
OG0011328	2	2	1	1	1	1	1	9
OG0011329	2	2	1	1	1	1	1	9
OG0011330	2	2	1	1	1	1	1	9
OG0011331	1	3	1	1	1	1	1	9
OG0011332	2	3	1	1	1	1	0	9
OG0011333	3	1	1	1	1	1	1	9
OG0011334	2	2	1	1	1	1	1	9
OG0011335	2	3	1	1	1	1	0	9
OG0011336	3	1	1	1	1	1	1	9
OG0011337	2	2	1	1	1	1	1	9
OG0011338	2	2	1	1	1	1	1	9
OG0011339	2	2	1	1	1	1	1	9
OG0011340	1	3	1	1	1	1	1	9
OG0011341	2	4	1	0	1	0	1	9
OG0011342	1	4	1	1	1	0	1	9
OG0011343	3	2	1	0	1	1	1	9
OG0011344	1	4	1	1	1	0	1	9
OG0011345	3	2	1	1	0	1	1	9
OG0011346	1	3	1	1	1	1	1	9
OG0011347	2	2	1	1	1	1	1	9
OG0011348	2	2	1	1	1	1	1	9
OG0011349	2	3	1	0	1	1	1	9
OG0011350	2	3	1	1	0	1	1	9
OG0011351	2	2	1	1	1	1	1	9
OG0011352	1	3	1	1	1	1	1	9
OG0011353	2	3	1	1	1	0	1	9
OG0011354	2	2	1	1	1	1	1	9
OG0011355	1	3	1	1	1	1	1	9
OG0011356	2	2	1	1	1	1	1	9
OG0011357	2	3	1	1	1	1	0	9
OG0011358	2	2	1	1	1	1	1	9
OG0011359	2	3	1	1	1	1	0	9
OG0011360	2	2	1	1	1	1	1	9
OG0011361	1	5	1	1	0	1	0	9
OG0011362	2	2	1	1	1	1	1	9
OG0011363	2	2	1	1	1	1	1	9
OG0011364	2	2	1	1	1	1	1	9
OG0011365	2	2	1	1	1	1	1	9
OG0011366	2	2	1	1	1	1	1	9
OG0011367	2	2	1	1	1	1	1	9
OG0011368	3	3	1	0	1	0	1	9
OG0011369	2	2	1	1	1	1	1	9
OG0011370	1	3	1	1	1	1	1	9
OG0011371	2	2	1	1	1	1	1	9
OG0011372	1	3	1	1	1	1	1	9
OG0011373	2	3	1	1	1	0	1	9
OG0011374	2	2	1	1	1	1	1	9
OG0011375	1	3	1	1	1	1	1	9
OG0011376	1	3	1	1	1	1	1	9
OG0011377	2	2	1	1	1	1	1	9
OG0011378	1	3	1	1	1	1	1	9
OG0011379	1	3	1	1	1	1	1	9
OG0011380	2	2	1	1	1	1	1	9
OG0011381	1	3	1	1	1	1	1	9
OG0011382	1	3	1	1	1	0	2	9
OG0011383	2	2	1	1	1	1	1	9
OG0011384	1	4	1	1	1	0	1	9
OG0011385	2	2	1	1	1	1	1	9
OG0011386	2	4	1	1	0	0	1	9
OG0011387	9	0	0	0	0	0	0	9
OG0011388	1	3	1	1	1	1	1	9
OG0011389	1	3	1	1	1	1	1	9
OG0011390	2	2	1	1	1	1	1	9
OG0011391	2	2	1	1	1	1	1	9
OG0011392	2	2	1	1	1	1	1	9
OG0011393	4	1	2	0	0	1	1	9
OG0011394	1	2	2	1	1	1	1	9
OG0011395	2	2	1	1	1	1	1	9
OG0011396	2	2	1	1	1	1	1	9
OG0011397	2	2	1	1	1	1	1	9
OG0011398	2	2	1	1	1	1	1	9
OG0011399	2	2	1	1	1	1	1	9
OG0011400	2	2	1	1	1	1	1	9
OG0011401	1	3	1	1	1	1	1	9
OG0011402	1	3	1	1	1	1	1	9
OG0011403	2	2	1	1	1	1	1	9
OG0011404	2	2	1	1	1	1	1	9
OG0011405	1	4	1	1	1	1	0	9
OG0011406	2	2	1	1	1	1	1	9
OG0011407	2	2	1	1	1	1	1	9
OG0011408	2	3	1	1	1	0	1	9
OG0011409	1	3	1	1	1	1	1	9
OG0011410	1	3	1	1	1	1	1	9
OG0011411	9	0	0	0	0	0	0	9
OG0011412	2	2	1	1	1	1	1	9
OG0011413	2	2	1	1	1	1	1	9
OG0011414	2	3	1	0	1	1	1	9
OG0011415	2	2	1	1	1	1	1	9
OG0011416	2	2	1	1	1	1	1	9
OG0011417	2	2	1	1	1	1	1	9
OG0011418	2	2	1	1	1	1	1	9
OG0011419	1	3	1	1	1	1	1	9
OG0011420	1	3	1	1	1	0	2	9
OG0011421	2	3	1	1	1	0	1	9
OG0011422	2	2	1	1	1	1	1	9
OG0011423	2	2	1	1	1	1	1	9
OG0011424	1	3	1	1	1	1	1	9
OG0011425	2	2	1	1	1	1	1	9
OG0011426	2	2	1	1	1	1	1	9
OG0011427	2	3	1	1	0	1	1	9
OG0011428	2	2	1	1	1	1	1	9
OG0011429	2	1	1	2	1	1	1	9
OG0011430	1	3	1	1	1	1	1	9
OG0011431	1	3	1	1	1	1	1	9
OG0011432	1	3	1	1	1	1	1	9
OG0011433	2	3	1	1	0	0	2	9
OG0011434	2	2	1	0	2	1	1	9
OG0011435	1	3	1	1	1	1	1	9
OG0011436	2	2	1	1	1	1	1	9
OG0011437	2	2	1	1	1	1	1	9
OG0011438	2	3	1	0	1	1	1	9
OG0011439	2	1	1	1	1	1	2	9
OG0011440	2	2	1	1	1	1	1	9
OG0011441	3	2	1	1	1	0	1	9
OG0011442	2	2	1	1	1	1	1	9
OG0011443	4	3	1	0	0	1	0	9
OG0011444	2	2	1	1	1	1	1	9
OG0011445	2	2	1	1	1	1	1	9
OG0011446	2	2	1	1	1	1	1	9
OG0011447	3	0	2	1	1	1	1	9
OG0011448	1	2	1	1	2	1	1	9
OG0011449	1	4	1	0	1	1	1	9
OG0011450	2	2	1	1	1	1	1	9
OG0011451	2	2	1	1	1	1	1	9
OG0011452	1	3	1	1	1	1	1	9
OG0011453	1	3	1	1	1	1	1	9
OG0011454	2	1	1	2	1	1	1	9
OG0011455	2	2	1	1	1	1	1	9
OG0011456	2	2	1	1	1	1	1	9
OG0011457	2	1	1	1	1	1	2	9
OG0011458	1	3	1	1	1	1	1	9
OG0011459	2	2	2	0	0	2	1	9
OG0011460	1	3	1	1	1	1	1	9
OG0011461	1	2	1	1	1	1	2	9
OG0011462	2	3	1	1	1	1	0	9
OG0011463	1	3	1	1	1	1	1	9
OG0011464	2	2	1	1	1	1	1	9
OG0011465	2	2	1	1	1	1	1	9
OG0011466	1	3	1	1	1	1	1	9
OG0011467	2	3	1	1	1	0	1	9
OG0011468	1	3	1	1	1	1	1	9
OG0011469	2	2	1	1	1	1	1	9
OG0011470	2	2	1	1	1	1	1	9
OG0011471	1	3	1	1	1	1	1	9
OG0011472	1	3	1	1	1	1	1	9
OG0011473	2	2	1	1	1	1	1	9
OG0011474	1	0	2	1	1	2	2	9
OG0011475	1	1	1	1	1	2	2	9
OG0011476	2	2	1	1	2	1	0	9
OG0011477	3	1	1	1	1	1	1	9
OG0011478	1	3	1	1	1	1	1	9
OG0011479	2	2	1	1	1	1	1	9
OG0011480	2	2	1	1	1	1	1	9
OG0011481	2	2	1	1	1	1	1	9
OG0011482	1	4	1	1	1	1	0	9
OG0011483	2	2	1	1	1	1	1	9
OG0011484	2	2	1	1	1	1	1	9
OG0011485	2	2	1	1	1	1	1	9
OG0011486	2	3	1	1	1	0	1	9
OG0011487	2	3	1	1	1	1	0	9
OG0011488	2	2	1	1	1	1	1	9
OG0011489	2	2	1	1	1	1	1	9
OG0011490	1	3	1	1	1	1	1	9
OG0011491	1	3	1	1	1	1	1	9
OG0011492	2	2	1	1	1	1	1	9
OG0011493	2	2	1	1	1	1	1	9
OG0011494	2	3	1	1	0	1	1	9
OG0011495	1	3	1	1	1	1	1	9
OG0011496	1	3	1	1	1	1	1	9
OG0011497	2	2	1	1	1	1	1	9
OG0011498	2	3	1	1	1	1	0	9
OG0011499	2	2	1	1	1	1	1	9
OG0011500	2	2	1	1	1	1	1	9
OG0011501	2	3	1	1	1	0	1	9
OG0011502	2	1	1	2	1	1	1	9
OG0011503	3	3	1	1	0	0	1	9
OG0011504	1	3	1	1	1	1	1	9
OG0011505	1	3	1	1	1	1	1	9
OG0011506	2	1	2	1	1	1	1	9
OG0011507	3	2	1	1	1	1	0	9
OG0011508	1	1	3	1	1	1	1	9
OG0011509	2	2	1	1	1	1	1	9
OG0011510	1	3	1	1	1	1	1	9
OG0011511	9	0	0	0	0	0	0	9
OG0011512	2	2	1	1	1	1	1	9
OG0011513	2	1	2	1	1	1	1	9
OG0011514	1	3	1	1	1	1	1	9
OG0011515	2	3	1	1	0	1	1	9
OG0011516	1	4	1	1	1	1	0	9
OG0011517	2	3	1	1	1	1	0	9
OG0011518	2	2	1	1	1	1	1	9
OG0011519	3	2	1	1	0	1	1	9
OG0011520	1	3	1	1	1	1	1	9
OG0011521	1	3	1	1	1	1	1	9
OG0011522	2	4	1	1	1	0	0	9
OG0011523	2	2	1	1	1	1	1	9
OG0011524	1	4	1	0	1	1	1	9
OG0011525	2	2	1	1	1	1	1	9
OG0011526	2	2	1	1	1	1	1	9
OG0011527	2	2	1	1	1	1	1	9
OG0011528	2	3	1	1	1	0	1	9
OG0011529	1	3	1	1	1	1	1	9
OG0011530	2	2	1	1	1	1	1	9
OG0011531	2	2	1	1	1	1	1	9
OG0011532	2	2	1	1	1	1	1	9
OG0011533	2	2	1	1	1	1	1	9
OG0011534	1	5	1	1	0	0	1	9
OG0011535	4	3	0	0	1	1	0	9
OG0011536	3	3	1	0	0	1	1	9
OG0011537	3	2	1	1	1	0	1	9
OG0011538	3	1	1	1	1	1	1	9
OG0011539	2	2	1	1	1	1	1	9
OG0011540	3	1	1	1	1	1	1	9
OG0011541	2	2	1	1	1	1	1	9
OG0011542	2	2	1	1	1	1	1	9
OG0011543	2	2	1	1	1	1	1	9
OG0011544	2	2	1	1	1	1	1	9
OG0011545	2	2	1	1	1	1	1	9
OG0011546	2	2	1	1	1	1	1	9
OG0011547	2	4	1	1	1	0	0	9
OG0011548	1	2	1	1	1	1	2	9
OG0011549	2	2	1	1	1	1	1	9
OG0011550	2	4	1	0	0	1	1	9
OG0011551	1	3	2	1	0	1	1	9
OG0011552	2	2	1	1	1	1	1	9
OG0011553	2	2	1	1	1	1	1	9
OG0011554	2	2	1	1	1	1	1	9
OG0011555	2	3	1	1	1	1	0	9
OG0011556	1	3	1	1	1	1	1	9
OG0011557	2	2	1	1	1	1	1	9
OG0011558	1	3	1	1	1	1	1	9
OG0011559	2	2	1	1	1	1	1	9
OG0011560	1	3	1	1	1	1	1	9
OG0011561	1	3	1	1	1	1	1	9
OG0011562	2	1	1	1	1	1	2	9
OG0011563	2	2	1	1	1	1	1	9
OG0011564	2	2	1	1	1	1	1	9
OG0011565	1	4	1	1	0	1	1	9
OG0011566	1	4	1	0	1	1	1	9
OG0011567	1	3	1	1	1	2	0	9
OG0011568	3	1	1	1	1	1	1	9
OG0011569	1	4	0	1	1	1	1	9
OG0011570	2	2	1	1	1	1	1	9
OG0011571	1	3	1	1	1	1	1	9
OG0011572	3	1	1	1	1	1	1	9
OG0011573	2	2	1	1	1	1	1	9
OG0011574	1	3	1	1	1	1	1	9
OG0011575	2	2	1	1	1	1	1	9
OG0011576	2	2	1	1	1	1	1	9
OG0011577	2	2	1	1	1	1	1	9
OG0011578	3	2	1	1	1	0	1	9
OG0011579	1	3	1	1	1	0	2	9
OG0011580	2	2	1	1	1	1	1	9
OG0011581	2	2	1	1	1	1	1	9
OG0011582	2	3	1	0	1	1	1	9
OG0011583	2	2	1	1	1	1	1	9
OG0011584	2	2	1	1	1	1	1	9
OG0011585	1	3	1	1	1	1	1	9
OG0011586	1	2	1	1	1	1	2	9
OG0011587	1	3	1	1	1	1	1	9
OG0011588	1	3	1	1	1	1	1	9
OG0011589	1	3	1	1	1	1	1	9
OG0011590	1	3	1	1	1	1	1	9
OG0011591	1	3	1	1	1	0	2	9
OG0011592	2	2	1	1	1	1	1	9
OG0011593	1	3	1	1	1	1	1	9
OG0011594	2	2	1	1	1	1	1	9
OG0011595	2	2	1	1	1	1	1	9
OG0011596	1	3	1	1	1	1	1	9
OG0011597	2	1	2	1	1	1	1	9
OG0011598	2	3	1	1	0	1	1	9
OG0011599	1	3	1	1	1	1	1	9
OG0011600	1	3	1	1	1	1	1	9
OG0011601	2	3	1	1	1	0	1	9
OG0011602	1	3	1	1	1	1	1	9
OG0011603	2	3	1	1	1	1	0	9
OG0011604	2	2	1	1	1	1	1	9
OG0011605	1	3	1	1	1	1	1	9
OG0011606	1	3	1	1	1	1	1	9
OG0011607	2	3	2	1	0	0	1	9
OG0011608	1	3	1	1	1	1	1	9
OG0011609	2	2	1	1	1	0	2	9
OG0011610	2	4	1	1	1	0	0	9
OG0011611	2	2	1	1	1	1	1	9
OG0011612	2	3	1	1	0	1	1	9
OG0011613	2	3	1	1	1	1	0	9
OG0011614	2	2	1	1	1	1	1	9
OG0011615	1	3	1	1	1	1	1	9
OG0011616	2	2	1	1	1	1	1	9
OG0011617	1	3	1	1	1	1	1	9
OG0011618	2	2	1	1	1	1	1	9
OG0011619	1	2	1	1	1	1	2	9
OG0011620	2	2	1	1	1	1	1	9
OG0011621	1	3	1	1	1	1	1	9
OG0011622	1	3	1	1	1	1	1	9
OG0011623	1	3	1	1	1	1	1	9
OG0011624	2	2	1	1	1	1	1	9
OG0011625	2	2	1	1	1	1	1	9
OG0011626	1	3	1	1	1	1	1	9
OG0011627	3	2	1	1	1	1	0	9
OG0011628	3	2	1	1	1	0	1	9
OG0011629	2	2	1	1	1	1	1	9
OG0011630	2	3	1	1	1	1	0	9
OG0011631	2	2	1	1	1	1	1	9
OG0011632	1	3	1	1	1	1	1	9
OG0011633	2	2	1	1	1	1	1	9
OG0011634	2	2	1	1	1	1	1	9
OG0011635	2	3	1	1	0	1	1	9
OG0011636	1	3	1	1	1	1	1	9
OG0011637	3	1	1	1	1	1	1	9
OG0011638	1	3	1	1	1	1	1	9
OG0011639	2	3	1	0	1	1	1	9
OG0011640	2	4	1	1	0	0	1	9
OG0011641	1	3	1	1	1	1	1	9
OG0011642	1	3	1	1	1	1	1	9
OG0011643	2	2	1	1	1	1	1	9
OG0011644	2	2	1	1	1	1	1	9
OG0011645	1	4	1	1	1	1	0	9
OG0011646	2	2	1	1	1	1	1	9
OG0011647	2	2	1	1	1	1	1	9
OG0011648	1	3	1	1	1	1	1	9
OG0011649	9	0	0	0	0	0	0	9
OG0011650	1	3	1	1	1	1	1	9
OG0011651	9	0	0	0	0	0	0	9
OG0011652	2	2	1	1	1	1	1	9
OG0011653	2	2	1	1	1	1	1	9
OG0011654	2	4	1	1	0	0	1	9
OG0011655	3	1	1	1	1	1	1	9
OG0011656	2	2	1	1	1	1	1	9
OG0011657	2	2	1	1	1	1	1	9
OG0011658	2	4	1	1	0	1	0	9
OG0011659	2	2	1	1	1	1	1	9
OG0011660	2	2	1	1	1	1	1	9
OG0011661	1	3	1	1	1	1	1	9
OG0011662	2	3	1	1	1	0	1	9
OG0011663	2	2	1	1	1	1	1	9
OG0011664	2	3	1	1	0	1	1	9
OG0011665	3	3	1	1	0	0	1	9
OG0011666	1	2	1	1	1	1	2	9
OG0011667	2	2	1	1	1	1	1	9
OG0011668	1	4	1	1	1	1	0	9
OG0011669	2	2	1	1	1	1	1	9
OG0011670	2	3	1	1	1	0	1	9
OG0011671	1	3	1	1	1	1	1	9
OG0011672	2	2	1	1	1	1	1	9
OG0011673	3	2	1	0	1	1	1	9
OG0011674	2	2	1	1	1	1	1	9
OG0011675	2	2	1	1	1	1	1	9
OG0011676	2	2	1	1	1	1	1	9
OG0011677	1	3	1	1	1	1	1	9
OG0011678	1	3	1	1	1	1	1	9
OG0011679	2	2	1	1	1	1	1	9
OG0011680	1	3	1	1	1	1	1	9
OG0011681	2	1	1	1	1	1	2	9
OG0011682	2	2	1	1	1	1	1	9
OG0011683	2	2	1	1	1	1	1	9
OG0011684	3	2	1	0	1	1	1	9
OG0011685	2	2	1	1	1	1	1	9
OG0011686	1	3	1	1	1	1	1	9
OG0011687	1	3	1	1	1	1	1	9
OG0011688	2	2	1	1	1	1	1	9
OG0011689	2	2	1	1	1	1	1	9
OG0011690	2	3	1	1	1	0	1	9
OG0011691	2	2	1	1	1	1	1	9
OG0011692	1	3	1	1	1	1	1	9
OG0011693	2	2	1	1	1	1	1	9
OG0011694	2	2	1	1	1	1	1	9
OG0011695	2	3	1	1	1	0	1	9
OG0011696	2	2	1	1	1	1	1	9
OG0011697	1	3	1	1	1	1	1	9
OG0011698	2	2	1	1	1	1	1	9
OG0011699	1	3	1	1	1	1	1	9
OG0011700	2	2	1	1	1	1	1	9
OG0011701	2	2	1	1	1	1	1	9
OG0011702	1	3	1	1	1	1	1	9
OG0011703	2	2	1	1	1	1	1	9
OG0011704	2	2	1	1	1	1	1	9
OG0011705	1	3	1	1	1	1	1	9
OG0011706	2	2	1	1	1	1	1	9
OG0011707	2	3	1	1	1	1	0	9
OG0011708	2	1	1	2	1	1	1	9
OG0011709	1	4	1	1	1	0	1	9
OG0011710	2	2	1	1	1	1	1	9
OG0011711	1	3	1	1	1	1	1	9
OG0011712	2	2	1	1	1	1	1	9
OG0011713	2	2	1	1	1	1	1	9
OG0011714	1	3	1	1	1	1	1	9
OG0011715	2	2	1	1	1	1	1	9
OG0011716	3	3	1	1	0	0	1	9
OG0011717	2	2	1	1	1	1	1	9
OG0011718	2	3	1	1	1	0	1	9
OG0011719	2	4	1	0	1	0	1	9
OG0011720	2	2	1	1	1	1	1	9
OG0011721	2	2	1	1	1	1	1	9
OG0011722	2	2	1	1	1	1	1	9
OG0011723	2	3	1	1	1	1	0	9
OG0011724	1	3	1	1	1	1	1	9
OG0011725	2	2	1	1	1	1	1	9
OG0011726	1	3	1	1	2	1	0	9
OG0011727	2	3	0	1	1	1	1	9
OG0011728	1	1	1	2	2	1	1	9
OG0011729	2	2	1	1	1	1	1	9
OG0011730	2	2	1	1	1	1	1	9
OG0011731	2	2	1	1	1	1	1	9
OG0011732	2	2	1	1	1	1	1	9
OG0011733	1	2	2	1	1	1	1	9
OG0011734	1	3	1	1	1	1	1	9
OG0011735	3	1	1	1	1	1	1	9
OG0011736	4	1	1	1	1	0	1	9
OG0011737	9	0	0	0	0	0	0	9
OG0011738	1	4	1	1	1	1	0	9
OG0011739	2	2	1	1	1	1	1	9
OG0011740	1	3	1	1	1	1	1	9
OG0011741	2	2	1	1	1	1	1	9
OG0011742	2	3	1	1	1	1	0	9
OG0011743	2	2	1	1	1	1	1	9
OG0011744	2	2	1	1	1	1	1	9
OG0011745	1	3	1	1	1	1	1	9
OG0011746	2	3	1	1	0	1	1	9
OG0011747	2	2	1	1	1	1	1	9
OG0011748	2	2	1	1	1	1	1	9
OG0011749	2	2	1	1	1	1	1	9
OG0011750	3	2	1	1	1	0	1	9
OG0011751	2	3	1	1	0	1	1	9
OG0011752	2	2	1	1	1	1	1	9
OG0011753	1	3	1	1	1	1	1	9
OG0011754	1	4	0	0	1	1	2	9
OG0011755	2	2	1	1	1	1	1	9
OG0011756	2	2	1	1	1	1	1	9
OG0011757	2	2	1	1	1	1	1	9
OG0011758	1	3	1	1	1	0	2	9
OG0011759	2	2	1	1	1	1	1	9
OG0011760	4	3	1	1	0	0	0	9
OG0011761	1	3	1	1	1	1	1	9
OG0011762	2	2	1	1	1	1	1	9
OG0011763	2	1	1	2	1	1	1	9
OG0011764	1	3	1	1	1	1	1	9
OG0011765	1	3	1	1	1	1	1	9
OG0011766	2	2	1	1	1	1	1	9
OG0011767	1	3	1	1	1	1	1	9
OG0011768	1	3	1	1	1	1	1	9
OG0011769	2	2	1	1	1	1	1	9
OG0011770	2	4	1	0	1	0	1	9
OG0011771	2	2	1	1	1	1	1	9
OG0011772	2	2	1	1	1	1	1	9
OG0011773	3	1	1	1	1	1	1	9
OG0011774	1	3	1	1	1	1	1	9
OG0011775	2	1	1	1	1	2	1	9
OG0011776	2	2	1	1	1	1	1	9
OG0011777	2	2	1	1	1	1	1	9
OG0011778	1	3	1	1	1	1	1	9
OG0011779	2	3	1	1	1	1	0	9
OG0011780	1	4	1	1	1	1	0	9
OG0011781	2	2	1	1	1	1	1	9
OG0011782	2	2	1	1	1	1	1	9
OG0011783	2	2	1	1	1	1	1	9
OG0011784	2	2	1	1	1	1	1	9
OG0011785	2	3	1	1	0	1	1	9
OG0011786	2	3	1	1	1	0	1	9
OG0011787	2	2	1	1	1	1	1	9
OG0011788	2	2	1	1	1	1	1	9
OG0011789	3	1	1	1	1	1	1	9
OG0011790	2	2	1	1	1	1	1	9
OG0011791	2	2	1	1	1	1	1	9
OG0011792	1	3	1	1	1	1	1	9
OG0011793	2	2	1	1	1	1	1	9
OG0011794	3	1	1	1	1	1	1	9
OG0011795	2	2	1	1	1	1	1	9
OG0011796	3	1	1	1	1	1	1	9
OG0011797	1	4	1	1	0	1	1	9
OG0011798	1	2	1	1	1	2	1	9
OG0011799	2	2	1	0	2	1	1	9
OG0011800	3	2	1	1	0	1	1	9
OG0011801	2	2	1	1	1	1	1	9
OG0011802	2	2	1	1	1	1	1	9
OG0011803	2	2	1	1	0	0	3	9
OG0011804	3	1	1	1	1	1	1	9
OG0011805	1	3	1	1	1	1	1	9
OG0011806	1	2	2	1	1	1	1	9
OG0011807	1	3	1	1	1	1	1	9
OG0011808	2	4	1	0	1	0	1	9
OG0011809	2	2	1	1	1	1	1	9
OG0011810	3	1	1	1	1	1	1	9
OG0011811	2	2	1	1	1	1	1	9
OG0011812	2	2	1	1	1	1	1	9
OG0011813	1	3	1	1	1	1	1	9
OG0011814	2	2	1	1	1	1	1	9
OG0011815	2	2	1	1	1	1	1	9
OG0011816	2	3	1	1	1	1	0	9
OG0011817	2	2	1	1	1	1	1	9
OG0011818	1	3	1	1	1	1	1	9
OG0011819	3	1	1	1	1	1	1	9
OG0011820	2	3	1	1	1	0	1	9
OG0011821	2	2	1	1	1	1	1	9
OG0011822	3	1	1	1	1	1	1	9
OG0011823	2	2	1	1	1	1	1	9
OG0011824	2	2	1	1	1	1	1	9
OG0011825	2	3	1	1	0	1	1	9
OG0011826	2	3	1	1	0	1	1	9
OG0011827	2	2	1	1	1	1	1	9
OG0011828	2	2	1	1	1	1	1	9
OG0011829	1	3	1	1	1	1	1	9
OG0011830	2	3	1	1	1	1	0	9
OG0011831	1	3	1	1	1	1	1	9
OG0011832	1	3	1	1	1	1	1	9
OG0011833	2	1	1	1	0	2	2	9
OG0011834	1	3	1	1	1	1	1	9
OG0011835	2	2	1	1	1	1	1	9
OG0011836	1	3	1	1	1	1	1	9
OG0011837	2	3	1	1	1	0	1	9
OG0011838	1	3	1	1	1	1	1	9
OG0011839	2	2	1	1	1	1	1	9
OG0011840	2	2	1	1	1	1	1	9
OG0011841	2	2	1	1	1	1	1	9
OG0011842	1	2	1	1	1	1	2	9
OG0011843	2	2	1	1	1	1	1	9
OG0011844	2	2	1	1	1	1	1	9
OG0011845	2	2	1	1	1	1	1	9
OG0011846	1	4	1	1	1	1	0	9
OG0011847	1	2	1	1	1	1	2	9
OG0011848	2	2	1	1	1	1	1	9
OG0011849	2	2	1	1	1	1	1	9
OG0011850	2	2	1	1	1	1	1	9
OG0011851	2	2	1	1	1	1	1	9
OG0011852	2	2	1	1	1	1	1	9
OG0011853	1	3	1	1	1	1	1	9
OG0011854	2	4	1	1	0	0	1	9
OG0011855	2	2	1	1	1	1	1	9
OG0011856	2	2	1	1	1	1	1	9
OG0011857	2	2	1	1	1	1	1	9
OG0011858	2	2	2	1	1	0	1	9
OG0011859	1	3	1	1	1	1	1	9
OG0011860	1	4	1	2	0	0	1	9
OG0011861	2	2	1	1	1	1	1	9
OG0011862	1	3	1	1	1	1	1	9
OG0011863	1	3	1	1	1	1	1	9
OG0011864	2	2	1	1	1	1	1	9
OG0011865	1	3	1	1	1	1	1	9
OG0011866	2	2	1	1	1	1	1	9
OG0011867	1	2	1	1	1	2	1	9
OG0011868	2	3	1	1	1	0	1	9
OG0011869	2	2	1	1	1	1	1	9
OG0011870	2	2	1	1	1	1	1	9
OG0011871	2	2	1	1	1	1	1	9
OG0011872	3	1	1	1	1	1	1	9
OG0011873	2	2	1	1	1	1	1	9
OG0011874	2	2	1	1	1	1	1	9
OG0011875	2	4	1	0	0	1	1	9
OG0011876	2	2	1	1	1	1	1	9
OG0011877	1	3	1	1	1	1	1	9
OG0011878	2	3	1	1	1	0	1	9
OG0011879	2	2	1	1	1	1	1	9
OG0011880	2	2	1	1	1	1	1	9
OG0011881	1	3	1	1	2	1	0	9
OG0011882	2	3	1	1	1	1	0	9
OG0011883	1	2	1	1	1	1	2	9
OG0011884	1	4	1	1	1	0	1	9
OG0011885	9	0	0	0	0	0	0	9
OG0011886	2	2	1	1	1	1	1	9
OG0011887	1	3	1	1	1	1	1	9
OG0011888	1	3	1	1	1	1	1	9
OG0011889	2	2	1	1	1	1	1	9
OG0011890	2	2	1	1	1	1	1	9
OG0011891	2	3	1	1	1	1	0	9
OG0011892	3	2	1	0	1	1	1	9
OG0011893	2	2	1	1	1	1	1	9
OG0011894	2	2	1	1	1	1	1	9
OG0011895	2	2	1	1	1	1	1	9
OG0011896	1	3	1	1	1	1	1	9
OG0011897	3	2	1	1	1	1	0	9
OG0011898	2	2	1	1	1	1	1	9
OG0011899	2	4	0	0	1	0	2	9
OG0011900	1	4	1	1	0	1	1	9
OG0011901	2	4	1	0	0	1	1	9
OG0011902	2	3	1	0	1	1	1	9
OG0011903	2	4	1	0	1	1	0	9
OG0011904	2	2	1	1	1	1	1	9
OG0011905	1	3	1	1	1	1	1	9
OG0011906	2	2	1	2	1	0	1	9
OG0011907	3	1	1	1	1	1	1	9
OG0011908	2	2	5	0	0	0	0	9
OG0011909	3	1	1	1	1	1	1	9
OG0011910	2	2	2	1	1	0	1	9
OG0011911	9	0	0	0	0	0	0	9
OG0011912	2	2	1	1	1	1	1	9
OG0011913	2	1	1	1	1	2	1	9
OG0011914	1	4	1	1	1	0	1	9
OG0011915	2	2	1	1	1	1	1	9
OG0011916	1	3	1	1	1	1	1	9
OG0011917	2	3	1	1	0	1	1	9
OG0011918	1	3	1	1	1	1	1	9
OG0011919	2	2	1	1	1	1	1	9
OG0011920	2	2	1	1	1	1	1	9
OG0011921	2	2	1	1	1	1	1	9
OG0011922	2	2	1	1	1	1	1	9
OG0011923	2	2	1	1	1	1	1	9
OG0011924	1	3	1	1	1	1	1	9
OG0011925	2	2	1	1	1	1	1	9
OG0011926	2	2	1	1	1	1	1	9
OG0011927	2	2	1	1	1	1	1	9
OG0011928	3	2	1	1	1	1	0	9
OG0011929	1	3	1	1	1	1	1	9
OG0011930	2	2	1	1	1	1	1	9
OG0011931	2	3	1	1	1	0	1	9
OG0011932	2	2	1	1	1	1	1	9
OG0011933	2	2	1	1	1	1	1	9
OG0011934	2	2	1	1	1	1	1	9
OG0011935	2	2	1	1	1	1	1	9
OG0011936	1	3	1	1	1	1	1	9
OG0011937	2	2	1	1	1	1	1	9
OG0011938	1	4	1	1	0	1	1	9
OG0011939	2	2	1	1	1	1	1	9
OG0011940	2	2	1	1	1	0	2	9
OG0011941	1	3	1	1	1	1	1	9
OG0011942	2	3	1	1	0	1	1	9
OG0011943	2	2	1	1	1	1	1	9
OG0011944	2	2	1	1	1	1	1	9
OG0011945	2	2	1	1	1	1	1	9
OG0011946	2	2	1	1	1	1	1	9
OG0011947	2	3	1	1	1	0	1	9
OG0011948	2	2	1	1	1	1	1	9
OG0011949	1	3	1	1	1	1	1	9
OG0011950	2	2	1	1	1	1	1	9
OG0011951	1	3	1	1	1	1	1	9
OG0011952	2	2	1	1	1	1	1	9
OG0011953	2	2	1	1	1	1	1	9
OG0011954	1	4	1	1	1	0	1	9
OG0011955	1	3	1	1	1	1	1	9
OG0011956	1	3	1	1	1	1	1	9
OG0011957	7	0	0	1	0	0	1	9
OG0011958	1	3	1	0	1	2	1	9
OG0011959	2	3	1	2	0	0	1	9
OG0011960	2	2	1	1	1	1	1	9
OG0011961	2	2	1	1	1	1	1	9
OG0011962	3	1	1	1	1	1	1	9
OG0011963	9	0	0	0	0	0	0	9
OG0011964	2	2	1	1	1	1	1	9
OG0011965	2	4	1	0	1	0	1	9
OG0011966	2	2	1	1	1	1	1	9
OG0011967	1	3	1	1	1	1	1	9
OG0011968	1	2	1	1	1	2	1	9
OG0011969	1	3	1	1	1	1	1	9
OG0011970	1	2	1	1	1	1	2	9
OG0011971	1	3	1	1	1	1	1	9
OG0011972	2	3	1	0	1	1	1	9
OG0011973	2	2	1	1	1	1	1	9
OG0011974	1	3	1	1	1	1	1	9
OG0011975	2	2	1	1	1	1	1	9
OG0011976	2	1	1	1	1	1	2	9
OG0011977	2	3	1	1	1	0	1	9
OG0011978	2	3	1	1	1	1	0	9
OG0011979	1	3	1	1	1	1	1	9
OG0011980	1	2	2	0	1	1	2	9
OG0011981	1	3	1	1	1	1	1	9
OG0011982	2	3	1	1	1	1	0	9
OG0011983	2	2	1	1	1	1	1	9
OG0011984	2	2	1	1	1	1	1	9
OG0011985	2	2	1	1	1	1	1	9
OG0011986	2	3	1	1	0	1	1	9
OG0011987	2	3	1	1	1	1	0	9
OG0011988	2	2	1	1	1	1	1	9
OG0011989	1	3	1	1	1	1	1	9
OG0011990	2	2	1	1	1	1	1	9
OG0011991	1	3	1	1	1	1	1	9
OG0011992	2	2	1	1	1	1	1	9
OG0011993	1	3	1	1	1	1	1	9
OG0011994	2	2	1	1	1	1	1	9
OG0011995	1	3	1	1	1	1	1	9
OG0011996	2	2	1	1	1	1	1	9
OG0011997	1	3	1	1	1	1	1	9
OG0011998	2	2	1	1	1	1	1	9
OG0011999	1	3	1	1	1	1	1	9
OG0012000	2	2	1	1	1	1	1	9
OG0012001	1	3	1	1	1	1	1	9
OG0012002	2	2	1	1	1	1	1	9
OG0012003	1	3	1	1	1	1	1	9
OG0012004	2	3	1	0	1	1	1	9
OG0012005	2	2	1	1	1	1	1	9
OG0012006	1	8	0	0	0	0	0	9
OG0012007	2	2	1	1	1	1	1	9
OG0012008	1	3	1	1	1	0	2	9
OG0012009	2	2	1	1	1	1	1	9
OG0012010	2	2	1	1	1	1	1	9
OG0012011	2	2	1	1	1	1	1	9
OG0012012	1	3	1	1	1	1	1	9
OG0012013	2	2	1	1	1	1	1	9
OG0012014	2	2	1	1	1	1	1	9
OG0012015	1	3	1	1	1	1	1	9
OG0012016	1	3	1	1	1	1	1	9
OG0012017	1	3	1	1	1	1	1	9
OG0012018	1	3	1	1	1	1	1	9
OG0012019	2	2	1	1	1	1	1	9
OG0012020	2	2	1	0	2	1	1	9
OG0012021	1	3	1	1	1	1	1	9
OG0012022	2	2	1	1	1	1	1	9
OG0012023	2	2	1	1	1	1	1	9
OG0012024	2	2	1	1	1	1	1	9
OG0012025	2	2	1	1	1	1	1	9
OG0012026	1	3	1	1	1	1	1	9
OG0012027	2	2	1	1	1	1	1	9
OG0012028	2	3	1	1	1	1	0	9
OG0012029	1	3	1	1	1	1	1	9
OG0012030	2	2	1	1	1	1	1	9
OG0012031	1	3	1	1	1	1	1	9
OG0012032	2	2	1	1	1	1	1	9
OG0012033	1	3	1	1	1	1	1	9
OG0012034	2	2	1	1	1	1	1	9
OG0012035	2	2	1	1	1	1	1	9
OG0012036	1	3	1	1	1	1	1	9
OG0012037	2	2	1	1	1	1	1	9
OG0012038	2	2	1	1	1	1	1	9
OG0012039	2	2	1	1	1	1	1	9
OG0012040	1	3	1	1	1	1	1	9
OG0012041	2	2	1	1	1	1	1	9
OG0012042	1	3	1	1	1	1	1	9
OG0012043	2	2	1	1	1	1	1	9
OG0012044	3	1	1	1	1	1	1	9
OG0012045	2	2	1	1	1	1	1	9
OG0012046	2	2	1	1	1	1	1	9
OG0012047	2	4	1	1	0	1	0	9
OG0012048	2	3	1	1	1	0	1	9
OG0012049	1	3	1	1	1	1	1	9
OG0012050	2	2	1	1	1	1	1	9
OG0012051	1	3	1	1	1	1	1	9
OG0012052	1	3	1	1	1	1	1	9
OG0012053	2	2	1	1	1	1	1	9
OG0012054	2	2	1	1	1	1	1	9
OG0012055	2	2	1	1	1	1	1	9
OG0012056	2	2	1	1	1	1	1	9
OG0012057	2	3	1	1	1	0	1	9
OG0012058	2	2	1	1	1	1	1	9
OG0012059	2	3	1	1	0	1	1	9
OG0012060	1	3	1	1	1	1	1	9
OG0012061	2	2	1	1	1	1	1	9
OG0012062	1	2	1	1	1	1	2	9
OG0012063	2	2	1	1	1	1	1	9
OG0012064	2	2	1	1	1	1	1	9
OG0012065	1	3	1	1	1	1	1	9
OG0012066	2	2	1	1	1	1	1	9
OG0012067	2	2	1	1	1	1	1	9
OG0012068	2	2	1	1	1	1	1	9
OG0012069	2	2	1	1	1	1	1	9
OG0012070	2	2	1	1	1	1	1	9
OG0012071	2	2	3	1	0	0	1	9
OG0012072	1	3	1	1	1	1	1	9
OG0012073	2	2	1	1	1	1	1	9
OG0012074	1	4	1	1	1	1	0	9
OG0012075	1	3	2	1	1	1	0	9
OG0012076	1	3	1	1	1	1	1	9
OG0012077	2	3	1	1	0	1	1	9
OG0012078	2	5	0	1	0	0	1	9
OG0012079	4	1	1	1	1	0	1	9
OG0012080	2	2	1	1	1	1	1	9
OG0012081	1	4	1	0	1	1	1	9
OG0012082	2	2	1	1	1	1	1	9
OG0012083	1	3	1	1	1	1	1	9
OG0012084	2	2	1	1	1	1	1	9
OG0012085	2	2	1	1	1	1	1	9
OG0012086	1	3	1	1	1	1	1	9
OG0012087	2	1	1	1	1	1	2	9
OG0012088	1	3	0	1	1	2	1	9
OG0012089	2	2	1	1	1	1	1	9
OG0012090	2	2	1	1	1	1	1	9
OG0012091	2	2	1	1	1	1	1	9
OG0012092	2	3	0	1	1	1	1	9
OG0012093	4	0	1	1	1	1	1	9
OG0012094	1	3	1	1	1	1	1	9
OG0012095	2	3	1	1	1	1	0	9
OG0012096	1	4	1	1	1	0	1	9
OG0012097	2	2	1	1	1	1	1	9
OG0012098	2	3	1	1	0	1	1	9
OG0012099	2	2	1	1	2	0	1	9
OG0012100	2	2	1	1	1	1	1	9
OG0012101	1	4	1	1	1	0	1	9
OG0012102	1	3	1	0	1	1	2	9
OG0012103	1	3	1	1	1	1	1	9
OG0012104	2	3	1	1	1	0	1	9
OG0012105	1	3	1	1	1	1	1	9
OG0012106	1	3	1	1	1	1	1	9
OG0012107	2	3	1	0	1	1	1	9
OG0012108	1	3	1	1	1	1	1	9
OG0012109	2	2	1	1	1	1	1	9
OG0012110	1	3	1	1	1	1	1	9
OG0012111	1	3	1	1	1	1	1	9
OG0012112	2	2	1	1	1	1	1	9
OG0012113	2	3	1	1	0	0	2	9
OG0012114	1	3	1	1	1	1	1	9
OG0012115	2	2	1	1	1	1	1	9
OG0012116	2	2	1	1	1	1	1	9
OG0012117	1	1	1	1	2	2	1	9
OG0012118	1	3	1	1	1	1	1	9
OG0012119	2	2	1	1	1	1	1	9
OG0012120	2	3	1	0	1	1	1	9
OG0012121	2	2	1	1	1	1	1	9
OG0012122	1	3	1	2	1	0	1	9
OG0012123	1	3	1	1	1	1	1	9
OG0012124	2	2	1	1	1	1	1	9
OG0012125	2	2	1	1	1	1	1	9
OG0012126	2	2	1	1	1	1	1	9
OG0012127	2	3	0	1	1	1	1	9
OG0012128	1	3	1	1	1	1	1	9
OG0012129	1	4	1	1	0	1	1	9
OG0012130	1	3	1	1	1	1	1	9
OG0012131	2	2	1	1	1	1	1	9
OG0012132	2	2	1	1	1	1	1	9
OG0012133	1	3	1	1	1	1	1	9
OG0012134	1	3	1	1	1	1	1	9
OG0012135	2	3	1	1	1	0	1	9
OG0012136	2	2	1	1	1	1	1	9
OG0012137	2	2	1	1	1	1	1	9
OG0012138	1	3	1	1	1	1	1	9
OG0012139	2	2	1	1	1	1	1	9
OG0012140	2	3	1	0	1	1	1	9
OG0012141	2	3	1	0	1	1	1	9
OG0012142	1	3	1	1	1	1	1	9
OG0012143	2	3	1	1	0	1	1	9
OG0012144	2	2	1	1	1	1	1	9
OG0012145	1	2	1	2	1	1	1	9
OG0012146	1	3	1	1	1	1	1	9
OG0012147	2	2	1	1	1	1	1	9
OG0012148	2	2	1	1	1	1	1	9
OG0012149	2	2	1	1	1	1	1	9
OG0012150	2	2	1	1	1	1	1	9
OG0012151	2	2	1	1	1	1	1	9
OG0012152	1	2	2	1	1	1	1	9
OG0012153	2	2	1	1	1	1	1	9
OG0012154	1	3	1	1	1	1	1	9
OG0012155	2	2	1	1	1	1	1	9
OG0012156	2	4	1	1	0	0	1	9
OG0012157	2	2	1	1	1	1	1	9
OG0012158	3	2	1	1	1	0	1	9
OG0012159	3	2	1	1	1	0	1	9
OG0012160	1	3	1	1	1	1	1	9
OG0012161	1	3	1	1	1	0	2	9
OG0012162	1	3	1	1	1	1	1	9
OG0012163	1	3	1	1	1	1	1	9
OG0012164	1	3	1	1	1	1	1	9
OG0012165	1	3	1	1	1	1	1	9
OG0012166	2	1	1	1	1	2	1	9
OG0012167	2	2	1	1	1	1	1	9
OG0012168	1	3	1	1	1	1	1	9
OG0012169	3	1	1	1	1	1	1	9
OG0012170	2	2	1	1	1	1	1	9
OG0012171	1	3	1	1	1	1	1	9
OG0012172	1	3	1	1	1	1	1	9
OG0012173	2	2	1	1	1	1	1	9
OG0012174	1	4	1	0	1	1	1	9
OG0012175	2	2	1	1	1	1	1	9
OG0012176	2	2	1	1	1	1	1	9
OG0012177	1	3	1	1	1	1	1	9
OG0012178	2	2	1	1	1	1	1	9
OG0012179	2	3	1	1	1	1	0	9
OG0012180	2	2	1	1	1	1	1	9
OG0012181	2	2	1	1	1	1	1	9
OG0012182	1	3	2	1	1	0	1	9
OG0012183	1	3	1	1	1	1	1	9
OG0012184	1	3	1	1	1	1	1	9
OG0012185	2	2	1	1	1	1	1	9
OG0012186	2	3	1	1	1	0	1	9
OG0012187	1	3	1	1	1	1	1	9
OG0012188	2	2	1	1	1	1	1	9
OG0012189	2	2	1	1	1	1	1	9
OG0012190	2	3	1	1	0	1	1	9
OG0012191	2	3	1	1	0	1	1	9
OG0012192	3	3	1	1	0	0	1	9
OG0012193	1	3	1	1	1	1	1	9
OG0012194	2	2	1	1	1	1	1	9
OG0012195	2	3	1	1	0	1	1	9
OG0012196	1	3	1	1	1	1	1	9
OG0012197	1	4	1	1	1	1	0	9
OG0012198	2	2	1	1	1	1	1	9
OG0012199	2	2	1	1	1	1	1	9
OG0012200	1	3	1	1	1	1	1	9
OG0012201	1	3	1	1	1	1	1	9
OG0012202	3	3	1	1	0	0	1	9
OG0012203	2	2	1	1	1	1	1	9
OG0012204	2	3	1	1	1	1	0	9
OG0012205	2	2	1	1	1	1	1	9
OG0012206	3	1	2	2	0	0	1	9
OG0012207	2	2	1	1	1	1	1	9
OG0012208	2	3	1	1	1	1	0	9
OG0012209	2	2	1	1	1	1	1	9
OG0012210	2	2	1	1	1	1	1	9
OG0012211	2	2	1	1	1	1	1	9
OG0012212	2	2	1	1	1	1	1	9
OG0012213	2	2	1	1	1	1	1	9
OG0012214	2	2	1	1	1	1	1	9
OG0012215	2	2	1	1	1	1	1	9
OG0012216	1	3	1	0	2	1	1	9
OG0012217	2	2	1	1	1	1	1	9
OG0012218	2	2	1	1	1	1	1	9
OG0012219	2	2	1	1	1	1	1	9
OG0012220	2	2	1	1	1	1	1	9
OG0012221	3	1	1	1	1	1	1	9
OG0012222	1	3	1	1	1	1	1	9
OG0012223	2	2	0	0	2	1	2	9
OG0012224	1	4	1	1	1	0	1	9
OG0012225	1	3	1	1	1	1	1	9
OG0012226	1	3	1	1	1	1	1	9
OG0012227	2	2	1	1	1	1	1	9
OG0012228	2	3	1	1	1	0	1	9
OG0012229	2	2	1	1	1	1	1	9
OG0012230	2	2	1	1	1	1	1	9
OG0012231	1	3	1	1	1	1	1	9
OG0012232	2	4	1	1	0	0	1	9
OG0012233	1	3	1	1	1	1	1	9
OG0012234	2	3	1	1	0	1	1	9
OG0012235	2	2	1	1	1	1	1	9
OG0012236	1	2	1	1	1	1	2	9
OG0012237	1	3	1	1	1	1	1	9
OG0012238	3	2	1	1	0	1	1	9
OG0012239	1	3	1	1	1	1	1	9
OG0012240	2	2	1	1	1	1	1	9
OG0012241	1	3	1	1	1	1	1	9
OG0012242	1	3	1	1	1	1	1	9
OG0012243	1	3	1	1	1	1	1	9
OG0012244	2	2	1	1	1	1	1	9
OG0012245	1	3	1	1	1	1	1	9
OG0012246	2	3	1	1	1	0	1	9
OG0012247	2	2	1	1	1	1	1	9
OG0012248	1	3	1	1	1	1	1	9
OG0012249	1	4	1	1	1	1	0	9
OG0012250	1	3	1	1	1	1	1	9
OG0012251	2	2	1	1	1	1	1	9
OG0012252	1	3	1	1	1	1	1	9
OG0012253	2	2	1	1	1	1	1	9
OG0012254	2	2	1	1	1	1	1	9
OG0012255	1	3	1	1	1	1	1	9
OG0012256	2	2	1	1	1	1	1	9
OG0012257	2	2	1	1	1	1	1	9
OG0012258	2	2	1	1	1	1	1	9
OG0012259	2	2	1	1	1	1	1	9
OG0012260	1	3	1	1	1	1	1	9
OG0012261	4	2	2	0	1	0	0	9
OG0012262	1	3	1	1	1	1	1	9
OG0012263	1	3	1	1	1	1	1	9
OG0012264	1	2	1	1	1	1	2	9
OG0012265	2	2	1	1	1	1	1	9
OG0012266	1	3	1	1	1	1	1	9
OG0012267	2	2	1	1	1	1	1	9
OG0012268	2	2	1	1	1	0	2	9
OG0012269	1	3	1	1	1	1	1	9
OG0012270	2	2	1	1	1	1	1	9
OG0012271	1	3	1	1	1	1	1	9
OG0012272	2	2	1	1	1	1	1	9
OG0012273	2	2	1	1	1	1	1	9
OG0012274	1	3	1	1	1	1	1	9
OG0012275	2	3	1	1	1	0	1	9
OG0012276	1	3	1	1	1	1	1	9
OG0012277	2	2	1	1	1	1	1	9
OG0012278	2	2	1	1	1	1	1	9
OG0012279	2	2	1	1	1	1	1	9
OG0012280	1	3	1	0	1	1	2	9
OG0012281	2	2	1	1	1	1	1	9
OG0012282	2	2	1	1	1	1	1	9
OG0012283	1	3	1	1	1	1	1	9
OG0012284	2	2	1	1	1	1	1	9
OG0012285	1	3	1	1	1	1	1	9
OG0012286	2	2	1	1	1	1	1	9
OG0012287	2	2	1	1	1	1	1	9
OG0012288	2	2	1	1	1	1	1	9
OG0012289	1	3	1	1	1	1	1	9
OG0012290	2	2	1	1	1	1	1	9
OG0012291	1	3	1	1	1	1	1	9
OG0012292	1	4	1	0	1	1	1	9
OG0012293	1	3	1	1	1	1	1	9
OG0012294	2	3	1	0	1	1	1	9
OG0012295	2	2	1	1	1	1	1	9
OG0012296	2	3	1	0	1	1	1	9
OG0012297	9	0	0	0	0	0	0	9
OG0012298	2	3	1	1	1	1	0	9
OG0012299	2	2	1	1	1	1	1	9
OG0012300	2	3	1	1	1	1	0	9
OG0012301	2	2	1	1	1	1	1	9
OG0012302	2	2	1	1	1	1	1	9
OG0012303	2	3	1	1	1	0	1	9
OG0012304	1	3	1	1	1	1	1	9
OG0012305	2	3	1	1	1	1	0	9
OG0012306	1	2	1	1	1	1	2	9
OG0012307	3	0	2	1	1	1	1	9
OG0012308	1	3	1	1	1	1	1	9
OG0012309	2	2	1	1	1	1	1	9
OG0012310	1	3	1	1	1	1	1	9
OG0012311	2	3	1	1	0	1	1	9
OG0012312	2	2	1	1	1	1	1	9
OG0012313	1	3	1	1	1	1	1	9
OG0012314	1	3	1	1	1	1	1	9
OG0012315	2	2	1	1	1	1	1	9
OG0012316	1	5	1	1	0	0	1	9
OG0012317	2	3	1	1	1	1	0	9
OG0012318	2	2	1	1	1	1	1	9
OG0012319	1	3	1	1	1	1	1	9
OG0012320	2	3	1	1	1	0	1	9
OG0012321	2	2	1	1	1	1	1	9
OG0012322	2	2	1	1	1	1	1	9
OG0012323	2	3	1	0	1	1	1	9
OG0012324	1	3	1	2	1	0	1	9
OG0012325	1	3	1	1	2	1	0	9
OG0012326	1	3	1	1	1	1	1	9
OG0012327	1	3	1	1	1	1	1	9
OG0012328	2	3	1	1	1	1	0	9
OG0012329	3	1	1	1	1	1	1	9
OG0012330	2	2	1	1	1	1	1	9
OG0012331	2	1	1	2	1	1	1	9
OG0012332	2	2	1	1	1	1	1	9
OG0012333	2	2	1	1	1	1	1	9
OG0012334	2	2	1	1	1	1	1	9
OG0012335	2	2	1	1	1	1	1	9
OG0012336	2	4	1	0	0	1	1	9
OG0012337	2	3	1	1	1	1	0	9
OG0012338	2	2	1	1	1	1	1	9
OG0012339	1	3	1	1	1	1	1	9
OG0012340	1	3	1	1	1	1	1	9
OG0012341	2	2	1	1	1	1	1	9
OG0012342	2	3	2	0	0	0	2	9
OG0012343	1	3	1	1	1	1	1	9
OG0012344	1	3	1	1	1	1	1	9
OG0012345	1	3	1	1	1	1	1	9
OG0012346	2	2	1	1	1	1	1	9
OG0012347	2	2	1	1	1	1	1	9
OG0012348	1	3	1	1	1	1	1	9
OG0012349	2	2	1	1	1	1	1	9
OG0012350	2	2	1	1	1	1	1	9
OG0012351	2	2	1	1	1	1	1	9
OG0012352	2	1	1	1	1	1	2	9
OG0012353	2	2	1	1	1	1	1	9
OG0012354	1	2	1	2	1	1	1	9
OG0012355	1	3	1	1	1	1	1	9
OG0012356	2	2	1	1	1	1	1	9
OG0012357	1	3	1	1	1	1	1	9
OG0012358	2	2	1	1	1	1	1	9
OG0012359	2	2	1	1	1	1	1	9
OG0012360	2	2	1	1	1	1	1	9
OG0012361	1	2	2	1	1	1	1	9
OG0012362	2	2	1	1	1	1	1	9
OG0012363	1	4	1	1	0	1	1	9
OG0012364	1	3	1	1	1	1	1	9
OG0012365	2	2	1	1	1	1	1	9
OG0012366	2	2	1	1	1	1	1	9
OG0012367	1	3	1	1	1	1	1	9
OG0012368	1	3	1	1	1	1	1	9
OG0012369	2	2	1	1	1	1	1	9
OG0012370	1	3	1	1	1	1	1	9
OG0012371	1	4	1	1	1	0	1	9
OG0012372	2	2	1	1	1	1	1	9
OG0012373	2	2	1	1	1	1	1	9
OG0012374	3	1	1	1	1	1	1	9
OG0012375	1	3	1	1	1	1	1	9
OG0012376	2	3	1	1	0	1	1	9
OG0012377	2	3	1	1	1	1	0	9
OG0012378	2	2	1	1	1	1	1	9
OG0012379	1	3	1	1	1	1	1	9
OG0012380	2	3	1	1	1	1	0	9
OG0012381	2	2	1	1	1	1	1	9
OG0012382	2	2	1	1	1	1	1	9
OG0012383	1	3	1	1	1	1	1	9
OG0012384	1	3	1	1	1	1	1	9
OG0012385	2	3	1	1	0	1	1	9
OG0012386	1	3	1	1	1	1	1	9
OG0012387	2	2	1	1	1	1	1	9
OG0012388	2	2	1	2	1	0	1	9
OG0012389	1	3	1	1	1	1	1	9
OG0012390	2	2	1	1	1	1	1	9
OG0012391	1	3	1	1	1	1	1	9
OG0012392	1	3	1	1	1	1	1	9
OG0012393	2	2	1	1	1	1	1	9
OG0012394	2	2	1	1	1	1	1	9
OG0012395	2	2	1	1	1	1	1	9
OG0012396	1	3	1	1	1	1	1	9
OG0012397	1	3	1	1	1	1	1	9
OG0012398	1	2	2	1	0	1	2	9
OG0012399	2	2	1	1	1	1	1	9
OG0012400	2	2	1	1	1	1	1	9
OG0012401	2	3	1	1	0	1	1	9
OG0012402	1	3	1	1	1	1	1	9
OG0012403	3	1	1	1	1	1	1	9
OG0012404	1	3	1	1	1	1	1	9
OG0012405	1	3	1	1	1	1	1	9
OG0012406	1	4	0	1	1	1	1	9
OG0012407	2	2	1	1	1	1	1	9
OG0012408	1	3	1	1	1	1	1	9
OG0012409	2	2	1	1	1	1	1	9
OG0012410	1	3	1	1	1	1	1	9
OG0012411	2	2	1	1	1	1	1	9
OG0012412	1	3	1	1	1	1	1	9
OG0012413	2	2	1	1	1	1	1	9
OG0012414	2	2	1	1	1	1	1	9
OG0012415	2	3	1	0	1	1	1	9
OG0012416	2	3	1	1	1	1	0	9
OG0012417	1	3	1	1	1	1	1	9
OG0012418	2	2	1	1	1	1	1	9
OG0012419	2	2	1	1	1	1	1	9
OG0012420	2	2	1	1	1	1	1	9
OG0012421	2	2	1	1	1	1	1	9
OG0012422	1	4	1	1	0	1	1	9
OG0012423	2	2	1	1	1	1	1	9
OG0012424	2	2	1	1	1	1	1	9
OG0012425	2	2	1	1	1	1	1	9
OG0012426	2	3	1	1	1	0	1	9
OG0012427	2	3	2	0	0	0	2	9
OG0012428	1	4	1	1	0	1	1	9
OG0012429	2	2	1	1	1	1	1	9
OG0012430	2	3	1	1	0	1	1	9
OG0012431	2	2	1	1	1	1	1	9
OG0012432	2	2	1	1	1	1	1	9
OG0012433	2	2	1	1	1	1	1	9
OG0012434	2	2	1	1	1	1	1	9
OG0012435	2	2	1	1	1	1	1	9
OG0012436	2	3	1	1	1	1	0	9
OG0012437	1	3	1	1	1	1	1	9
OG0012438	2	2	1	1	2	0	1	9
OG0012439	1	3	1	1	1	1	1	9
OG0012440	2	2	1	1	1	1	1	9
OG0012441	2	2	1	1	1	1	1	9
OG0012442	2	2	1	1	1	1	1	9
OG0012443	2	2	1	1	1	1	1	9
OG0012444	2	3	1	1	1	1	0	9
OG0012445	2	2	1	1	1	1	1	9
OG0012446	1	3	1	1	1	1	1	9
OG0012447	2	3	1	1	1	1	0	9
OG0012448	1	3	1	1	1	1	1	9
OG0012449	2	2	1	1	1	1	1	9
OG0012450	2	2	1	1	1	1	1	9
OG0012451	2	2	1	1	1	1	1	9
OG0012452	1	3	1	1	1	1	1	9
OG0012453	2	2	1	1	1	1	1	9
OG0012454	2	2	1	1	1	1	1	9
OG0012455	1	5	1	1	0	1	0	9
OG0012456	2	2	1	1	1	1	1	9
OG0012457	2	2	1	0	1	1	2	9
OG0012458	2	2	1	1	1	1	1	9
OG0012459	2	3	1	1	1	0	1	9
OG0012460	2	2	1	1	1	1	1	9
OG0012461	3	1	1	1	1	1	1	9
OG0012462	2	2	1	1	1	1	1	9
OG0012463	3	2	1	1	0	1	1	9
OG0012464	1	3	1	1	1	1	1	9
OG0012465	1	3	1	1	1	1	1	9
OG0012466	2	3	1	1	1	0	1	9
OG0012467	2	2	1	1	1	1	1	9
OG0012468	1	2	1	1	1	2	1	9
OG0012469	1	3	1	1	1	1	1	9
OG0012470	1	4	1	1	1	0	1	9
OG0012471	2	2	1	1	1	1	1	9
OG0012472	2	2	1	1	1	1	1	9
OG0012473	1	3	1	1	1	1	1	9
OG0012474	2	2	1	1	1	1	1	9
OG0012475	2	3	1	0	1	1	1	9
OG0012476	1	3	1	1	1	1	1	9
OG0012477	2	3	1	1	0	1	1	9
OG0012478	1	3	1	1	1	1	1	9
OG0012479	2	2	1	1	1	1	1	9
OG0012480	1	3	0	3	0	1	1	9
OG0012481	2	2	1	1	1	1	1	9
OG0012482	2	2	1	1	1	1	1	9
OG0012483	2	1	1	1	1	1	2	9
OG0012484	1	3	1	1	1	1	1	9
OG0012485	1	3	1	1	1	1	1	9
OG0012486	1	3	1	1	1	1	1	9
OG0012487	1	2	1	2	1	1	1	9
OG0012488	1	3	1	1	1	1	1	9
OG0012489	2	3	1	1	1	1	0	9
OG0012490	1	3	1	1	1	1	1	9
OG0012491	2	2	1	1	1	1	1	9
OG0012492	2	2	1	1	1	1	1	9
OG0012493	1	4	1	1	1	1	0	9
OG0012494	1	3	1	1	1	1	1	9
OG0012495	2	3	1	1	0	1	1	9
OG0012496	1	3	1	1	1	1	1	9
OG0012497	1	2	1	1	1	2	1	9
OG0012498	2	3	1	1	0	1	1	9
OG0012499	1	3	1	1	1	1	1	9
OG0012500	2	2	1	1	1	1	1	9
OG0012501	1	3	1	1	1	1	1	9
OG0012502	1	6	1	1	0	0	0	9
OG0012503	1	3	1	1	1	1	1	9
OG0012504	1	3	1	1	1	1	1	9
OG0012505	2	3	1	1	1	0	1	9
OG0012506	1	3	1	1	1	1	1	9
OG0012507	4	0	1	1	1	1	1	9
OG0012508	1	3	1	1	1	1	1	9
OG0012509	2	2	1	1	1	1	1	9
OG0012510	2	2	1	1	1	1	1	9
OG0012511	2	2	1	1	1	1	1	9
OG0012512	2	3	1	1	0	1	1	9
OG0012513	1	3	1	1	1	1	1	9
OG0012514	1	3	1	1	1	1	1	9
OG0012515	1	3	1	1	1	1	1	9
OG0012516	1	3	1	1	1	1	1	9
OG0012517	1	2	1	1	1	2	1	9
OG0012518	1	3	1	1	1	1	1	9
OG0012519	2	3	1	1	1	0	1	9
OG0012520	1	3	1	1	1	1	1	9
OG0012521	1	3	1	1	0	1	2	9
OG0012522	1	3	1	1	1	1	1	9
OG0012523	2	2	1	1	2	0	1	9
OG0012524	1	3	1	1	1	1	1	9
OG0012525	2	3	1	1	1	1	0	9
OG0012526	2	2	1	1	1	1	1	9
OG0012527	1	3	1	1	1	1	1	9
OG0012528	1	3	1	1	1	1	1	9
OG0012529	1	3	1	1	1	1	1	9
OG0012530	2	2	1	1	1	1	1	9
OG0012531	2	3	1	1	1	1	0	9
OG0012532	2	2	1	1	1	1	1	9
OG0012533	2	3	1	1	1	0	1	9
OG0012534	1	2	1	1	1	0	3	9
OG0012535	2	2	1	1	1	1	1	9
OG0012536	1	3	1	0	2	1	1	9
OG0012537	2	3	1	1	1	1	0	9
OG0012538	1	3	1	1	1	1	1	9
OG0012539	2	3	2	0	0	1	1	9
OG0012540	2	2	1	1	1	1	1	9
OG0012541	2	3	1	1	1	0	1	9
OG0012542	1	3	1	1	1	1	1	9
OG0012543	2	3	1	1	1	0	1	9
OG0012544	1	3	1	1	1	1	1	9
OG0012545	1	4	1	1	0	1	1	9
OG0012546	1	3	1	1	1	1	1	9
OG0012547	1	3	1	1	1	1	1	9
OG0012548	2	5	1	0	0	0	1	9
OG0012549	1	3	1	1	1	1	1	9
OG0012550	2	4	1	1	0	0	1	9
OG0012551	2	3	1	1	1	1	0	9
OG0012552	1	3	1	1	1	1	1	9
OG0012553	2	2	1	1	1	1	1	9
OG0012554	1	3	1	1	1	1	1	9
OG0012555	1	3	1	1	1	1	1	9
OG0012556	2	2	1	1	1	1	1	9
OG0012557	2	2	1	1	1	1	1	9
OG0012558	2	2	1	1	1	1	1	9
OG0012559	2	3	1	1	0	1	1	9
OG0012560	2	2	1	1	1	1	1	9
OG0012561	2	1	1	2	1	1	1	9
OG0012562	1	3	1	1	1	1	1	9
OG0012563	2	3	1	1	1	1	0	9
OG0012564	2	2	1	1	1	1	1	9
OG0012565	1	3	1	1	1	1	1	9
OG0012566	2	2	1	1	1	1	1	9
OG0012567	2	3	1	1	1	0	1	9
OG0012568	2	3	1	1	0	1	1	9
OG0012569	2	3	1	1	1	0	1	9
OG0012570	2	3	1	1	1	0	1	9
OG0012571	2	2	1	1	1	1	1	9
OG0012572	2	2	1	1	1	1	1	9
OG0012573	2	2	1	1	1	1	1	9
OG0012574	1	3	1	1	1	1	1	9
OG0012575	2	2	1	1	1	1	1	9
OG0012576	1	3	1	1	1	1	1	9
OG0012577	2	2	1	1	1	1	1	9
OG0012578	1	3	1	1	1	1	1	9
OG0012579	2	2	1	1	1	1	1	9
OG0012580	1	3	2	1	1	1	0	9
OG0012581	2	2	1	1	1	1	1	9
OG0012582	2	2	1	1	1	1	1	9
OG0012583	1	3	1	1	1	1	1	9
OG0012584	2	2	1	1	1	1	1	9
OG0012585	1	4	1	1	0	1	1	9
OG0012586	2	2	1	1	1	1	1	9
OG0012587	2	3	1	1	1	1	0	9
OG0012588	2	3	1	1	1	0	1	9
OG0012589	2	2	1	1	1	1	1	9
OG0012590	2	1	1	1	1	2	1	9
OG0012591	1	3	1	1	1	1	1	9
OG0012592	2	2	1	1	1	1	1	9
OG0012593	2	2	1	1	1	1	1	9
OG0012594	1	2	1	1	1	1	2	9
OG0012595	1	3	1	1	1	1	1	9
OG0012596	1	3	1	1	1	1	1	9
OG0012597	1	4	1	1	1	1	0	9
OG0012598	2	2	1	1	1	1	1	9
OG0012599	2	2	1	1	1	1	1	9
OG0012600	2	3	1	1	1	0	1	9
OG0012601	2	2	1	1	1	1	1	9
OG0012602	2	3	1	1	0	1	1	9
OG0012603	1	3	1	1	1	1	1	9
OG0012604	1	3	1	1	1	1	1	9
OG0012605	2	2	1	1	1	1	1	9
OG0012606	1	3	1	1	1	1	1	9
OG0012607	2	2	1	1	1	1	1	9
OG0012608	1	3	1	1	1	1	1	9
OG0012609	2	3	1	1	1	0	1	9
OG0012610	1	3	1	1	1	1	1	9
OG0012611	2	2	1	1	1	1	1	9
OG0012612	1	3	1	1	1	1	1	9
OG0012613	2	3	1	1	0	1	1	9
OG0012614	1	2	1	1	2	1	1	9
OG0012615	2	2	1	1	1	1	1	9
OG0012616	2	2	1	1	1	1	1	9
OG0012617	1	3	1	1	1	1	1	9
OG0012618	1	3	1	1	1	1	1	9
OG0012619	2	2	1	1	1	1	1	9
OG0012620	2	2	1	1	1	1	1	9
OG0012621	2	2	1	1	1	1	1	9
OG0012622	2	3	1	1	1	1	0	9
OG0012623	2	2	1	1	1	1	1	9
OG0012624	2	3	1	1	1	0	1	9
OG0012625	2	2	1	1	1	1	1	9
OG0012626	1	3	1	1	1	1	1	9
OG0012627	1	3	1	1	1	1	1	9
OG0012628	1	3	1	1	1	1	1	9
OG0012629	2	3	1	1	1	0	1	9
OG0012630	2	2	1	1	1	1	1	9
OG0012631	2	2	1	1	1	1	1	9
OG0012632	2	2	1	1	1	1	1	9
OG0012633	2	4	1	1	0	0	1	9
OG0012634	2	4	1	1	0	0	1	9
OG0012635	2	2	1	1	1	1	1	9
OG0012636	1	3	1	1	1	1	1	9
OG0012637	1	3	1	1	1	1	1	9
OG0012638	2	2	1	1	1	1	1	9
OG0012639	1	2	3	1	1	0	1	9
OG0012640	2	3	1	0	1	1	1	9
OG0012641	2	2	1	1	1	1	1	9
OG0012642	2	3	1	1	0	1	1	9
OG0012643	2	2	1	1	1	1	1	9
OG0012644	1	3	1	1	1	1	1	9
OG0012645	2	2	1	1	1	1	1	9
OG0012646	2	2	1	1	1	1	1	9
OG0012647	2	3	1	1	1	0	1	9
OG0012648	1	3	1	1	1	1	1	9
OG0012649	1	4	1	1	1	1	0	9
OG0012650	2	2	1	1	1	1	1	9
OG0012651	2	2	1	1	1	1	1	9
OG0012652	1	3	1	1	1	1	1	9
OG0012653	1	3	1	1	1	1	1	9
OG0012654	1	3	1	1	1	1	1	9
OG0012655	2	2	1	1	1	1	1	9
OG0012656	1	4	1	1	1	0	1	9
OG0012657	2	2	1	1	1	1	1	9
OG0012658	2	2	1	1	1	1	1	9
OG0012659	1	3	1	1	1	1	1	9
OG0012660	1	3	1	1	1	1	1	9
OG0012661	2	2	1	1	1	0	2	9
OG0012662	2	2	1	1	1	1	1	9
OG0012663	1	3	1	1	1	1	1	9
OG0012664	2	2	1	1	1	1	1	9
OG0012665	2	2	1	1	1	1	1	9
OG0012666	1	3	1	1	1	1	1	9
OG0012667	2	2	1	1	1	1	1	9
OG0012668	2	2	1	1	1	1	1	9
OG0012669	1	3	1	1	1	1	1	9
OG0012670	2	2	1	1	1	1	1	9
OG0012671	2	2	1	1	1	1	1	9
OG0012672	3	1	1	1	1	1	1	9
OG0012673	3	1	1	1	1	1	1	9
OG0012674	2	2	1	1	1	1	1	9
OG0012675	1	3	1	1	1	1	1	9
OG0012676	2	2	1	1	1	1	1	9
OG0012677	2	2	1	1	1	1	1	9
OG0012678	2	0	1	1	2	1	2	9
OG0012679	2	3	1	0	1	1	1	9
OG0012680	2	2	1	1	1	1	1	9
OG0012681	2	3	1	1	1	1	0	9
OG0012682	1	3	1	1	1	1	1	9
OG0012683	1	4	1	1	1	0	1	9
OG0012684	2	2	1	1	1	1	1	9
OG0012685	2	2	1	1	1	1	1	9
OG0012686	1	3	1	1	1	1	1	9
OG0012687	1	3	1	1	1	1	1	9
OG0012688	2	2	1	1	1	1	1	9
OG0012689	2	2	1	1	1	1	1	9
OG0012690	2	2	1	1	1	1	1	9
OG0012691	2	2	1	1	1	1	1	9
OG0012692	2	3	1	1	0	1	1	9
OG0012693	2	2	1	1	1	1	1	9
OG0012694	1	3	1	1	1	1	1	9
OG0012695	2	2	1	1	1	1	1	9
OG0012696	2	2	1	1	1	1	1	9
OG0012697	1	3	1	1	1	1	1	9
OG0012698	3	2	1	1	1	0	1	9
OG0012699	2	2	1	1	1	1	1	9
OG0012700	2	2	1	1	1	1	1	9
OG0012701	2	4	2	1	0	0	0	9
OG0012702	1	4	1	1	1	1	0	9
OG0012703	2	2	1	1	1	1	1	9
OG0012704	2	2	1	1	1	1	1	9
OG0012705	2	3	1	1	1	0	1	9
OG0012706	2	2	1	1	1	1	1	9
OG0012707	1	3	1	1	1	1	1	9
OG0012708	2	2	1	1	1	1	1	9
OG0012709	2	2	1	1	1	1	1	9
OG0012710	2	2	1	1	1	1	1	9
OG0012711	2	2	1	1	1	1	1	9
OG0012712	1	2	1	1	1	1	2	9
OG0012713	2	2	1	1	1	1	1	9
OG0012714	2	2	1	1	1	1	1	9
OG0012715	1	3	1	1	1	1	1	9
OG0012716	1	1	2	2	2	1	0	9
OG0012717	1	3	1	1	1	1	1	9
OG0012718	1	2	1	1	1	0	3	9
OG0012719	2	2	1	1	1	1	1	9
OG0012720	1	5	0	1	1	1	0	9
OG0012721	1	3	1	1	1	1	1	9
OG0012722	2	4	1	0	0	1	1	9
OG0012723	2	2	1	1	1	1	1	9
OG0012724	2	2	1	1	1	1	1	9
OG0012725	1	3	1	1	1	1	1	9
OG0012726	2	2	1	1	1	1	1	9
OG0012727	1	3	1	1	1	1	1	9
OG0012728	1	3	1	1	1	1	1	9
OG0012729	2	2	1	1	1	1	1	9
OG0012730	2	2	1	1	1	1	1	9
OG0012731	2	2	1	1	1	1	1	9
OG0012732	2	4	1	1	0	0	1	9
OG0012733	2	2	1	1	1	1	1	9
OG0012734	2	2	1	1	1	1	1	9
OG0012735	2	2	1	1	1	1	1	9
OG0012736	2	2	1	1	1	1	1	9
OG0012737	2	2	1	1	1	1	1	9
OG0012738	2	2	1	1	1	1	1	9
OG0012739	2	2	1	1	1	1	1	9
OG0012740	1	3	1	1	1	1	1	9
OG0012741	1	3	1	1	1	1	1	9
OG0012742	1	3	1	1	1	1	1	9
OG0012743	1	3	1	1	1	1	1	9
OG0012744	1	3	1	1	1	1	1	9
OG0012745	2	2	1	1	1	1	1	9
OG0012746	2	2	1	1	1	1	1	9
OG0012747	2	2	1	1	1	1	1	9
OG0012748	1	3	1	1	1	1	1	9
OG0012749	2	2	1	1	1	1	1	9
OG0012750	1	3	1	1	1	1	1	9
OG0012751	2	2	1	1	1	1	1	9
OG0012752	1	4	1	1	1	1	0	9
OG0012753	2	2	1	1	1	1	1	9
OG0012754	1	4	1	1	0	0	2	9
OG0012755	2	2	1	1	1	1	1	9
OG0012756	2	2	1	1	1	1	1	9
OG0012757	2	2	1	1	1	1	1	9
OG0012758	1	3	1	1	1	1	1	9
OG0012759	1	3	1	1	1	1	1	9
OG0012760	2	2	1	1	1	1	1	9
OG0012761	2	2	1	1	1	1	1	9
OG0012762	1	3	1	1	1	1	1	9
OG0012763	2	3	1	1	1	1	0	9
OG0012764	2	2	1	1	1	1	1	9
OG0012765	2	2	1	0	1	2	1	9
OG0012766	2	2	1	1	1	1	1	9
OG0012767	1	3	1	1	1	1	1	9
OG0012768	1	3	1	1	1	1	1	9
OG0012769	2	3	1	1	2	0	0	9
OG0012770	1	3	1	1	1	1	1	9
OG0012771	2	2	1	1	1	1	1	9
OG0012772	1	3	1	1	1	1	1	9
OG0012773	2	3	1	1	0	1	1	9
OG0012774	2	2	1	1	1	1	1	9
OG0012775	2	2	1	1	1	1	1	9
OG0012776	2	2	1	1	1	1	1	9
OG0012777	1	4	1	1	1	1	0	9
OG0012778	1	2	1	2	1	1	1	9
OG0012779	2	1	2	1	1	1	1	9
OG0012780	1	3	1	1	1	1	1	9
OG0012781	1	4	1	1	1	0	1	9
OG0012782	1	4	1	1	1	0	1	9
OG0012783	2	2	1	1	1	1	1	9
OG0012784	2	3	1	1	1	0	1	9
OG0012785	2	2	1	1	1	1	1	9
OG0012786	1	3	1	1	1	1	1	9
OG0012787	1	4	1	0	1	1	1	9
OG0012788	2	3	1	0	1	1	1	9
OG0012789	2	2	1	1	1	1	1	9
OG0012790	2	2	1	1	1	1	1	9
OG0012791	1	3	1	1	1	1	1	9
OG0012792	2	1	2	1	1	1	1	9
OG0012793	1	5	0	0	0	1	2	9
OG0012794	1	4	1	1	1	0	1	9
OG0012795	2	2	1	1	1	1	1	9
OG0012796	2	2	1	1	1	1	1	9
OG0012797	1	3	1	1	1	1	1	9
OG0012798	2	3	1	0	1	1	1	9
OG0012799	2	2	1	1	1	1	1	9
OG0012800	2	2	1	1	1	1	1	9
OG0012801	1	3	1	1	1	1	1	9
OG0012802	2	2	1	1	1	1	1	9
OG0012803	1	3	1	1	1	1	1	9
OG0012804	1	3	1	1	1	1	1	9
OG0012805	1	5	0	1	1	1	0	9
OG0012806	1	3	1	1	1	1	1	9
OG0012807	2	2	1	1	1	1	1	9
OG0012808	1	3	1	1	1	1	1	9
OG0012809	2	2	1	1	1	1	1	9
OG0012810	2	2	1	1	1	1	1	9
OG0012811	1	3	1	1	1	1	1	9
OG0012812	2	2	1	1	1	1	1	9
OG0012813	1	3	1	1	1	1	1	9
OG0012814	2	1	1	1	0	2	2	9
OG0012815	1	3	1	1	1	1	1	9
OG0012816	1	4	1	1	1	0	1	9
OG0012817	2	2	1	1	1	1	1	9
OG0012818	2	3	1	1	1	1	0	9
OG0012819	1	3	1	1	1	0	2	9
OG0012820	2	2	1	1	1	1	1	9
OG0012821	2	2	1	1	1	1	1	9
OG0012822	2	2	1	1	1	1	1	9
OG0012823	2	2	1	1	1	1	1	9
OG0012824	2	2	1	1	1	1	1	9
OG0012825	2	2	1	1	1	1	1	9
OG0012826	2	2	1	1	1	1	1	9
OG0012827	2	2	1	1	1	1	1	9
OG0012828	2	2	1	1	1	1	1	9
OG0012829	1	3	1	1	1	1	1	9
OG0012830	2	2	1	1	1	1	1	9
OG0012831	2	3	1	1	0	1	1	9
OG0012832	2	3	1	1	1	0	1	9
OG0012833	1	3	1	1	1	1	1	9
OG0012834	1	3	1	1	1	1	1	9
OG0012835	2	2	1	1	1	1	1	9
OG0012836	1	4	1	1	1	1	0	9
OG0012837	2	2	1	1	1	1	1	9
OG0012838	1	3	1	1	1	1	1	9
OG0012839	2	2	1	1	1	1	1	9
OG0012840	2	3	1	0	1	1	1	9
OG0012841	1	3	1	1	1	1	1	9
OG0012842	2	2	1	1	1	1	1	9
OG0012843	1	3	1	1	1	1	1	9
OG0012844	1	3	1	1	1	1	1	9
OG0012845	2	2	1	1	1	1	1	9
OG0012846	2	4	1	1	0	0	1	9
OG0012847	2	3	1	1	0	1	1	9
OG0012848	2	2	1	1	1	1	1	9
OG0012849	3	1	1	1	1	1	1	9
OG0012850	2	2	1	1	1	1	1	9
OG0012851	1	4	1	1	1	1	0	9
OG0012852	1	3	1	1	1	1	1	9
OG0012853	2	1	1	1	1	1	2	9
OG0012854	2	2	1	1	1	1	1	9
OG0012855	1	4	1	1	1	1	0	9
OG0012856	2	2	1	1	1	1	1	9
OG0012857	1	3	1	1	1	1	1	9
OG0012858	2	2	1	1	1	1	1	9
OG0012859	1	3	1	1	1	1	1	9
OG0012860	1	3	1	1	1	1	1	9
OG0012861	2	3	1	1	1	0	1	9
OG0012862	2	2	1	1	1	1	1	9
OG0012863	1	3	1	1	1	1	1	9
OG0012864	1	3	1	1	1	1	1	9
OG0012865	2	2	1	1	1	1	1	9
OG0012866	1	3	1	1	1	0	2	9
OG0012867	2	2	1	1	1	1	1	9
OG0012868	2	2	1	1	1	1	1	9
OG0012869	1	3	1	1	1	1	1	9
OG0012870	1	3	1	1	1	1	1	9
OG0012871	2	2	1	1	1	1	1	9
OG0012872	2	2	1	1	1	1	1	9
OG0012873	2	2	1	1	1	1	1	9
OG0012874	2	2	1	1	1	1	1	9
OG0012875	2	1	1	1	1	2	1	9
OG0012876	1	3	1	1	1	1	1	9
OG0012877	2	2	1	1	1	1	1	9
OG0012878	2	3	1	1	1	0	1	9
OG0012879	2	2	1	1	1	0	2	9
OG0012880	2	2	1	1	1	1	1	9
OG0012881	1	4	1	1	0	1	1	9
OG0012882	2	2	1	1	1	1	1	9
OG0012883	1	3	1	1	1	1	1	9
OG0012884	2	2	1	1	1	1	1	9
OG0012885	2	2	1	1	1	1	1	9
OG0012886	2	4	1	1	0	1	0	9
OG0012887	1	3	1	1	1	1	1	9
OG0012888	2	2	1	1	1	1	1	9
OG0012889	2	2	1	1	1	1	1	9
OG0012890	2	3	1	1	1	1	0	9
OG0012891	1	3	1	1	1	1	1	9
OG0012892	1	3	1	1	1	1	1	9
OG0012893	2	2	1	1	1	1	1	9
OG0012894	1	3	1	1	1	1	1	9
OG0012895	3	2	1	1	1	0	1	9
OG0012896	3	1	1	1	1	1	1	9
OG0012897	1	3	1	1	1	1	1	9
OG0012898	2	1	1	1	0	2	2	9
OG0012899	1	3	1	1	1	1	1	9
OG0012900	2	2	1	1	1	1	1	9
OG0012901	2	2	1	1	1	1	1	9
OG0012902	2	3	1	1	1	1	0	9
OG0012903	2	3	1	1	1	1	0	9
OG0012904	1	3	1	1	1	1	1	9
OG0012905	1	3	1	1	1	1	1	9
OG0012906	2	2	1	1	1	1	1	9
OG0012907	2	2	1	1	1	1	1	9
OG0012908	1	3	1	1	1	1	1	9
OG0012909	2	3	1	1	1	0	1	9
OG0012910	2	2	1	1	1	1	1	9
OG0012911	2	2	1	1	2	0	1	9
OG0012912	2	3	1	0	1	1	1	9
OG0012913	1	2	1	1	2	1	1	9
OG0012914	1	3	1	1	1	1	1	9
OG0012915	2	2	1	1	1	1	1	9
OG0012916	2	2	1	1	1	1	1	9
OG0012917	2	2	1	1	1	1	1	9
OG0012918	1	3	1	1	1	1	1	9
OG0012919	2	2	1	1	1	1	1	9
OG0012920	1	3	1	1	1	1	1	9
OG0012921	1	4	1	1	1	0	1	9
OG0012922	1	3	1	1	1	1	1	9
OG0012923	1	4	1	1	1	0	1	9
OG0012924	1	3	1	1	1	1	1	9
OG0012925	1	3	1	1	1	1	1	9
OG0012926	2	2	1	1	1	1	1	9
OG0012927	2	3	1	1	1	0	1	9
OG0012928	1	1	1	1	1	2	2	9
OG0012929	1	3	1	1	1	1	1	9
OG0012930	2	2	1	1	1	1	1	9
OG0012931	1	3	1	1	1	1	1	9
OG0012932	1	3	1	1	1	1	1	9
OG0012933	2	3	1	1	1	0	1	9
OG0012934	2	2	1	1	1	1	1	9
OG0012935	1	3	1	1	1	1	1	9
OG0012936	2	2	1	1	1	1	1	9
OG0012937	2	2	1	1	1	1	1	9
OG0012938	2	2	1	1	1	1	1	9
OG0012939	1	3	1	1	1	1	1	9
OG0012940	2	2	1	1	1	1	1	9
OG0012941	2	2	1	1	1	1	1	9
OG0012942	1	3	0	1	1	1	2	9
OG0012943	2	2	1	1	1	1	1	9
OG0012944	1	2	1	1	1	2	1	9
OG0012945	2	2	1	1	1	1	1	9
OG0012946	1	4	1	1	1	1	0	9
OG0012947	2	3	1	1	1	1	0	9
OG0012948	1	2	2	1	1	1	1	9
OG0012949	2	3	1	1	1	1	0	9
OG0012950	1	3	1	1	1	1	1	9
OG0012951	2	2	1	1	1	1	1	9
OG0012952	1	3	1	1	1	1	1	9
OG0012953	1	3	1	1	1	1	1	9
OG0012954	2	2	1	1	1	1	1	9
OG0012955	1	3	1	1	1	1	1	9
OG0012956	1	3	1	1	1	1	1	9
OG0012957	2	2	1	1	1	1	1	9
OG0012958	1	3	1	1	1	1	1	9
OG0012959	2	2	1	1	1	1	1	9
OG0012960	1	3	1	1	1	1	1	9
OG0012961	2	2	1	1	1	1	1	9
OG0012962	1	2	1	1	1	2	1	9
OG0012963	2	2	1	1	1	1	1	9
OG0012964	1	3	1	1	1	1	1	9
OG0012965	1	3	1	1	1	1	1	9
OG0012966	1	3	1	1	1	1	1	9
OG0012967	2	2	1	1	1	1	1	9
OG0012968	2	2	1	1	1	1	1	9
OG0012969	2	2	1	1	1	1	1	9
OG0012970	2	2	1	1	1	1	1	9
OG0012971	1	3	1	1	1	1	1	9
OG0012972	2	2	1	1	1	1	1	9
OG0012973	1	3	1	1	1	1	1	9
OG0012974	2	2	1	1	1	1	1	9
OG0012975	1	4	1	1	1	0	1	9
OG0012976	1	4	1	1	0	1	1	9
OG0012977	2	1	1	1	1	1	2	9
OG0012978	2	2	1	1	1	1	1	9
OG0012979	2	3	1	1	1	1	0	9
OG0012980	2	3	1	0	1	1	1	9
OG0012981	2	3	0	1	1	1	1	9
OG0012982	1	2	2	1	1	1	1	9
OG0012983	2	2	1	1	1	1	1	9
OG0012984	1	3	1	1	1	1	1	9
OG0012985	2	2	1	1	1	1	1	9
OG0012986	1	3	1	1	1	1	1	9
OG0012987	2	2	1	1	1	1	1	9
OG0012988	1	3	1	1	1	1	1	9
OG0012989	1	3	1	1	1	1	1	9
OG0012990	2	3	1	1	1	0	1	9
OG0012991	2	2	1	1	0	2	1	9
OG0012992	2	2	1	1	1	1	1	9
OG0012993	1	4	1	1	1	0	1	9
OG0012994	2	2	1	1	1	1	1	9
OG0012995	2	2	1	1	1	1	1	9
OG0012996	1	3	1	1	1	1	1	9
OG0012997	1	3	1	1	1	1	1	9
OG0012998	2	3	1	1	1	0	1	9
OG0012999	2	2	1	1	1	1	1	9
OG0013000	1	3	1	1	1	1	1	9
OG0013001	2	2	1	1	1	1	1	9
OG0013002	2	2	1	1	1	1	1	9
OG0013003	1	3	1	1	1	1	1	9
OG0013004	2	2	1	1	1	1	1	9
OG0013005	1	3	1	1	1	1	1	9
OG0013006	1	3	1	1	1	1	1	9
OG0013007	2	2	1	1	1	1	1	9
OG0013008	2	4	1	1	1	0	0	9
OG0013009	1	3	1	1	1	1	1	9
OG0013010	2	2	1	1	1	1	1	9
OG0013011	2	3	1	1	1	1	0	9
OG0013012	2	2	1	1	1	1	1	9
OG0013013	1	3	1	1	1	1	1	9
OG0013014	1	3	1	1	1	1	1	9
OG0013015	2	2	1	1	1	1	1	9
OG0013016	1	3	1	1	1	1	1	9
OG0013017	2	2	1	1	1	0	2	9
OG0013018	1	4	1	1	0	1	1	9
OG0013019	2	4	1	1	1	0	0	9
OG0013020	2	2	1	1	1	1	1	9
OG0013021	1	3	1	1	1	1	1	9
OG0013022	2	4	1	1	1	0	0	9
OG0013023	2	2	1	1	1	1	1	9
OG0013024	1	4	1	1	0	1	1	9
OG0013025	1	3	1	1	1	1	1	9
OG0013026	2	3	1	1	1	1	0	9
OG0013027	2	2	1	1	1	1	1	9
OG0013028	1	3	1	1	1	1	1	9
OG0013029	1	4	1	1	1	1	0	9
OG0013030	2	3	1	0	1	1	1	9
OG0013031	1	3	1	1	1	1	1	9
OG0013032	2	2	1	1	1	1	1	9
OG0013033	2	2	1	1	1	1	1	9
OG0013034	2	2	1	1	1	1	1	9
OG0013035	1	2	1	1	1	1	2	9
OG0013036	1	3	1	1	1	1	1	9
OG0013037	2	2	1	1	1	1	1	9
OG0013038	1	3	1	1	1	1	1	9
OG0013039	1	3	1	1	1	1	1	9
OG0013040	2	2	1	1	1	0	2	9
OG0013041	2	2	1	1	1	1	1	9
OG0013042	2	4	1	1	0	0	1	9
OG0013043	1	4	1	1	1	0	1	9
OG0013044	2	3	1	1	0	1	1	9
OG0013045	1	3	1	1	1	1	1	9
OG0013046	2	2	1	1	1	1	1	9
OG0013047	1	3	1	1	1	1	1	9
OG0013048	1	3	1	1	1	1	1	9
OG0013049	1	3	1	1	1	1	1	9
OG0013050	2	3	1	1	1	1	0	9
OG0013051	2	2	1	1	1	1	1	9
OG0013052	1	3	1	1	1	1	1	9
OG0013053	1	4	1	1	1	1	0	9
OG0013054	2	2	1	1	1	1	1	9
OG0013055	2	3	1	1	0	1	1	9
OG0013056	1	3	1	1	1	1	1	9
OG0013057	1	4	1	1	1	1	0	9
OG0013058	1	3	1	1	1	1	1	9
OG0013059	2	3	1	1	0	1	1	9
OG0013060	1	3	1	1	1	1	1	9
OG0013061	1	2	1	1	1	2	1	9
OG0013062	1	3	1	1	1	1	1	9
OG0013063	1	3	1	1	1	1	1	9
OG0013064	2	2	1	1	1	1	1	9
OG0013065	2	2	1	1	1	1	1	9
OG0013066	1	2	1	1	1	1	2	9
OG0013067	1	3	1	1	1	1	1	9
OG0013068	1	4	1	0	1	1	1	9
OG0013069	2	2	1	1	1	1	1	9
OG0013070	1	3	1	1	1	1	1	9
OG0013071	2	1	1	1	1	1	2	9
OG0013072	1	3	1	1	1	1	1	9
OG0013073	1	3	1	1	1	1	1	9
OG0013074	3	1	1	1	1	1	1	9
OG0013075	1	3	1	1	1	1	1	9
OG0013076	1	2	1	1	0	2	2	9
OG0013077	1	3	1	1	1	0	2	9
OG0013078	1	3	1	1	1	1	1	9
OG0013079	1	3	1	1	1	1	1	9
OG0013080	2	2	1	1	1	1	1	9
OG0013081	2	2	1	1	1	1	1	9
OG0013082	2	2	1	1	1	1	1	9
OG0013083	1	3	1	1	1	1	1	9
OG0013084	1	3	1	1	1	1	1	9
OG0013085	1	3	1	1	1	1	1	9
OG0013086	2	2	1	1	1	1	1	9
OG0013087	2	2	1	1	1	1	1	9
OG0013088	1	3	1	1	1	1	1	9
OG0013089	1	3	1	1	1	1	1	9
OG0013090	2	2	1	1	1	1	1	9
OG0013091	2	2	1	1	1	1	1	9
OG0013092	1	3	1	1	1	1	1	9
OG0013093	2	2	1	1	1	1	1	9
OG0013094	2	2	1	1	1	1	1	9
OG0013095	1	3	1	1	1	1	1	9
OG0013096	1	3	1	1	1	1	1	9
OG0013097	2	2	1	1	1	1	1	9
OG0013098	1	0	2	2	1	2	1	9
OG0013099	2	2	1	1	1	1	1	9
OG0013100	1	5	1	0	1	0	1	9
OG0013101	2	2	1	1	1	1	1	9
OG0013102	2	2	1	1	1	1	1	9
OG0013103	1	3	1	1	1	1	1	9
OG0013104	2	2	1	1	1	1	1	9
OG0013105	1	3	1	1	1	1	1	9
OG0013106	2	2	1	1	1	1	1	9
OG0013107	2	3	1	1	0	1	1	9
OG0013108	2	2	1	1	1	1	1	9
OG0013109	2	2	1	1	1	1	1	9
OG0013110	1	3	1	1	1	1	1	9
OG0013111	2	2	1	1	1	1	1	9
OG0013112	2	2	1	1	1	1	1	9
OG0013113	1	3	1	1	1	1	1	9
OG0013114	2	2	1	1	1	1	1	9
OG0013115	2	2	1	1	1	1	1	9
OG0013116	2	2	1	1	1	1	1	9
OG0013117	2	2	1	1	1	1	1	9
OG0013118	1	3	1	1	1	1	1	9
OG0013119	1	3	1	1	1	1	1	9
OG0013120	2	2	1	1	1	1	1	9
OG0013121	2	2	1	1	1	1	1	9
OG0013122	1	3	1	1	1	1	1	9
OG0013123	2	4	1	1	0	1	0	9
OG0013124	2	2	1	1	1	1	1	9
OG0013125	1	3	1	1	1	1	1	9
OG0013126	1	3	1	1	1	1	1	9
OG0013127	2	3	1	1	1	1	0	9
OG0013128	1	3	0	1	2	1	1	9
OG0013129	1	3	1	1	1	1	1	9
OG0013130	2	2	1	1	1	1	1	9
OG0013131	1	2	1	1	1	2	1	9
OG0013132	2	2	1	1	1	1	1	9
OG0013133	2	3	1	1	1	0	1	9
OG0013134	2	2	1	1	1	1	1	9
OG0013135	2	3	1	1	1	0	1	9
OG0013136	1	3	1	1	1	1	1	9
OG0013137	1	4	1	1	1	0	1	9
OG0013138	1	3	1	1	1	1	1	9
OG0013139	1	4	1	1	1	1	0	9
OG0013140	2	2	1	1	1	1	1	9
OG0013141	1	4	1	1	1	0	1	9
OG0013142	1	3	1	1	1	1	1	9
OG0013143	2	2	1	1	1	1	1	9
OG0013144	2	3	1	1	1	0	1	9
OG0013145	1	4	1	1	0	1	1	9
OG0013146	2	2	1	1	1	1	1	9
OG0013147	1	3	1	1	1	1	1	9
OG0013148	1	3	1	1	1	1	1	9
OG0013149	1	3	1	1	1	1	1	9
OG0013150	2	2	1	1	1	1	1	9
OG0013151	1	4	1	0	1	1	1	9
OG0013152	1	3	1	1	1	1	1	9
OG0013153	1	3	1	2	1	0	1	9
OG0013154	2	3	1	1	1	1	0	9
OG0013155	1	3	1	1	1	1	1	9
OG0013156	2	2	1	1	1	1	1	9
OG0013157	2	5	1	0	0	0	1	9
OG0013158	2	2	1	1	1	1	1	9
OG0013159	2	2	1	1	1	1	1	9
OG0013160	1	3	1	1	1	1	1	9
OG0013161	1	3	1	1	1	1	1	9
OG0013162	2	2	1	1	1	1	1	9
OG0013163	1	3	1	1	1	1	1	9
OG0013164	1	3	1	1	1	1	1	9
OG0013165	1	2	1	1	1	2	1	9
OG0013166	1	3	1	1	1	1	1	9
OG0013167	1	4	1	1	1	0	1	9
OG0013168	2	2	1	1	1	1	1	9
OG0013169	1	4	1	1	1	1	0	9
OG0013170	1	2	2	1	1	1	1	9
OG0013171	1	3	1	1	1	1	1	9
OG0013172	2	2	1	1	1	1	1	9
OG0013173	1	3	1	1	1	1	1	9
OG0013174	1	4	1	1	1	0	1	9
OG0013175	2	2	1	1	1	1	1	9
OG0013176	3	1	1	1	1	1	1	9
OG0013177	2	2	1	1	1	1	1	9
OG0013178	1	3	1	1	1	1	1	9
OG0013179	2	1	1	2	1	0	2	9
OG0013180	1	3	1	1	1	1	1	9
OG0013181	1	3	1	1	1	1	1	9
OG0013182	1	3	1	1	1	1	1	9
OG0013183	1	3	1	1	1	1	1	9
OG0013184	1	2	1	1	1	2	1	9
OG0013185	2	2	1	1	1	1	1	9
OG0013186	1	3	1	1	1	1	1	9
OG0013187	2	2	1	1	1	1	1	9
OG0013188	1	3	1	1	1	1	1	9
OG0013189	1	3	1	1	1	1	1	9
OG0013190	2	2	1	1	1	1	1	9
OG0013191	2	2	1	1	1	1	1	9
OG0013192	1	3	1	1	1	1	1	9
OG0013193	1	3	1	1	1	1	1	9
OG0013194	2	2	1	1	1	1	1	9
OG0013195	2	2	1	1	1	1	1	9
OG0013196	1	3	1	1	1	1	1	9
OG0013197	1	3	1	1	1	1	1	9
OG0013198	2	2	1	1	1	1	1	9
OG0013199	2	2	1	1	1	1	1	9
OG0013200	2	3	1	1	1	0	1	9
OG0013201	2	2	1	1	1	1	1	9
OG0013202	2	2	1	1	1	1	1	9
OG0013203	1	3	1	1	1	1	1	9
OG0013204	2	2	1	1	1	1	1	9
OG0013205	2	3	1	1	1	1	0	9
OG0013206	1	3	1	1	1	1	1	9
OG0013207	1	1	2	2	1	1	1	9
OG0013208	1	3	1	1	1	1	1	9
OG0013209	2	2	1	1	1	1	1	9
OG0013210	2	3	1	1	1	1	0	9
OG0013211	2	3	1	1	1	0	1	9
OG0013212	1	3	1	1	1	1	1	9
OG0013213	2	2	1	1	1	1	1	9
OG0013214	2	4	1	1	1	0	0	9
OG0013215	1	3	1	1	1	1	1	9
OG0013216	2	2	1	1	1	1	1	9
OG0013217	2	2	1	1	1	1	1	9
OG0013218	2	2	1	1	1	1	1	9
OG0013219	1	3	1	1	1	1	1	9
OG0013220	2	4	1	1	0	1	0	9
OG0013221	1	3	1	1	1	1	1	9
OG0013222	2	2	1	1	1	1	1	9
OG0013223	2	3	1	1	1	0	1	9
OG0013224	2	3	1	1	0	0	2	9
OG0013225	1	3	1	1	1	0	2	9
OG0013226	1	3	1	1	1	1	1	9
OG0013227	1	3	1	1	1	1	1	9
OG0013228	2	2	1	1	1	1	1	9
OG0013229	1	3	1	1	1	1	1	9
OG0013230	1	4	1	1	1	1	0	9
OG0013231	1	4	2	1	0	0	1	9
OG0013232	2	2	1	1	1	1	1	9
OG0013233	2	3	1	0	1	1	1	9
OG0013234	2	1	1	2	1	1	1	9
OG0013235	1	3	1	1	1	1	1	9
OG0013236	1	3	1	1	1	1	1	9
OG0013237	1	3	1	1	1	1	1	9
OG0013238	2	2	1	1	1	1	1	9
OG0013239	2	3	1	1	0	1	1	9
OG0013240	1	3	1	1	1	1	1	9
OG0013241	1	3	1	1	1	1	1	9
OG0013242	2	3	1	1	1	0	1	9
OG0013243	1	3	1	1	1	1	1	9
OG0013244	2	2	1	1	1	1	1	9
OG0013245	1	3	1	1	1	1	1	9
OG0013246	2	1	1	1	1	1	2	9
OG0013247	1	3	1	1	1	1	1	9
OG0013248	1	3	1	1	1	1	1	9
OG0013249	1	3	2	1	1	1	0	9
OG0013250	1	3	1	1	1	1	1	9
OG0013251	2	2	1	1	1	1	1	9
OG0013252	2	2	1	1	1	1	1	9
OG0013253	2	3	1	1	1	1	0	9
OG0013254	1	3	1	1	1	1	1	9
OG0013255	2	1	1	2	1	1	1	9
OG0013256	1	2	1	1	1	1	2	9
OG0013257	2	2	1	1	1	1	1	9
OG0013258	2	2	1	1	1	1	1	9
OG0013259	1	4	1	1	1	0	1	9
OG0013260	2	2	1	1	1	1	1	9
OG0013261	2	2	1	1	1	1	1	9
OG0013262	2	2	1	1	1	1	1	9
OG0013263	2	2	1	1	1	1	1	9
OG0013264	1	3	1	1	1	1	1	9
OG0013265	1	3	1	1	1	1	1	9
OG0013266	1	3	1	1	1	1	1	9
OG0013267	2	2	1	1	1	1	1	9
OG0013268	1	3	1	1	1	1	1	9
OG0013269	2	3	1	1	0	1	1	9
OG0013270	2	2	1	1	1	1	1	9
OG0013271	2	4	1	0	0	1	1	9
OG0013272	1	3	1	1	1	1	1	9
OG0013273	2	2	1	1	1	1	1	9
OG0013274	1	4	1	1	1	0	1	9
OG0013275	1	3	1	1	1	1	1	9
OG0013276	2	2	1	1	1	1	1	9
OG0013277	1	4	1	1	1	0	1	9
OG0013278	2	2	1	1	1	1	1	9
OG0013279	1	3	1	1	1	1	1	9
OG0013280	1	3	1	1	1	1	1	9
OG0013281	1	4	1	0	1	1	1	9
OG0013282	2	3	1	1	1	1	0	9
OG0013283	3	2	1	1	0	1	1	9
OG0013284	1	4	1	1	1	1	0	9
OG0013285	1	3	1	1	1	1	1	9
OG0013286	1	3	1	1	1	1	1	9
OG0013287	1	3	1	1	1	1	1	9
OG0013288	1	3	1	1	1	1	1	9
OG0013289	2	2	1	1	1	1	1	9
OG0013290	2	2	1	1	1	1	1	9
OG0013291	1	3	1	1	1	1	1	9
OG0013292	2	2	1	1	1	1	1	9
OG0013293	2	3	1	1	1	1	0	9
OG0013294	2	2	1	1	1	1	1	9
OG0013295	1	4	1	1	1	0	1	9
OG0013296	1	3	1	1	1	1	1	9
OG0013297	2	2	1	1	1	1	1	9
OG0013298	2	3	1	1	1	0	1	9
OG0013299	1	4	1	1	0	1	1	9
OG0013300	1	6	0	0	1	0	1	9
OG0013301	1	3	1	1	1	1	1	9
OG0013302	1	3	1	1	1	1	1	9
OG0013303	2	2	1	1	1	1	1	9
OG0013304	2	4	1	1	0	1	0	9
OG0013305	2	2	1	1	1	1	1	9
OG0013306	2	2	1	1	1	1	1	9
OG0013307	1	3	1	1	1	2	0	9
OG0013308	1	4	1	1	1	1	0	9
OG0013309	1	4	1	1	1	1	0	9
OG0013310	2	2	1	1	1	1	1	9
OG0013311	1	2	2	0	1	1	2	9
OG0013312	2	3	1	1	1	0	1	9
OG0013313	1	3	1	1	1	1	1	9
OG0013314	2	2	1	1	1	1	1	9
OG0013315	2	3	1	1	0	1	1	9
OG0013316	2	2	1	1	1	1	1	9
OG0013317	1	3	1	1	1	1	1	9
OG0013318	2	2	1	1	1	1	1	9
OG0013319	1	3	1	1	1	0	2	9
OG0013320	1	3	1	1	1	1	1	9
OG0013321	1	3	1	1	1	1	1	9
OG0013322	2	2	1	1	1	1	1	9
OG0013323	1	3	1	1	1	1	1	9
OG0013324	2	2	1	1	1	1	1	9
OG0013325	1	3	1	1	1	1	1	9
OG0013326	1	3	1	1	1	1	1	9
OG0013327	2	1	1	1	2	1	1	9
OG0013328	1	5	1	0	0	1	1	9
OG0013329	2	2	1	1	1	1	1	9
OG0013330	1	3	1	1	1	1	1	9
OG0013331	1	3	1	1	1	1	1	9
OG0013332	2	3	0	1	1	1	1	9
OG0013333	1	3	1	1	1	1	1	9
OG0013334	1	3	1	1	1	1	1	9
OG0013335	1	3	1	1	1	1	1	9
OG0013336	1	4	1	0	1	1	1	9
OG0013337	2	3	1	1	1	1	0	9
OG0013338	2	2	1	1	1	1	1	9
OG0013339	1	3	1	1	1	1	1	9
OG0013340	1	3	1	1	1	1	1	9
OG0013341	2	3	1	1	1	1	0	9
OG0013342	2	3	1	1	1	1	0	9
OG0013343	2	3	1	0	1	1	1	9
OG0013344	1	3	1	1	1	1	1	9
OG0013345	1	3	1	1	1	1	1	9
OG0013346	2	2	1	1	1	1	1	9
OG0013347	1	3	1	1	1	1	1	9
OG0013348	1	3	1	1	1	1	1	9
OG0013349	1	4	1	1	1	1	0	9
OG0013350	2	2	1	1	1	1	1	9
OG0013351	1	2	1	1	1	2	1	9
OG0013352	2	3	1	1	1	1	0	9
OG0013353	1	5	1	0	1	0	1	9
OG0013354	2	2	1	1	1	1	1	9
OG0013355	2	3	1	1	1	1	0	9
OG0013356	2	2	1	1	1	1	1	9
OG0013357	1	3	1	1	1	0	2	9
OG0013358	1	3	1	1	1	1	1	9
OG0013359	1	2	1	1	1	1	2	9
OG0013360	2	2	1	1	1	1	1	9
OG0013361	1	3	1	1	1	1	1	9
OG0013362	1	3	1	1	1	1	1	9
OG0013363	2	2	1	1	1	1	1	9
OG0013364	1	8	0	0	0	0	0	9
OG0013365	1	3	1	1	1	1	1	9
OG0013366	2	2	1	1	1	1	1	9
OG0013367	1	3	1	1	1	1	1	9
OG0013368	2	2	1	1	1	1	1	9
OG0013369	1	3	1	1	1	0	2	9
OG0013370	2	3	1	1	1	0	1	9
OG0013371	1	3	1	1	1	1	1	9
OG0013372	2	3	1	1	0	1	1	9
OG0013373	1	3	1	1	1	1	1	9
OG0013374	1	3	1	1	1	1	1	9
OG0013375	2	2	1	1	1	1	1	9
OG0013376	1	3	1	1	1	1	1	9
OG0013377	2	2	1	1	1	1	1	9
OG0013378	1	3	1	1	1	1	1	9
OG0013379	2	2	1	1	1	1	1	9
OG0013380	1	3	1	1	1	1	1	9
OG0013381	2	2	1	1	1	1	1	9
OG0013382	1	3	1	1	1	1	1	9
OG0013383	2	2	1	1	1	1	1	9
OG0013384	2	2	1	1	1	1	1	9
OG0013385	2	3	1	1	0	1	1	9
OG0013386	2	2	1	0	1	1	2	9
OG0013387	1	3	2	2	0	0	1	9
OG0013388	2	3	1	1	1	0	1	9
OG0013389	2	2	1	1	1	1	1	9
OG0013390	2	2	1	1	1	1	1	9
OG0013391	1	3	1	1	1	1	1	9
OG0013392	1	3	1	1	1	1	1	9
OG0013393	1	4	1	1	0	1	1	9
OG0013394	2	2	1	1	1	1	1	9
OG0013395	1	3	1	1	1	1	1	9
OG0013396	1	3	1	1	1	1	1	9
OG0013397	2	2	1	1	1	1	1	9
OG0013398	1	3	1	1	1	1	1	9
OG0013399	2	2	1	1	1	1	1	9
OG0013400	1	3	1	1	1	1	1	9
OG0013401	1	3	1	1	1	1	1	9
OG0013402	1	3	1	1	1	1	1	9
OG0013403	1	4	1	1	1	0	1	9
OG0013404	1	4	0	1	1	1	1	9
OG0013405	2	2	1	1	1	1	1	9
OG0013406	2	2	1	1	1	1	1	9
OG0013407	1	2	1	1	1	2	1	9
OG0013408	2	2	1	1	1	1	1	9
OG0013409	1	3	1	1	1	1	1	9
OG0013410	2	3	1	1	1	1	0	9
OG0013411	1	3	1	1	1	1	1	9
OG0013412	1	3	1	1	1	1	1	9
OG0013413	2	3	1	1	1	0	1	9
OG0013414	1	1	0	0	0	0	7	9
OG0013415	2	2	1	1	1	1	1	9
OG0013416	2	2	1	1	1	1	1	9
OG0013417	1	3	1	1	1	1	1	9
OG0013418	2	2	1	1	1	1	1	9
OG0013419	2	2	1	1	1	1	1	9
OG0013420	1	3	1	1	1	1	1	9
OG0013421	2	2	1	1	1	1	1	9
OG0013422	2	2	1	1	1	1	1	9
OG0013423	2	2	1	2	1	0	1	9
OG0013424	2	4	1	1	0	0	1	9
OG0013425	1	4	1	1	1	1	0	9
OG0013426	1	3	1	1	1	1	1	9
OG0013427	2	1	1	1	1	1	2	9
OG0013428	2	3	1	1	1	1	0	9
OG0013429	1	3	1	1	1	1	1	9
OG0013430	1	3	1	1	1	1	1	9
OG0013431	2	2	1	1	1	1	1	9
OG0013432	2	1	0	0	2	2	2	9
OG0013433	2	2	1	1	1	1	1	9
OG0013434	1	3	1	1	1	1	1	9
OG0013435	1	3	1	1	1	1	1	9
OG0013436	1	3	1	1	1	1	1	9
OG0013437	1	3	1	1	1	1	1	9
OG0013438	1	3	1	1	1	1	1	9
OG0013439	1	3	1	1	1	1	1	9
OG0013440	2	2	1	1	1	1	1	9
OG0013441	2	2	1	1	1	1	1	9
OG0013442	1	3	1	1	1	1	1	9
OG0013443	1	4	1	1	0	1	1	9
OG0013444	1	3	1	1	0	2	1	9
OG0013445	2	2	1	1	1	1	1	9
OG0013446	1	3	1	1	1	1	1	9
OG0013447	1	3	1	1	1	1	1	9
OG0013448	2	3	1	1	1	0	1	9
OG0013449	2	2	1	1	1	1	1	9
OG0013450	1	2	1	2	1	0	2	9
OG0013451	2	4	0	1	1	1	0	9
OG0013452	1	1	1	3	1	1	1	9
OG0013453	2	2	1	1	1	1	1	9
OG0013454	2	2	1	1	1	1	1	9
OG0013455	1	3	1	1	1	1	1	9
OG0013456	1	3	1	1	2	0	1	9
OG0013457	1	4	1	1	0	1	1	9
OG0013458	1	3	1	1	1	1	1	9
OG0013459	1	4	1	1	1	0	1	9
OG0013460	1	3	1	1	1	1	1	9
OG0013461	3	2	1	1	1	0	1	9
OG0013462	1	3	1	1	1	1	1	9
OG0013463	1	3	1	1	1	1	1	9
OG0013464	2	3	1	1	1	0	1	9
OG0013465	2	2	1	1	1	1	1	9
OG0013466	2	2	1	1	1	1	1	9
OG0013467	1	3	1	1	1	1	1	9
OG0013468	2	3	1	1	0	1	1	9
OG0013469	1	3	1	1	1	1	1	9
OG0013470	1	3	1	1	1	1	1	9
OG0013471	1	3	1	1	1	1	1	9
OG0013472	1	3	1	1	1	1	1	9
OG0013473	1	3	1	1	1	1	1	9
OG0013474	1	3	1	1	1	1	1	9
OG0013475	2	2	1	1	1	1	1	9
OG0013476	2	3	1	1	1	0	1	9
OG0013477	1	3	1	1	1	1	1	9
OG0013478	1	3	1	1	1	1	1	9
OG0013479	1	3	1	1	1	1	1	9
OG0013480	2	2	1	1	1	1	1	9
OG0013481	1	4	1	1	0	1	1	9
OG0013482	2	3	1	1	1	0	1	9
OG0013483	1	3	1	1	1	1	1	9
OG0013484	1	3	1	1	1	1	1	9
OG0013485	1	4	1	1	0	1	1	9
OG0013486	1	3	1	1	1	1	1	9
OG0013487	1	4	0	1	1	1	1	9
OG0013488	1	2	0	0	5	0	1	9
OG0013489	1	3	1	1	1	1	1	9
OG0013490	2	2	1	1	1	1	1	9
OG0013491	1	3	1	1	1	1	1	9
OG0013492	2	2	1	1	1	1	1	9
OG0013493	1	4	1	1	1	0	1	9
OG0013494	2	2	1	1	1	1	1	9
OG0013495	1	3	1	1	1	1	1	9
OG0013496	1	3	1	1	1	1	1	9
OG0013497	1	3	1	1	1	1	1	9
OG0013498	2	2	1	1	1	1	1	9
OG0013499	2	2	1	1	1	1	1	9
OG0013500	2	2	1	1	1	1	1	9
OG0013501	1	3	1	1	1	1	1	9
OG0013502	1	3	1	1	1	1	1	9
OG0013503	1	3	1	1	1	1	1	9
OG0013504	1	3	1	1	1	1	1	9
OG0013505	2	2	1	1	1	1	1	9
OG0013506	1	2	1	1	1	1	2	9
OG0013507	2	2	1	1	1	1	1	9
OG0013508	1	1	1	1	1	2	2	9
OG0013509	2	2	1	1	1	1	1	9
OG0013510	2	2	1	1	1	1	1	9
OG0013511	2	3	1	1	1	1	0	9
OG0013512	1	3	1	1	1	1	1	9
OG0013513	1	3	1	1	1	1	1	9
OG0013514	1	3	1	1	1	1	1	9
OG0013515	1	4	1	0	1	1	1	9
OG0013516	2	2	1	1	1	1	1	9
OG0013517	1	3	1	1	1	1	1	9
OG0013518	1	3	1	1	1	1	1	9
OG0013519	2	2	1	1	1	1	1	9
OG0013520	2	2	1	1	1	1	1	9
OG0013521	2	2	1	1	1	1	1	9
OG0013522	1	3	1	1	1	1	1	9
OG0013523	2	2	1	1	1	1	1	9
OG0013524	1	3	1	1	1	1	1	9
OG0013525	2	1	1	1	1	2	1	9
OG0013526	2	3	1	1	1	0	1	9
OG0013527	2	2	1	1	1	1	1	9
OG0013528	1	3	1	1	1	1	1	9
OG0013529	2	2	1	1	1	1	1	9
OG0013530	1	3	1	1	1	1	1	9
OG0013531	2	2	1	1	1	1	1	9
OG0013532	2	3	0	1	1	1	1	9
OG0013533	1	3	1	1	1	1	1	9
OG0013534	1	3	1	1	1	1	1	9
OG0013535	1	2	1	1	1	1	2	9
OG0013536	2	2	1	1	1	1	1	9
OG0013537	2	2	1	1	1	1	1	9
OG0013538	1	3	1	1	1	1	1	9
OG0013539	1	3	1	1	1	1	1	9
OG0013540	1	3	1	1	1	1	1	9
OG0013541	1	3	1	1	1	1	1	9
OG0013542	1	3	1	1	1	1	1	9
OG0013543	1	3	1	1	1	1	1	9
OG0013544	1	3	1	1	1	1	1	9
OG0013545	1	3	1	1	1	1	1	9
OG0013546	1	3	1	1	1	1	1	9
OG0013547	1	3	1	1	1	1	1	9
OG0013548	2	3	1	0	1	1	1	9
OG0013549	1	3	1	1	1	1	1	9
OG0013550	1	3	1	1	1	1	1	9
OG0013551	1	3	1	1	1	1	1	9
OG0013552	2	2	1	1	1	1	1	9
OG0013553	2	2	1	1	1	1	1	9
OG0013554	1	3	1	1	1	1	1	9
OG0013555	2	4	1	1	0	0	1	9
OG0013556	1	3	1	1	1	1	1	9
OG0013557	1	3	1	1	1	1	1	9
OG0013558	1	3	1	1	1	1	1	9
OG0013559	1	3	1	1	1	1	1	9
OG0013560	2	2	1	1	1	1	1	9
OG0013561	1	3	1	1	1	1	1	9
OG0013562	1	3	1	1	1	1	1	9
OG0013563	1	3	1	1	1	1	1	9
OG0013564	1	3	1	2	1	0	1	9
OG0013565	2	2	1	1	1	1	1	9
OG0013566	1	2	2	1	1	1	1	9
OG0013567	1	3	1	1	1	1	1	9
OG0013568	1	3	1	1	1	1	1	9
OG0013569	2	3	1	1	0	1	1	9
OG0013570	1	3	1	1	1	1	1	9
OG0013571	1	4	1	1	1	0	1	9
OG0013572	1	3	1	1	1	1	1	9
OG0013573	1	3	1	1	1	1	1	9
OG0013574	1	3	1	1	1	1	1	9
OG0013575	1	3	1	1	1	1	1	9
OG0013576	1	3	1	1	1	1	1	9
OG0013577	1	3	1	1	1	1	1	9
OG0013578	2	2	1	1	1	1	1	9
OG0013579	2	2	1	1	1	1	1	9
OG0013580	1	3	1	1	1	1	1	9
OG0013581	1	3	1	1	1	1	1	9
OG0013582	1	3	1	1	1	1	1	9
OG0013583	1	4	1	0	1	1	1	9
OG0013584	1	3	1	1	1	1	1	9
OG0013585	1	3	1	1	1	1	1	9
OG0013586	1	3	1	1	1	1	1	9
OG0013587	1	3	1	1	1	1	1	9
OG0013588	1	3	1	1	1	1	1	9
OG0013589	1	3	1	1	1	1	1	9
OG0013590	2	2	1	1	1	0	2	9
OG0013591	2	2	1	1	1	1	1	9
OG0013592	2	2	1	1	1	1	1	9
OG0013593	1	4	1	1	1	1	0	9
OG0013594	1	3	1	1	1	1	1	9
OG0013595	1	3	1	0	1	1	2	9
OG0013596	2	3	1	1	1	0	1	9
OG0013597	1	3	1	1	1	1	1	9
OG0013598	2	2	1	1	1	1	1	9
OG0013599	1	3	1	1	1	1	1	9
OG0013600	2	2	1	1	1	1	1	9
OG0013601	1	2	1	1	1	2	1	9
OG0013602	2	2	1	1	1	1	1	9
OG0013603	1	4	1	1	1	1	0	9
OG0013604	1	3	1	1	1	1	1	9
OG0013605	1	3	1	1	1	1	1	9
OG0013606	1	3	1	1	1	1	1	9
OG0013607	1	4	1	1	1	1	0	9
OG0013608	1	3	1	1	1	1	1	9
OG0013609	2	2	1	1	1	1	1	9
OG0013610	1	2	1	1	1	1	2	9
OG0013611	1	3	1	1	1	1	1	9
OG0013612	1	3	1	1	1	1	1	9
OG0013613	2	2	1	1	1	1	1	9
OG0013614	2	2	1	1	1	1	1	9
OG0013615	2	3	1	1	0	1	1	9
OG0013616	1	3	2	1	1	0	1	9
OG0013617	1	3	1	1	1	1	1	9
OG0013618	2	2	1	1	1	1	1	9
OG0013619	1	3	1	1	1	1	1	9
OG0013620	2	2	1	1	1	1	1	9
OG0013621	1	3	1	1	1	1	1	9
OG0013622	1	3	1	2	0	1	1	9
OG0013623	1	3	1	1	1	1	1	9
OG0013624	1	3	1	1	1	1	1	9
OG0013625	1	3	1	1	1	1	1	9
OG0013626	2	2	1	1	1	1	1	9
OG0013627	1	3	1	1	1	1	1	9
OG0013628	1	3	1	1	1	1	1	9
OG0013629	2	2	1	1	1	1	1	9
OG0013630	1	2	1	1	2	1	1	9
OG0013631	1	3	1	1	1	1	1	9
OG0013632	1	3	1	1	1	1	1	9
OG0013633	1	3	1	1	1	1	1	9
OG0013634	2	2	1	1	1	1	1	9
OG0013635	1	4	1	1	1	1	0	9
OG0013636	1	3	1	1	1	1	1	9
OG0013637	1	3	1	1	1	1	1	9
OG0013638	2	3	1	1	1	1	0	9
OG0013639	2	2	1	1	1	1	1	9
OG0013640	1	2	1	1	2	1	1	9
OG0013641	2	2	1	1	1	1	1	9
OG0013642	1	3	1	1	1	1	1	9
OG0013643	2	3	1	1	1	0	1	9
OG0013644	1	3	1	1	1	1	1	9
OG0013645	2	3	1	1	1	0	1	9
OG0013646	1	3	1	1	1	1	1	9
OG0013647	2	3	1	1	1	1	0	9
OG0013648	2	2	1	1	1	1	1	9
OG0013649	2	2	1	1	1	1	1	9
OG0013650	2	3	1	1	0	1	1	9
OG0013651	1	3	1	1	1	1	1	9
OG0013652	1	3	1	1	1	1	1	9
OG0013653	2	1	1	1	1	1	2	9
OG0013654	2	2	1	1	1	1	1	9
OG0013655	1	3	1	1	1	1	1	9
OG0013656	2	2	1	1	1	1	1	9
OG0013657	1	3	1	1	1	1	1	9
OG0013658	2	2	1	1	1	1	1	9
OG0013659	2	2	1	1	1	1	1	9
OG0013660	1	3	1	1	1	0	2	9
OG0013661	1	3	1	1	1	1	1	9
OG0013662	1	3	1	1	1	1	1	9
OG0013663	2	2	1	1	1	1	1	9
OG0013664	1	3	1	1	1	1	1	9
OG0013665	1	3	1	1	1	1	1	9
OG0013666	1	3	1	1	1	1	1	9
OG0013667	2	3	1	1	0	1	1	9
OG0013668	2	2	1	1	1	1	1	9
OG0013669	1	3	1	1	1	1	1	9
OG0013670	2	2	1	1	1	1	1	9
OG0013671	1	3	1	1	1	1	1	9
OG0013672	2	3	1	1	1	1	0	9
OG0013673	1	2	1	2	1	0	2	9
OG0013674	2	2	1	1	1	1	1	9
OG0013675	1	3	1	1	1	1	1	9
OG0013676	1	3	1	1	1	1	1	9
OG0013677	1	3	1	1	1	1	1	9
OG0013678	1	2	1	1	1	1	2	9
OG0013679	1	3	1	1	1	1	1	9
OG0013680	1	3	1	1	1	1	1	9
OG0013681	1	2	1	1	1	1	2	9
OG0013682	1	3	1	1	1	1	1	9
OG0013683	1	2	2	1	1	1	1	9
OG0013684	1	3	1	1	1	1	1	9
OG0013685	1	3	1	1	1	1	1	9
OG0013686	1	3	1	1	1	1	1	9
OG0013687	1	3	1	1	1	1	1	9
OG0013688	2	1	2	1	1	1	1	9
OG0013689	2	2	1	1	1	1	1	9
OG0013690	1	3	1	1	1	1	1	9
OG0013691	1	3	1	1	1	1	1	9
OG0013692	2	2	1	1	1	1	1	9
OG0013693	2	2	1	1	1	1	1	9
OG0013694	1	4	1	1	1	1	0	9
OG0013695	1	3	1	1	1	1	1	9
OG0013696	1	3	1	1	1	1	1	9
OG0013697	2	2	1	1	1	1	1	9
OG0013698	2	4	1	0	1	0	1	9
OG0013699	1	3	1	1	1	1	1	9
OG0013700	1	3	1	1	1	1	1	9
OG0013701	1	3	1	1	1	1	1	9
OG0013702	1	3	1	1	1	1	1	9
OG0013703	2	2	1	1	1	1	1	9
OG0013704	1	4	1	1	1	1	0	9
OG0013705	2	4	1	1	0	0	1	9
OG0013706	1	4	1	1	1	0	1	9
OG0013707	1	3	1	1	1	1	1	9
OG0013708	1	3	1	1	1	1	1	9
OG0013709	1	3	1	1	1	1	1	9
OG0013710	1	4	1	1	0	1	1	9
OG0013711	1	3	1	1	1	1	1	9
OG0013712	1	3	1	1	1	1	1	9
OG0013713	1	3	1	1	1	1	1	9
OG0013714	2	2	1	1	1	1	1	9
OG0013715	1	3	1	1	1	1	1	9
OG0013716	2	2	1	1	1	1	1	9
OG0013717	1	3	1	1	1	1	1	9
OG0013718	2	2	1	1	1	1	1	9
OG0013719	2	2	1	1	1	1	1	9
OG0013720	2	2	1	1	1	1	1	9
OG0013721	1	3	1	1	1	1	1	9
OG0013722	1	1	2	1	1	1	2	9
OG0013723	2	2	1	1	1	1	1	9
OG0013724	1	3	1	1	1	1	1	9
OG0013725	2	4	2	1	0	0	0	9
OG0013726	1	4	1	1	1	1	0	9
OG0013727	1	3	1	1	1	1	1	9
OG0013728	1	3	1	1	1	1	1	9
OG0013729	1	3	0	2	1	2	0	9
OG0013730	1	2	1	1	1	1	2	9
OG0013731	1	2	2	1	1	1	1	9
OG0013732	1	4	1	1	0	1	1	9
OG0013733	1	3	1	1	0	1	2	9
OG0013734	2	2	1	1	1	1	1	9
OG0013735	2	2	1	1	1	1	1	9
OG0013736	2	2	1	1	1	1	1	9
OG0013737	1	3	1	1	1	1	1	9
OG0013738	2	2	1	1	1	1	1	9
OG0013739	2	3	1	1	1	1	0	9
OG0013740	1	4	1	0	1	1	1	9
OG0013741	1	3	1	1	1	1	1	9
OG0013742	1	3	1	1	1	1	1	9
OG0013743	1	2	1	1	1	1	2	9
OG0013744	1	4	1	1	1	0	1	9
OG0013745	2	2	1	1	1	1	1	9
OG0013746	1	4	1	0	1	1	1	9
OG0013747	2	2	1	1	1	1	1	9
OG0013748	1	3	1	1	1	1	1	9
OG0013749	1	4	1	1	1	1	0	9
OG0013750	1	0	0	0	3	2	3	9
OG0013751	1	4	1	1	1	1	0	9
OG0013752	2	2	1	1	1	1	1	9
OG0013753	1	3	1	1	1	1	1	9
OG0013754	1	3	1	1	1	1	1	9
OG0013755	1	3	1	1	1	1	1	9
OG0013756	1	4	1	0	1	1	1	9
OG0013757	1	2	1	1	1	1	2	9
OG0013758	2	2	1	1	1	1	1	9
OG0013759	2	1	1	1	1	1	2	9
OG0013760	2	3	1	0	1	1	1	9
OG0013761	1	4	0	1	1	1	1	9
OG0013762	2	2	1	1	1	1	1	9
OG0013763	2	2	1	1	1	1	1	9
OG0013764	1	2	0	1	2	2	1	9
OG0013765	1	2	2	1	1	1	1	9
OG0013766	2	2	1	1	1	1	1	9
OG0013767	1	4	1	1	1	0	1	9
OG0013768	1	4	1	1	0	1	1	9
OG0013769	1	3	1	1	1	1	1	9
OG0013770	1	3	1	1	1	1	1	9
OG0013771	1	3	1	1	1	1	1	9
OG0013772	1	3	1	1	1	1	1	9
OG0013773	1	3	1	1	1	1	1	9
OG0013774	1	3	1	1	1	1	1	9
OG0013775	1	0	4	0	0	0	4	9
OG0013776	1	4	1	1	0	1	1	9
OG0013777	1	3	1	1	1	1	1	9
OG0013778	1	3	1	1	1	1	1	9
OG0013779	1	3	1	1	1	1	1	9
OG0013780	1	4	1	0	1	1	1	9
OG0013781	1	3	1	1	1	1	1	9
OG0013782	1	4	1	1	1	1	0	9
OG0013783	2	3	1	1	1	0	1	9
OG0013784	1	3	1	1	1	1	1	9
OG0013785	2	3	1	1	1	1	0	9
OG0013786	1	4	1	1	1	1	0	9
OG0013787	1	3	1	1	1	1	1	9
OG0013788	2	2	1	1	1	1	1	9
OG0013789	2	2	1	1	1	1	1	9
OG0013790	2	3	1	1	0	1	1	9
OG0013791	1	4	1	1	1	1	0	9
OG0013792	1	3	1	1	1	1	1	9
OG0013793	1	3	1	1	1	1	1	9
OG0013794	1	4	1	1	0	1	1	9
OG0013795	1	2	1	1	1	1	2	9
OG0013796	1	3	1	1	1	1	1	9
OG0013797	1	3	1	1	1	1	1	9
OG0013798	1	3	1	1	1	1	1	9
OG0013799	2	2	1	1	1	1	1	9
OG0013800	1	2	1	1	1	1	2	9
OG0013801	1	4	1	1	1	0	1	9
OG0013802	2	2	1	1	1	1	1	9
OG0013803	1	3	1	1	1	1	1	9
OG0013804	1	4	1	1	1	1	0	9
OG0013805	1	3	1	1	1	1	1	9
OG0013806	1	3	1	1	1	1	1	9
OG0013807	1	3	1	1	1	0	2	9
OG0013808	2	2	1	1	1	1	1	9
OG0013809	1	3	1	1	1	1	1	9
OG0013810	1	2	1	1	2	1	1	9
OG0013811	1	2	1	1	1	2	1	9
OG0013812	1	4	1	0	1	1	1	9
OG0013813	1	3	1	1	1	1	1	9
OG0013814	1	3	1	1	1	1	1	9
OG0013815	1	3	1	1	1	1	1	9
OG0013816	1	3	1	1	1	1	1	9
OG0013817	2	2	1	1	1	1	1	9
OG0013818	1	4	1	1	0	1	1	9
OG0013819	1	3	1	1	1	1	1	9
OG0013820	1	3	1	1	1	1	1	9
OG0013821	1	3	1	1	1	1	1	9
OG0013822	2	2	1	1	1	1	1	9
OG0013823	2	2	1	1	1	1	1	9
OG0013824	1	3	1	1	1	1	1	9
OG0013825	1	3	1	1	1	1	1	9
OG0013826	1	3	1	1	1	1	1	9
OG0013827	1	3	1	1	1	1	1	9
OG0013828	1	3	1	1	1	1	1	9
OG0013829	1	3	1	1	1	1	1	9
OG0013830	2	2	1	1	1	1	1	9
OG0013831	1	3	1	1	1	1	1	9
OG0013832	1	3	1	1	1	1	1	9
OG0013833	1	3	1	1	1	1	1	9
OG0013834	1	3	1	1	1	1	1	9
OG0013835	1	4	1	1	1	0	1	9
OG0013836	2	2	1	1	1	1	1	9
OG0013837	1	3	1	1	1	1	1	9
OG0013838	1	3	1	1	1	1	1	9
OG0013839	1	4	1	1	1	0	1	9
OG0013840	1	2	1	1	1	2	1	9
OG0013841	1	3	1	1	1	1	1	9
OG0013842	1	3	1	1	1	1	1	9
OG0013843	1	4	1	1	1	0	1	9
OG0013844	1	3	1	1	1	1	1	9
OG0013845	1	3	1	1	1	1	1	9
OG0013846	1	3	1	1	1	1	1	9
OG0013847	1	3	1	1	1	1	1	9
OG0013848	1	3	1	1	1	1	1	9
OG0013849	1	3	1	1	1	1	1	9
OG0013850	2	2	1	1	1	1	1	9
OG0013851	1	3	1	1	1	1	1	9
OG0013852	1	3	1	1	1	1	1	9
OG0013853	1	3	2	1	1	0	1	9
OG0013854	1	3	1	1	1	1	1	9
OG0013855	1	4	0	1	1	1	1	9
OG0013856	1	3	1	1	1	1	1	9
OG0013857	1	3	1	1	1	1	1	9
OG0013858	1	3	1	1	1	1	1	9
OG0013859	2	2	1	1	1	1	1	9
OG0013860	2	1	3	1	1	1	0	9
OG0013861	1	4	1	1	1	1	0	9
OG0013862	1	2	1	1	1	2	1	9
OG0013863	1	3	1	1	1	1	1	9
OG0013864	1	3	1	1	1	1	1	9
OG0013865	2	2	1	1	1	1	1	9
OG0013866	1	3	1	1	1	1	1	9
OG0013867	1	2	1	1	1	1	2	9
OG0013868	1	3	1	1	1	1	1	9
OG0013869	1	3	1	1	1	1	1	9
OG0013870	1	3	1	1	1	1	1	9
OG0013871	1	3	1	1	1	1	1	9
OG0013872	1	3	1	1	1	1	1	9
OG0013873	1	3	1	1	1	2	0	9
OG0013874	1	3	3	0	1	0	1	9
OG0013875	1	4	1	1	1	1	0	9
OG0013876	1	3	1	1	1	1	1	9
OG0013877	1	2	2	1	1	1	1	9
OG0013878	1	4	1	1	0	1	1	9
OG0013879	1	3	1	1	1	1	1	9
OG0013880	1	4	1	0	1	1	1	9
OG0013881	1	3	1	1	1	1	1	9
OG0013882	1	3	1	1	1	1	1	9
OG0013883	1	2	1	1	1	1	2	9
OG0013884	1	3	1	1	1	1	1	9
OG0013885	1	3	1	1	1	1	1	9
OG0013886	1	2	1	1	2	1	1	9
OG0013887	1	3	1	1	1	1	1	9
OG0013888	1	3	1	1	1	1	1	9
OG0013889	1	3	1	1	1	1	1	9
OG0013890	2	1	1	1	2	1	1	9
OG0013891	1	3	1	1	1	1	1	9
OG0013892	1	2	1	1	1	1	2	9
OG0013893	1	3	1	1	1	1	1	9
OG0013894	1	3	1	1	1	1	1	9
OG0013895	1	3	1	1	1	1	1	9
OG0013896	1	3	1	1	1	1	1	9
OG0013897	1	3	1	1	1	1	1	9
OG0013898	1	3	1	1	1	1	1	9
OG0013899	1	2	1	1	2	1	1	9
OG0013900	1	3	1	1	1	1	1	9
OG0013901	1	3	1	1	1	1	1	9
OG0013902	1	4	1	1	1	0	1	9
OG0013903	1	4	1	1	0	1	1	9
OG0013904	1	3	1	1	1	1	1	9
OG0013905	1	3	1	1	1	1	1	9
OG0013906	1	3	1	1	1	1	1	9
OG0013907	1	3	1	1	1	1	1	9
OG0013908	1	3	1	1	1	1	1	9
OG0013909	1	3	1	1	1	1	1	9
OG0013910	1	4	1	1	1	0	1	9
OG0013911	1	3	1	1	1	1	1	9
OG0013912	2	2	1	1	1	1	1	9
OG0013913	1	4	1	1	1	1	0	9
OG0013914	2	2	1	1	1	1	1	9
OG0013915	1	4	1	1	0	1	1	9
OG0013916	1	3	1	1	1	1	1	9
OG0013917	1	3	1	1	1	1	1	9
OG0013918	1	3	1	1	1	1	1	9
OG0013919	1	3	1	1	1	1	1	9
OG0013920	1	3	1	1	1	1	1	9
OG0013921	1	3	1	1	1	1	1	9
OG0013922	0	8	0	0	0	0	1	9
OG0013923	0	8	0	1	0	0	0	9
OG0013924	0	4	1	1	1	1	1	9
OG0013925	0	4	1	1	1	1	1	9
OG0013926	0	9	0	0	0	0	0	9
OG0013927	0	4	1	1	1	1	1	9
OG0013928	0	9	0	0	0	0	0	9
OG0013929	0	4	1	1	1	1	1	9
OG0013930	0	4	1	1	1	1	1	9
OG0013931	0	4	1	1	1	1	1	9
OG0013932	0	4	1	1	1	1	1	9
OG0013933	0	9	0	0	0	0	0	9
OG0013934	0	5	0	0	2	1	1	9
OG0013935	0	3	1	0	1	0	4	9
OG0013936	0	4	1	0	1	1	2	9
OG0013937	0	5	1	0	1	1	1	9
OG0013938	0	5	0	1	1	1	1	9
OG0013939	0	4	0	0	1	1	3	9
OG0013940	0	3	1	1	1	1	2	9
OG0013941	0	3	2	0	2	2	0	9
OG0013942	0	4	1	1	1	2	0	9
OG0013943	0	4	1	1	1	1	1	9
OG0013944	0	4	1	1	0	2	1	9
OG0013945	0	5	0	1	1	1	1	9
OG0013946	0	4	1	1	0	1	2	9
OG0013947	0	4	1	1	0	1	2	9
OG0013948	0	3	1	1	1	1	2	9
OG0013949	0	4	1	1	1	1	1	9
OG0013950	0	3	2	1	1	1	1	9
OG0013951	0	2	2	1	1	1	2	9
OG0013952	0	6	0	1	1	0	1	9
OG0013953	0	4	1	1	1	1	1	9
OG0013954	0	4	1	1	1	1	1	9
OG0013955	0	4	1	1	1	1	1	9
OG0013956	0	7	1	0	0	0	1	9
OG0013957	0	9	0	0	0	0	0	9
OG0013958	0	4	1	1	1	1	1	9
OG0013959	0	3	1	2	0	1	2	9
OG0013960	0	5	0	1	0	0	3	9
OG0013961	0	6	2	0	0	0	1	9
OG0013962	0	3	0	0	1	2	3	9
OG0013963	0	3	3	1	1	1	0	9
OG0013964	0	4	0	0	2	2	1	9
OG0013965	0	3	0	1	2	1	2	9
OG0013966	0	4	1	1	1	1	1	9
OG0013967	0	4	1	1	1	1	1	9
OG0013968	0	9	0	0	0	0	0	9
OG0013969	0	4	1	1	1	1	1	9
OG0013970	0	6	1	0	0	0	2	9
OG0013971	0	4	1	1	1	1	1	9
OG0013972	0	3	1	2	1	1	1	9
OG0013973	0	4	1	1	1	1	1	9
OG0013974	0	5	0	1	1	1	1	9
OG0013975	0	4	1	1	1	1	1	9
OG0013976	0	4	1	1	1	1	1	9
OG0013977	0	8	0	0	1	0	0	9
OG0013978	0	4	1	1	1	1	1	9
OG0013979	0	5	1	1	0	1	1	9
OG0013980	0	1	0	0	6	1	1	9
OG0013981	0	6	1	0	1	0	1	9
OG0013982	0	4	0	0	1	2	2	9
OG0013983	0	6	0	1	0	1	1	9
OG0013984	0	8	1	0	0	0	0	9
OG0013985	0	4	1	1	1	1	1	9
OG0013986	0	3	2	1	1	1	1	9
OG0013987	0	4	1	1	1	1	1	9
OG0013988	0	4	1	1	1	1	1	9
OG0013989	0	4	1	1	1	1	1	9
OG0013990	0	4	0	1	0	3	1	9
OG0013991	0	4	1	1	1	1	1	9
OG0013992	0	4	1	1	1	1	1	9
OG0013993	0	4	0	0	0	1	4	9
OG0013994	0	9	0	0	0	0	0	9
OG0013995	0	4	1	1	0	1	2	9
OG0013996	0	3	0	2	1	1	2	9
OG0013997	0	4	1	1	1	1	1	9
OG0013998	0	4	1	1	1	1	1	9
OG0013999	0	9	0	0	0	0	0	9
OG0014000	0	4	1	1	1	1	1	9
OG0014001	0	5	0	1	1	1	1	9
OG0014002	0	2	1	1	1	2	2	9
OG0014003	0	9	0	0	0	0	0	9
OG0014004	0	4	1	0	0	1	3	9
OG0014005	0	4	1	1	1	1	1	9
OG0014006	0	6	2	0	0	0	1	9
OG0014007	0	4	1	1	1	1	1	9
OG0014008	0	7	0	0	1	1	0	9
OG0014009	0	4	1	1	1	1	1	9
OG0014010	0	4	1	1	1	1	1	9
OG0014011	0	5	0	1	0	1	2	9
OG0014012	0	5	1	1	1	1	0	9
OG0014013	0	4	1	1	1	1	1	9
OG0014014	0	3	0	2	2	2	0	9
OG0014015	0	4	1	1	1	1	1	9
OG0014016	0	4	1	1	1	1	1	9
OG0014017	0	4	1	1	1	1	1	9
OG0014018	0	4	1	1	1	1	1	9
OG0014019	0	4	1	1	1	1	1	9
OG0014020	0	4	1	1	1	1	1	9
OG0014021	0	4	1	1	1	1	1	9
OG0014022	0	6	0	2	1	0	0	9
OG0014023	0	4	1	0	0	2	2	9
OG0014024	0	3	2	1	1	1	1	9
OG0014025	0	4	1	1	1	1	1	9
OG0014026	0	4	1	1	1	1	1	9
OG0014027	0	4	1	1	1	1	1	9
OG0014028	0	4	1	1	1	1	1	9
OG0014029	0	3	1	1	1	1	2	9
OG0014030	0	5	1	0	1	1	1	9
OG0014031	0	4	1	1	1	1	1	9
OG0014032	0	3	0	1	0	2	3	9
OG0014033	0	8	0	0	1	0	0	9
OG0014034	0	9	0	0	0	0	0	9
OG0014035	0	4	1	1	1	1	1	9
OG0014036	0	4	1	1	1	0	2	9
OG0014037	0	9	0	0	0	0	0	9
OG0014038	0	8	0	0	1	0	0	9
OG0014039	0	4	1	1	1	1	1	9
OG0014040	0	4	1	1	1	1	1	9
OG0014041	0	4	1	1	1	1	1	9
OG0014042	0	5	0	1	2	1	0	9
OG0014043	0	4	1	1	1	1	1	9
OG0014044	0	4	1	1	1	1	1	9
OG0014045	0	4	1	1	1	1	1	9
OG0014046	0	8	0	0	0	0	1	9
OG0014047	0	4	1	1	1	1	1	9
OG0014048	0	4	1	1	1	1	1	9
OG0014049	0	5	1	1	1	0	1	9
OG0014050	0	4	0	1	3	1	0	9
OG0014051	0	6	0	0	1	0	2	9
OG0014052	0	7	0	0	1	1	0	9
OG0014053	0	8	0	1	0	0	0	9
OG0014054	0	9	0	0	0	0	0	9
OG0014055	0	6	1	1	1	0	0	9
OG0014056	0	4	1	1	1	1	1	9
OG0014057	0	4	0	2	1	1	1	9
OG0014058	0	3	1	1	1	0	3	9
OG0014059	0	4	1	1	1	1	1	9
OG0014060	0	9	0	0	0	0	0	9
OG0014061	0	8	0	0	0	0	1	9
OG0014062	0	3	1	1	2	1	1	9
OG0014063	0	4	1	1	1	1	1	9
OG0014064	0	5	1	1	1	1	0	9
OG0014065	0	4	0	1	1	2	1	9
OG0014066	0	4	1	1	1	1	1	9
OG0014067	0	9	0	0	0	0	0	9
OG0014068	0	4	1	0	1	2	1	9
OG0014069	0	5	0	0	0	1	3	9
OG0014070	0	1	1	1	2	3	1	9
OG0014071	0	4	1	1	1	1	1	9
OG0014072	0	4	1	1	1	2	0	9
OG0014073	0	4	1	1	1	1	1	9
OG0014074	0	5	2	0	0	0	2	9
OG0014075	0	4	0	1	3	0	1	9
OG0014076	0	4	1	1	1	1	1	9
OG0014077	0	4	1	1	1	1	1	9
OG0014078	0	5	0	0	1	0	3	9
OG0014079	0	2	0	5	2	0	0	9
OG0014080	0	4	1	1	1	1	1	9
OG0014081	0	4	1	1	1	1	1	9
OG0014082	0	4	1	1	1	1	1	9
OG0014083	0	5	1	1	1	1	0	9
OG0014084	0	2	4	1	0	1	1	9
OG0014085	0	3	1	1	1	1	2	9
OG0014086	0	8	0	0	0	0	1	9
OG0014087	0	6	2	0	0	0	1	9
OG0014088	0	1	1	3	1	1	2	9
OG0014089	0	4	1	1	1	1	1	9
OG0014090	0	5	0	1	0	3	0	9
OG0014091	0	4	1	1	1	1	1	9
OG0014092	0	4	1	1	1	1	1	9
OG0014093	0	4	1	1	1	1	1	9
OG0014094	0	6	0	0	1	0	2	9
OG0014095	0	4	1	1	1	1	1	9
OG0014096	0	5	1	1	1	1	0	9
OG0014097	0	3	2	1	1	1	1	9
OG0014098	0	4	1	1	1	1	1	9
OG0014099	0	3	1	1	2	1	1	9
OG0014100	0	4	1	1	1	1	1	9
OG0014101	0	4	1	1	1	1	1	9
OG0014102	0	4	1	1	1	1	1	9
OG0014103	0	3	2	1	1	1	1	9
OG0014104	0	4	1	1	1	1	1	9
OG0014105	0	4	1	1	1	1	1	9
OG0014106	0	9	0	0	0	0	0	9
OG0014107	0	3	1	2	1	1	1	9
OG0014108	0	4	1	1	1	1	1	9
OG0014109	0	4	1	1	1	1	1	9
OG0014110	0	3	1	1	1	1	2	9
OG0014111	0	7	0	0	0	1	1	9
OG0014112	0	4	1	1	1	1	1	9
OG0014113	0	9	0	0	0	0	0	9
OG0014114	0	6	0	1	0	1	1	9
OG0014115	0	4	1	1	1	1	1	9
OG0014116	0	4	1	1	1	1	1	9
OG0014117	0	5	1	1	1	1	0	9
OG0014118	0	5	1	1	1	0	1	9
OG0014119	0	3	1	1	1	1	2	9
OG0014120	0	4	1	1	1	1	1	9
OG0014121	0	3	2	1	1	1	1	9
OG0014122	0	5	1	1	1	1	0	9
OG0014123	0	4	1	1	1	1	1	9
OG0014124	0	5	0	0	1	2	1	9
OG0014125	0	3	1	1	1	1	2	9
OG0014126	0	4	1	1	1	1	1	9
OG0014127	0	4	1	1	1	1	1	9
OG0014128	0	4	1	1	1	1	1	9
OG0014129	0	4	1	1	1	1	1	9
OG0014130	0	4	1	1	1	1	1	9
OG0014131	0	4	1	1	1	1	1	9
OG0014132	0	5	1	1	1	0	1	9
OG0014133	0	7	1	0	0	0	1	9
OG0014134	0	4	1	1	1	1	1	9
OG0014135	0	4	1	1	1	1	1	9
OG0014136	0	5	0	0	0	0	4	9
OG0014137	0	2	0	3	1	1	2	9
OG0014138	0	7	1	0	0	0	1	9
OG0014139	0	4	0	2	2	0	1	9
OG0014140	0	2	0	0	0	0	7	9
OG0014141	0	8	0	0	0	0	1	9
OG0014142	0	3	1	1	2	1	1	9
OG0014143	0	5	1	0	1	1	1	9
OG0014144	0	4	0	0	1	2	2	9
OG0014145	0	8	0	0	0	0	1	9
OG0014146	0	6	1	1	0	0	1	9
OG0014147	0	5	0	0	1	1	2	9
OG0014148	0	4	1	1	1	1	1	9
OG0014149	0	4	1	1	1	1	1	9
OG0014150	0	5	0	1	1	1	1	9
OG0014151	0	5	0	0	1	1	2	9
OG0014152	0	4	1	1	1	1	1	9
OG0014153	0	4	1	1	1	1	1	9
OG0014154	0	4	1	1	1	1	1	9
OG0014155	0	4	1	1	1	1	1	9
OG0014156	0	4	1	0	0	3	1	9
OG0014157	0	4	1	1	1	2	0	9
OG0014158	0	3	0	1	4	1	0	9
OG0014159	0	4	1	1	1	1	1	9
OG0014160	0	3	1	1	2	2	0	9
OG0014161	0	8	0	0	0	0	1	9
OG0014162	0	4	1	1	1	1	1	9
OG0014163	0	9	0	0	0	0	0	9
OG0014164	0	3	3	2	0	1	0	9
OG0014165	0	4	1	1	1	1	1	9
OG0014166	0	9	0	0	0	0	0	9
OG0014167	0	3	2	1	1	1	1	9
OG0014168	0	4	1	1	1	1	1	9
OG0014169	0	5	1	1	0	1	1	9
OG0014170	0	3	1	1	1	2	1	9
OG0014171	0	3	1	1	1	2	1	9
OG0014172	0	3	1	1	1	2	1	9
OG0014173	0	7	0	0	0	1	1	9
OG0014174	0	6	0	1	1	0	1	9
OG0014175	0	6	1	1	0	1	0	9
OG0014176	0	2	1	2	1	2	1	9
OG0014177	0	3	1	1	1	1	2	9
OG0014178	0	3	1	1	1	2	1	9
OG0014179	0	4	1	1	1	1	1	9
OG0014180	0	4	1	1	1	1	1	9
OG0014181	0	4	0	1	2	1	1	9
OG0014182	0	4	1	1	1	1	1	9
OG0014183	0	3	1	1	1	1	2	9
OG0014184	0	2	3	1	1	1	1	9
OG0014185	0	4	1	1	1	1	1	9
OG0014186	0	4	1	1	1	1	1	9
OG0014187	0	4	1	1	1	1	1	9
OG0014188	0	4	1	1	1	1	1	9
OG0014189	0	4	1	1	1	1	1	9
OG0014190	0	4	1	1	1	1	1	9
OG0014191	0	4	1	1	1	1	1	9
OG0014192	0	4	1	1	1	1	1	9
OG0014193	0	4	1	1	1	1	1	9
OG0014194	0	3	1	1	1	2	1	9
OG0014195	0	3	1	1	1	2	1	9
OG0014196	0	4	1	1	1	1	1	9
OG0014197	0	4	1	1	1	1	1	9
OG0014198	0	5	1	0	0	2	1	9
OG0014199	0	8	0	0	1	0	0	9
OG0014200	0	4	1	1	2	0	1	9
OG0014201	0	8	0	0	0	0	1	9
OG0014202	0	4	1	1	1	1	1	9
OG0014203	0	4	1	1	1	1	1	9
OG0014204	0	2	1	0	0	3	3	9
OG0014205	0	4	1	1	1	1	1	9
OG0014206	0	4	2	0	1	1	1	9
OG0014207	0	3	1	1	1	1	2	9
OG0014208	0	4	1	1	1	1	1	9
OG0014209	0	3	1	1	2	1	1	9
OG0014210	0	9	0	0	0	0	0	9
OG0014211	0	9	0	0	0	0	0	9
OG0014212	0	4	1	1	1	1	1	9
OG0014213	0	4	1	1	1	1	1	9
OG0014214	0	5	1	1	1	1	0	9
OG0014215	0	6	0	0	1	1	1	9
OG0014216	0	4	1	1	1	1	1	9
OG0014217	0	3	2	1	1	1	1	9
OG0014218	0	3	0	0	0	3	3	9
OG0014219	0	1	1	1	0	2	4	9
OG0014220	0	4	1	1	1	1	1	9
OG0014221	0	3	1	2	1	1	1	9
OG0014222	0	3	0	2	1	1	2	9
OG0014223	0	6	0	2	0	1	0	9
OG0014224	0	4	2	0	1	1	1	9
OG0014225	0	3	1	1	1	1	2	9
OG0014226	0	4	1	1	1	1	1	9
OG0014227	0	3	0	0	1	0	5	9
OG0014228	0	4	1	1	1	1	1	9
OG0014229	0	4	1	1	1	1	1	9
OG0014230	0	5	1	1	1	0	1	9
OG0014231	0	4	1	1	1	1	1	9
OG0014232	0	4	1	1	1	1	1	9
OG0014233	0	3	1	1	2	0	2	9
OG0014234	0	5	1	0	1	1	1	9
OG0014235	0	3	1	1	1	2	1	9
OG0014236	0	5	0	1	1	1	1	9
OG0014237	0	4	0	0	0	0	5	9
OG0014238	0	4	1	1	1	1	1	9
OG0014239	0	9	0	0	0	0	0	9
OG0014240	0	6	1	1	1	0	0	9
OG0014241	0	4	0	2	1	1	1	9
OG0014242	0	3	2	1	1	1	1	9
OG0014243	0	3	1	1	1	1	2	9
OG0014244	0	4	1	1	1	1	1	9
OG0014245	0	9	0	0	0	0	0	9
OG0014246	0	3	1	1	1	1	2	9
OG0014247	0	2	1	3	1	1	1	9
OG0014248	0	5	3	1	0	0	0	9
OG0014249	0	4	1	1	1	1	1	9
OG0014250	0	3	1	2	1	1	1	9
OG0014251	0	3	2	1	1	1	1	9
OG0014252	0	4	0	2	1	1	1	9
OG0014253	0	3	2	1	1	1	1	9
OG0014254	0	4	1	1	0	1	2	9
OG0014255	0	6	0	2	1	0	0	9
OG0014256	0	2	0	0	2	1	4	9
OG0014257	0	4	2	1	1	0	1	9
OG0014258	0	4	1	1	1	1	1	9
OG0014259	0	4	1	1	1	1	1	9
OG0014260	0	4	1	1	1	1	1	9
OG0014261	0	4	1	1	1	1	1	9
OG0014262	0	3	1	2	1	1	1	9
OG0014263	0	4	0	1	1	2	1	9
OG0014264	0	4	1	1	1	1	1	9
OG0014265	0	6	0	0	0	1	2	9
OG0014266	0	4	1	1	1	1	1	9
OG0014267	0	4	1	1	1	1	1	9
OG0014268	0	3	1	2	1	1	1	9
OG0014269	0	1	1	1	1	2	3	9
OG0014270	0	3	2	1	1	1	1	9
OG0014271	0	3	2	1	1	1	1	9
OG0014272	0	2	1	1	1	2	2	9
OG0014273	0	4	1	1	1	1	1	9
OG0014274	0	3	0	1	1	2	2	9
OG0014275	0	4	1	1	1	1	1	9
OG0014276	0	4	1	1	1	1	1	9
OG0014277	0	2	1	1	1	2	2	9
OG0014278	0	4	1	1	1	1	1	9
OG0014279	0	4	1	1	1	1	1	9
OG0014280	0	4	1	1	1	1	1	9
OG0014281	0	4	1	1	1	1	1	9
OG0014282	0	4	1	1	1	1	1	9
OG0014283	0	4	1	1	1	1	1	9
OG0014284	0	4	1	1	1	1	1	9
OG0014285	0	5	0	0	2	0	2	9
OG0014286	0	4	1	1	1	1	1	9
OG0014287	0	4	1	1	1	1	1	9
OG0014288	0	4	1	1	1	1	1	9
OG0014289	0	3	1	1	1	1	2	9
OG0014290	0	4	1	1	1	1	1	9
OG0014291	0	3	0	0	1	2	3	9
OG0014292	0	5	0	0	0	1	3	9
OG0014293	0	5	1	1	0	1	1	9
OG0014294	0	4	1	1	1	1	1	9
OG0014295	0	4	1	1	1	1	1	9
OG0014296	0	6	0	1	0	1	1	9
OG0014297	0	3	1	1	2	1	1	9
OG0014298	0	4	1	1	1	1	1	9
OG0014299	0	3	1	1	1	1	2	9
OG0014300	0	4	0	0	1	3	1	9
OG0014301	0	2	1	1	1	2	2	9
OG0014302	0	3	1	0	1	1	3	9
OG0014303	0	3	1	1	2	1	1	9
OG0014304	0	3	1	2	1	1	1	9
OG0014305	0	3	1	1	1	2	1	9
OG0014306	0	4	1	1	1	1	1	9
OG0014307	0	3	1	1	1	2	1	9
OG0014308	0	4	1	1	1	1	1	9
OG0014309	0	4	1	1	1	1	1	9
OG0014310	0	4	1	1	1	1	1	9
OG0014311	0	4	1	1	1	1	1	9
OG0014312	0	4	1	1	1	1	1	9
OG0014313	0	4	1	1	1	1	1	9
OG0014314	0	9	0	0	0	0	0	9
OG0014315	0	3	1	1	1	2	1	9
OG0014316	0	6	0	2	1	0	0	9
OG0014317	0	4	1	1	1	1	1	9
OG0014318	0	4	1	1	1	1	1	9
OG0014319	0	4	1	1	1	1	1	9
OG0014320	0	3	1	1	1	2	1	9
OG0014321	0	2	1	1	1	3	1	9
OG0014322	0	4	1	1	1	1	1	9
OG0014323	0	4	1	1	1	1	1	9
OG0014324	0	3	1	2	1	1	1	9
OG0014325	0	4	1	1	1	1	1	9
OG0014326	0	3	2	0	0	0	4	9
OG0014327	0	4	0	1	2	1	1	9
OG0014328	0	2	1	1	1	2	2	9
OG0014329	0	3	2	1	1	1	1	9
OG0014330	0	4	1	1	1	1	1	9
OG0014331	0	5	1	0	1	1	1	9
OG0014332	0	9	0	0	0	0	0	9
OG0014333	0	4	1	1	1	1	1	9
OG0014334	0	6	0	0	0	1	2	9
OG0014335	0	3	1	0	1	1	3	9
OG0014336	0	4	1	1	1	1	1	9
OG0014337	0	4	1	1	1	1	1	9
OG0014338	0	4	1	1	1	1	1	9
OG0014339	0	4	1	1	1	1	1	9
OG0014340	0	9	0	0	0	0	0	9
OG0014341	0	4	1	1	1	1	1	9
OG0014342	0	4	1	1	1	1	1	9
OG0014343	0	5	1	2	1	0	0	9
OG0014344	0	7	1	0	1	0	0	9
OG0014345	0	1	3	0	0	1	4	9
OG0014346	0	2	0	1	2	2	2	9
OG0014347	0	5	0	0	2	1	1	9
OG0014348	0	2	0	0	0	1	6	9
OG0014349	0	4	1	1	1	1	1	9
OG0014350	0	2	2	2	0	3	0	9
OG0014351	0	3	1	2	1	1	1	9
OG0014352	0	6	0	1	0	1	1	9
OG0014353	0	4	2	1	0	0	2	9
OG0014354	0	2	1	1	1	2	2	9
OG0014355	0	4	1	1	1	1	1	9
OG0014356	0	3	1	1	2	1	1	9
OG0014357	0	4	1	1	1	1	1	9
OG0014358	0	4	1	1	1	1	1	9
OG0014359	0	4	1	1	1	1	1	9
OG0014360	0	2	1	1	3	1	1	9
OG0014361	0	4	1	1	1	1	1	9
OG0014362	0	4	1	1	1	1	1	9
OG0014363	0	3	1	1	1	1	2	9
OG0014364	0	3	1	2	1	1	1	9
OG0014365	0	4	0	2	1	1	1	9
OG0014366	0	3	1	1	1	1	2	9
OG0014367	0	1	1	1	3	0	3	9
OG0014368	0	1	0	0	0	1	7	9
OG0014369	0	3	1	1	1	1	2	9
OG0014370	0	1	0	0	0	0	8	9
OG0014371	0	4	1	1	0	1	2	9
OG0014372	0	3	1	2	1	1	1	9
OG0014373	0	2	1	0	1	1	4	9
OG0014374	0	3	0	0	1	1	4	9
OG0014375	0	5	0	1	0	0	3	9
OG0014376	0	3	2	1	1	1	1	9
OG0014377	0	9	0	0	0	0	0	9
OG0014378	0	2	0	0	0	1	6	9
OG0014379	0	1	0	1	4	1	2	9
OG0014380	0	1	1	0	0	0	7	9
OG0014381	0	3	1	1	1	2	1	9
OG0014382	0	3	1	2	1	1	1	9
OG0014383	0	2	0	2	2	2	1	9
OG0014384	0	2	1	1	2	0	3	9
OG0014385	0	3	2	2	0	1	1	9
OG0014386	0	2	1	1	1	2	2	9
OG0014387	0	3	2	1	1	1	1	9
OG0014388	0	4	1	1	1	2	0	9
OG0014389	0	1	0	4	0	2	2	9
OG0014390	0	0	1	0	1	1	6	9
OG0014391	0	0	1	2	3	1	2	9
OG0014392	0	0	3	1	2	2	1	9
OG0014393	0	0	2	2	2	1	2	9
OG0014394	0	0	1	4	1	0	3	9
OG0014395	0	0	0	1	2	3	3	9
OG0014396	0	0	0	2	1	6	0	9
OG0014397	0	0	0	4	5	0	0	9
OG0014398	0	0	0	0	0	1	8	9
OG0014399	0	0	0	0	0	0	9	9
OG0014400	0	0	0	0	0	0	9	9
OG0014401	0	0	0	0	0	0	9	9
OG0014402	0	0	0	0	0	0	9	9
OG0014403	1	2	1	1	1	1	1	8
OG0014404	1	2	1	1	1	1	1	8
OG0014405	2	1	1	1	1	1	1	8
OG0014406	2	1	1	1	1	1	1	8
OG0014407	2	0	0	0	1	2	3	8
OG0014408	2	1	1	1	1	1	1	8
OG0014409	1	2	1	1	1	1	1	8
OG0014410	2	3	1	1	0	1	0	8
OG0014411	2	1	1	1	1	1	1	8
OG0014412	2	3	1	1	1	0	0	8
OG0014413	2	1	1	1	1	1	1	8
OG0014414	2	1	1	1	1	1	1	8
OG0014415	2	2	1	0	1	1	1	8
OG0014416	2	1	1	1	1	1	1	8
OG0014417	2	1	1	1	1	1	1	8
OG0014418	2	0	1	1	1	1	2	8
OG0014419	1	2	1	1	1	1	1	8
OG0014420	1	2	1	1	1	1	1	8
OG0014421	1	1	2	1	1	1	1	8
OG0014422	7	0	0	1	0	0	0	8
OG0014423	2	2	1	0	1	1	1	8
OG0014424	2	2	1	1	1	1	0	8
OG0014425	1	2	1	1	1	1	1	8
OG0014426	2	1	1	1	1	1	1	8
OG0014427	2	2	1	0	1	1	1	8
OG0014428	2	2	1	1	1	1	0	8
OG0014429	7	1	0	0	0	0	0	8
OG0014430	2	1	1	1	1	1	1	8
OG0014431	2	1	1	1	1	1	1	8
OG0014432	1	2	1	1	1	1	1	8
OG0014433	2	1	1	1	1	1	1	8
OG0014434	8	0	0	0	0	0	0	8
OG0014435	3	5	0	0	0	0	0	8
OG0014436	2	1	1	1	1	1	1	8
OG0014437	1	3	1	1	1	1	0	8
OG0014438	2	4	1	0	0	0	1	8
OG0014439	2	1	1	1	1	1	1	8
OG0014440	2	1	1	1	1	1	1	8
OG0014441	1	2	1	1	1	1	1	8
OG0014442	2	1	1	1	1	1	1	8
OG0014443	1	3	1	1	1	0	1	8
OG0014444	3	3	1	0	0	0	1	8
OG0014445	8	0	0	0	0	0	0	8
OG0014446	8	0	0	0	0	0	0	8
OG0014447	2	1	1	1	1	1	1	8
OG0014448	2	1	1	1	1	1	1	8
OG0014449	2	1	1	1	1	1	1	8
OG0014450	1	2	1	1	1	1	1	8
OG0014451	2	1	1	1	1	1	1	8
OG0014452	2	1	1	1	1	1	1	8
OG0014453	2	1	1	1	1	1	1	8
OG0014454	1	2	1	1	1	1	1	8
OG0014455	2	2	1	1	1	0	1	8
OG0014456	7	0	0	0	1	0	0	8
OG0014457	2	1	1	1	1	1	1	8
OG0014458	1	3	1	1	1	1	0	8
OG0014459	2	1	1	1	1	1	1	8
OG0014460	1	2	1	1	1	1	1	8
OG0014461	3	2	1	0	0	0	2	8
OG0014462	3	3	1	1	0	0	0	8
OG0014463	1	2	1	1	1	1	1	8
OG0014464	2	3	1	0	0	1	1	8
OG0014465	1	2	1	1	1	1	1	8
OG0014466	2	1	1	1	1	1	1	8
OG0014467	1	2	1	1	1	1	1	8
OG0014468	2	2	1	1	1	1	0	8
OG0014469	2	1	1	1	1	1	1	8
OG0014470	1	3	1	1	1	0	1	8
OG0014471	1	3	1	0	1	1	1	8
OG0014472	1	2	1	1	1	1	1	8
OG0014473	1	3	1	0	1	1	1	8
OG0014474	1	2	1	1	1	1	1	8
OG0014475	2	1	1	1	1	1	1	8
OG0014476	3	2	1	0	1	1	0	8
OG0014477	2	2	1	1	0	1	1	8
OG0014478	2	2	1	1	1	0	1	8
OG0014479	2	2	1	1	1	1	0	8
OG0014480	2	1	1	1	1	1	1	8
OG0014481	2	1	1	1	1	1	1	8
OG0014482	7	0	1	0	0	0	0	8
OG0014483	2	3	1	1	0	1	0	8
OG0014484	1	1	2	1	1	1	1	8
OG0014485	1	2	1	1	1	1	1	8
OG0014486	2	1	1	1	1	1	1	8
OG0014487	2	2	1	1	1	0	1	8
OG0014488	2	1	1	1	1	1	1	8
OG0014489	2	3	1	1	0	0	1	8
OG0014490	2	1	1	1	1	1	1	8
OG0014491	2	1	1	1	1	1	1	8
OG0014492	2	1	1	1	1	1	1	8
OG0014493	1	2	1	1	1	1	1	8
OG0014494	2	2	1	1	1	0	1	8
OG0014495	1	2	1	1	1	1	1	8
OG0014496	1	3	1	1	1	1	0	8
OG0014497	2	2	1	1	1	0	1	8
OG0014498	8	0	0	0	0	0	0	8
OG0014499	1	2	1	1	1	1	1	8
OG0014500	1	2	1	1	1	1	1	8
OG0014501	2	2	1	1	1	1	0	8
OG0014502	2	1	1	1	1	1	1	8
OG0014503	1	2	1	1	1	1	1	8
OG0014504	1	3	1	1	1	0	1	8
OG0014505	2	1	1	1	1	1	1	8
OG0014506	1	3	1	1	1	0	1	8
OG0014507	2	1	1	1	1	1	1	8
OG0014508	1	4	1	1	1	0	0	8
OG0014509	2	2	1	1	1	0	1	8
OG0014510	2	1	1	1	1	1	1	8
OG0014511	2	1	1	1	1	1	1	8
OG0014512	1	5	1	0	0	1	0	8
OG0014513	3	0	1	1	1	1	1	8
OG0014514	1	2	1	1	1	1	1	8
OG0014515	2	2	1	1	1	0	1	8
OG0014516	1	2	1	1	1	1	1	8
OG0014517	2	1	1	1	1	1	1	8
OG0014518	3	0	1	1	1	1	1	8
OG0014519	1	2	1	1	1	1	1	8
OG0014520	2	1	1	1	1	1	1	8
OG0014521	2	2	1	1	1	0	1	8
OG0014522	2	1	1	1	1	1	1	8
OG0014523	1	3	1	1	1	1	0	8
OG0014524	2	1	1	1	1	1	1	8
OG0014525	8	0	0	0	0	0	0	8
OG0014526	1	2	1	1	1	1	1	8
OG0014527	2	1	1	1	1	1	1	8
OG0014528	2	4	1	0	0	0	1	8
OG0014529	2	1	1	1	1	1	1	8
OG0014530	2	1	1	1	1	1	1	8
OG0014531	1	2	1	1	1	1	1	8
OG0014532	2	2	1	1	1	1	0	8
OG0014533	8	0	0	0	0	0	0	8
OG0014534	1	2	1	1	1	1	1	8
OG0014535	2	2	1	0	1	1	1	8
OG0014536	2	2	1	1	1	1	0	8
OG0014537	8	0	0	0	0	0	0	8
OG0014538	3	1	1	1	1	0	1	8
OG0014539	2	2	1	1	1	0	1	8
OG0014540	2	1	1	1	1	1	1	8
OG0014541	2	2	1	1	0	1	1	8
OG0014542	8	0	0	0	0	0	0	8
OG0014543	2	1	1	1	1	1	1	8
OG0014544	2	1	1	1	1	1	1	8
OG0014545	2	1	1	1	1	1	1	8
OG0014546	2	1	1	1	1	1	1	8
OG0014547	2	1	1	1	1	1	1	8
OG0014548	1	2	1	1	1	1	1	8
OG0014549	1	2	1	1	1	1	1	8
OG0014550	2	1	1	1	1	1	1	8
OG0014551	1	2	1	1	1	1	1	8
OG0014552	2	1	1	1	1	1	1	8
OG0014553	1	2	1	1	1	1	1	8
OG0014554	2	1	1	1	1	1	1	8
OG0014555	1	2	1	1	1	1	1	8
OG0014556	2	2	1	1	1	1	0	8
OG0014557	4	0	1	0	2	1	0	8
OG0014558	2	1	1	1	1	1	1	8
OG0014559	3	0	1	1	1	1	1	8
OG0014560	2	2	0	1	1	1	1	8
OG0014561	2	1	1	1	1	1	1	8
OG0014562	1	2	1	1	1	1	1	8
OG0014563	8	0	0	0	0	0	0	8
OG0014564	2	2	1	1	1	1	0	8
OG0014565	1	2	1	1	1	1	1	8
OG0014566	3	2	0	1	1	1	0	8
OG0014567	1	2	1	2	1	1	0	8
OG0014568	3	1	1	1	0	1	1	8
OG0014569	2	1	1	1	1	1	1	8
OG0014570	1	4	1	1	0	0	1	8
OG0014571	2	2	2	0	0	1	1	8
OG0014572	1	2	1	1	1	1	1	8
OG0014573	1	2	1	1	1	1	1	8
OG0014574	1	2	1	1	1	1	1	8
OG0014575	1	2	1	1	1	1	1	8
OG0014576	1	2	1	1	1	1	1	8
OG0014577	1	2	1	1	1	1	1	8
OG0014578	1	2	1	1	1	1	1	8
OG0014579	1	2	1	1	1	1	1	8
OG0014580	2	1	1	1	1	1	1	8
OG0014581	1	2	1	1	1	1	1	8
OG0014582	2	3	1	1	1	0	0	8
OG0014583	1	2	1	1	1	1	1	8
OG0014584	2	1	1	1	1	1	1	8
OG0014585	2	1	1	1	1	1	1	8
OG0014586	1	1	1	1	2	1	1	8
OG0014587	1	2	1	1	1	1	1	8
OG0014588	2	2	1	0	1	1	1	8
OG0014589	2	1	1	1	1	1	1	8
OG0014590	1	2	1	1	1	1	1	8
OG0014591	8	0	0	0	0	0	0	8
OG0014592	2	2	1	0	1	1	1	8
OG0014593	1	2	1	1	1	1	1	8
OG0014594	2	1	1	1	1	1	1	8
OG0014595	2	1	1	1	1	1	1	8
OG0014596	2	2	1	1	1	0	1	8
OG0014597	2	1	1	1	1	1	1	8
OG0014598	2	4	1	1	0	0	0	8
OG0014599	1	2	1	1	1	1	1	8
OG0014600	1	4	0	1	0	1	1	8
OG0014601	2	3	1	1	0	0	1	8
OG0014602	2	1	1	1	1	1	1	8
OG0014603	2	1	1	1	1	1	1	8
OG0014604	2	1	1	1	1	1	1	8
OG0014605	2	1	1	1	1	1	1	8
OG0014606	2	1	1	1	1	1	1	8
OG0014607	2	2	1	1	1	0	1	8
OG0014608	1	3	1	0	1	1	1	8
OG0014609	1	2	1	1	1	1	1	8
OG0014610	1	4	1	1	1	0	0	8
OG0014611	2	2	1	1	1	1	0	8
OG0014612	1	2	1	1	1	1	1	8
OG0014613	1	2	1	1	1	1	1	8
OG0014614	1	2	1	1	1	1	1	8
OG0014615	2	1	1	1	1	1	1	8
OG0014616	3	3	1	0	0	0	1	8
OG0014617	1	3	1	1	0	1	1	8
OG0014618	2	1	1	1	1	1	1	8
OG0014619	2	1	1	1	1	1	1	8
OG0014620	2	1	1	1	1	1	1	8
OG0014621	2	2	2	1	0	0	1	8
OG0014622	1	2	1	1	1	1	1	8
OG0014623	1	2	1	1	1	1	1	8
OG0014624	7	0	1	0	0	0	0	8
OG0014625	1	2	1	1	1	1	1	8
OG0014626	2	1	1	1	1	1	1	8
OG0014627	1	2	1	1	1	1	1	8
OG0014628	2	1	1	1	1	1	1	8
OG0014629	2	1	1	1	1	0	2	8
OG0014630	2	1	1	1	1	1	1	8
OG0014631	3	1	1	1	1	0	1	8
OG0014632	1	2	1	1	1	1	1	8
OG0014633	5	0	1	0	0	2	0	8
OG0014634	1	3	1	0	1	1	1	8
OG0014635	2	1	1	1	1	1	1	8
OG0014636	2	1	1	1	1	1	1	8
OG0014637	1	2	1	1	1	0	2	8
OG0014638	2	1	1	1	1	1	1	8
OG0014639	1	2	1	1	1	1	1	8
OG0014640	2	1	1	1	1	1	1	8
OG0014641	1	2	1	1	1	1	1	8
OG0014642	2	1	1	1	1	1	1	8
OG0014643	1	3	0	1	0	1	2	8
OG0014644	2	2	1	1	1	1	0	8
OG0014645	2	1	1	1	1	1	1	8
OG0014646	8	0	0	0	0	0	0	8
OG0014647	2	2	1	1	0	1	1	8
OG0014648	8	0	0	0	0	0	0	8
OG0014649	1	2	1	1	1	1	1	8
OG0014650	1	4	1	0	1	0	1	8
OG0014651	1	2	1	0	1	2	1	8
OG0014652	2	2	1	1	1	0	1	8
OG0014653	8	0	0	0	0	0	0	8
OG0014654	1	2	1	1	1	1	1	8
OG0014655	2	3	1	0	1	0	1	8
OG0014656	3	1	1	1	1	0	1	8
OG0014657	1	2	1	1	1	1	1	8
OG0014658	2	1	1	1	1	1	1	8
OG0014659	1	2	1	1	1	1	1	8
OG0014660	2	3	1	1	1	0	0	8
OG0014661	2	1	1	1	1	1	1	8
OG0014662	1	2	1	1	1	1	1	8
OG0014663	2	1	1	1	0	2	1	8
OG0014664	2	1	1	1	1	1	1	8
OG0014665	1	2	1	1	1	1	1	8
OG0014666	1	2	1	1	1	1	1	8
OG0014667	2	1	1	1	1	1	1	8
OG0014668	2	1	1	1	1	1	1	8
OG0014669	2	1	1	1	1	1	1	8
OG0014670	1	3	1	1	1	0	1	8
OG0014671	2	0	1	1	1	2	1	8
OG0014672	2	0	1	1	1	2	1	8
OG0014673	2	1	1	1	1	1	1	8
OG0014674	2	1	1	1	1	1	1	8
OG0014675	1	2	1	1	1	1	1	8
OG0014676	1	2	1	1	1	1	1	8
OG0014677	6	1	0	0	1	0	0	8
OG0014678	2	2	1	1	0	1	1	8
OG0014679	1	2	1	1	0	1	2	8
OG0014680	2	1	1	1	1	1	1	8
OG0014681	1	1	1	1	1	1	2	8
OG0014682	1	3	1	1	1	0	1	8
OG0014683	3	0	1	1	1	1	1	8
OG0014684	2	2	1	1	1	1	0	8
OG0014685	1	3	1	1	1	0	1	8
OG0014686	1	1	2	1	1	1	1	8
OG0014687	2	2	1	0	1	1	1	8
OG0014688	2	2	1	1	0	1	1	8
OG0014689	2	2	1	1	1	0	1	8
OG0014690	2	2	1	1	1	1	0	8
OG0014691	1	2	1	1	1	1	1	8
OG0014692	1	2	1	1	1	1	1	8
OG0014693	2	2	1	0	1	1	1	8
OG0014694	1	2	1	1	1	1	1	8
OG0014695	2	3	1	1	0	0	1	8
OG0014696	2	2	1	0	1	1	1	8
OG0014697	3	0	1	1	1	1	1	8
OG0014698	1	3	1	0	1	1	1	8
OG0014699	2	1	1	1	1	1	1	8
OG0014700	1	2	1	1	1	1	1	8
OG0014701	2	3	1	0	1	0	1	8
OG0014702	2	1	1	1	1	1	1	8
OG0014703	1	2	1	1	1	1	1	8
OG0014704	2	1	1	1	1	1	1	8
OG0014705	1	2	1	1	1	1	1	8
OG0014706	2	4	0	2	0	0	0	8
OG0014707	1	3	1	1	1	0	1	8
OG0014708	1	2	1	1	1	1	1	8
OG0014709	1	3	1	1	1	0	1	8
OG0014710	1	2	1	1	1	1	1	8
OG0014711	2	2	1	0	1	1	1	8
OG0014712	1	2	1	1	1	1	1	8
OG0014713	1	3	1	1	1	0	1	8
OG0014714	2	3	1	1	1	0	0	8
OG0014715	2	2	1	1	0	1	1	8
OG0014716	2	1	1	1	1	1	1	8
OG0014717	1	2	1	1	1	1	1	8
OG0014718	1	2	1	1	1	1	1	8
OG0014719	2	1	1	1	1	1	1	8
OG0014720	8	0	0	0	0	0	0	8
OG0014721	1	2	1	1	1	1	1	8
OG0014722	1	2	1	1	1	1	1	8
OG0014723	1	3	1	1	0	1	1	8
OG0014724	8	0	0	0	0	0	0	8
OG0014725	2	2	1	1	0	1	1	8
OG0014726	1	2	1	1	1	1	1	8
OG0014727	2	1	1	1	1	1	1	8
OG0014728	1	3	1	0	1	1	1	8
OG0014729	1	2	1	1	1	1	1	8
OG0014730	2	1	1	1	1	1	1	8
OG0014731	2	2	1	1	1	0	1	8
OG0014732	1	2	1	1	1	1	1	8
OG0014733	5	0	0	2	0	1	0	8
OG0014734	1	2	1	1	1	1	1	8
OG0014735	2	1	1	1	1	1	1	8
OG0014736	2	1	1	1	1	1	1	8
OG0014737	1	4	0	0	1	0	2	8
OG0014738	2	2	1	1	1	0	1	8
OG0014739	2	1	1	1	1	1	1	8
OG0014740	1	3	1	0	1	1	1	8
OG0014741	1	2	1	1	1	1	1	8
OG0014742	1	3	0	1	1	1	1	8
OG0014743	8	0	0	0	0	0	0	8
OG0014744	2	1	1	1	1	1	1	8
OG0014745	1	2	1	1	1	1	1	8
OG0014746	2	2	1	1	1	0	1	8
OG0014747	3	0	2	0	0	1	2	8
OG0014748	2	2	1	0	1	1	1	8
OG0014749	1	3	1	1	1	0	1	8
OG0014750	2	1	1	1	1	1	1	8
OG0014751	2	1	1	1	1	1	1	8
OG0014752	2	1	1	1	1	1	1	8
OG0014753	2	2	1	1	1	1	0	8
OG0014754	2	1	1	1	1	1	1	8
OG0014755	1	4	1	1	1	0	0	8
OG0014756	1	2	1	1	1	1	1	8
OG0014757	8	0	0	0	0	0	0	8
OG0014758	1	3	1	1	1	1	0	8
OG0014759	2	1	1	1	1	1	1	8
OG0014760	2	2	1	1	0	1	1	8
OG0014761	8	0	0	0	0	0	0	8
OG0014762	2	1	1	1	1	1	1	8
OG0014763	4	0	0	2	2	0	0	8
OG0014764	3	1	1	0	1	1	1	8
OG0014765	2	1	1	1	1	1	1	8
OG0014766	2	3	1	1	0	0	1	8
OG0014767	1	2	1	1	1	1	1	8
OG0014768	1	2	1	1	1	1	1	8
OG0014769	8	0	0	0	0	0	0	8
OG0014770	2	2	1	1	0	1	1	8
OG0014771	1	2	1	1	1	1	1	8
OG0014772	2	1	1	1	1	1	1	8
OG0014773	2	1	1	1	1	1	1	8
OG0014774	2	1	1	1	1	1	1	8
OG0014775	2	1	1	1	1	1	1	8
OG0014776	2	2	1	1	0	1	1	8
OG0014777	2	1	1	1	1	1	1	8
OG0014778	1	3	1	1	0	1	1	8
OG0014779	4	2	1	0	0	0	1	8
OG0014780	3	2	1	0	0	1	1	8
OG0014781	2	1	1	1	1	1	1	8
OG0014782	8	0	0	0	0	0	0	8
OG0014783	1	3	1	1	0	1	1	8
OG0014784	2	1	1	1	1	1	1	8
OG0014785	1	2	1	1	1	1	1	8
OG0014786	7	0	0	0	0	1	0	8
OG0014787	1	2	1	1	1	1	1	8
OG0014788	1	3	1	1	1	0	1	8
OG0014789	2	1	1	1	1	1	1	8
OG0014790	2	1	1	1	1	1	1	8
OG0014791	2	1	1	1	1	1	1	8
OG0014792	8	0	0	0	0	0	0	8
OG0014793	1	1	1	1	1	1	2	8
OG0014794	2	2	0	1	1	1	1	8
OG0014795	2	1	1	1	1	1	1	8
OG0014796	2	2	1	2	0	0	1	8
OG0014797	2	2	1	1	0	1	1	8
OG0014798	1	2	1	1	1	1	1	8
OG0014799	1	2	1	1	1	1	1	8
OG0014800	1	2	1	1	1	1	1	8
OG0014801	1	4	1	0	1	0	1	8
OG0014802	3	1	1	0	1	1	1	8
OG0014803	1	2	1	1	1	1	1	8
OG0014804	8	0	0	0	0	0	0	8
OG0014805	1	2	1	1	1	1	1	8
OG0014806	7	0	0	0	0	0	1	8
OG0014807	1	2	1	1	1	1	1	8
OG0014808	2	1	1	1	1	1	1	8
OG0014809	1	3	1	1	1	0	1	8
OG0014810	2	1	1	1	1	1	1	8
OG0014811	2	1	1	1	1	1	1	8
OG0014812	2	2	1	1	1	0	1	8
OG0014813	1	2	1	1	1	1	1	8
OG0014814	2	1	1	1	1	1	1	8
OG0014815	2	2	1	1	1	1	0	8
OG0014816	2	1	1	1	1	1	1	8
OG0014817	3	2	1	0	0	1	1	8
OG0014818	1	2	1	1	1	1	1	8
OG0014819	2	1	1	1	1	1	1	8
OG0014820	1	3	1	1	1	0	1	8
OG0014821	2	1	1	2	1	1	0	8
OG0014822	2	1	1	1	1	1	1	8
OG0014823	2	1	1	1	1	1	1	8
OG0014824	1	2	1	1	1	1	1	8
OG0014825	2	1	1	1	1	1	1	8
OG0014826	1	2	1	1	1	1	1	8
OG0014827	1	2	1	1	1	1	1	8
OG0014828	1	2	2	1	1	1	0	8
OG0014829	1	2	1	1	1	1	1	8
OG0014830	1	2	1	1	1	1	1	8
OG0014831	1	4	1	1	0	0	1	8
OG0014832	1	2	1	1	1	1	1	8
OG0014833	1	2	1	1	1	1	1	8
OG0014834	2	3	1	0	0	1	1	8
OG0014835	1	3	0	1	1	1	1	8
OG0014836	2	2	1	0	1	1	1	8
OG0014837	2	0	1	2	1	1	1	8
OG0014838	2	1	1	1	1	1	1	8
OG0014839	1	2	1	1	1	1	1	8
OG0014840	2	2	1	1	1	1	0	8
OG0014841	8	0	0	0	0	0	0	8
OG0014842	2	1	1	1	1	0	2	8
OG0014843	3	1	1	0	1	1	1	8
OG0014844	2	2	1	1	0	1	1	8
OG0014845	2	2	1	1	1	0	1	8
OG0014846	2	2	1	1	0	1	1	8
OG0014847	8	0	0	0	0	0	0	8
OG0014848	2	2	1	1	1	1	0	8
OG0014849	8	0	0	0	0	0	0	8
OG0014850	2	1	1	1	1	1	1	8
OG0014851	1	2	1	1	1	1	1	8
OG0014852	1	2	1	1	1	1	1	8
OG0014853	1	2	1	1	1	1	1	8
OG0014854	2	1	1	1	1	1	1	8
OG0014855	2	1	1	1	1	1	1	8
OG0014856	1	3	0	0	1	2	1	8
OG0014857	2	1	1	1	1	1	1	8
OG0014858	1	2	1	1	1	1	1	8
OG0014859	1	3	1	1	1	0	1	8
OG0014860	1	2	1	1	1	1	1	8
OG0014861	2	2	1	1	1	1	0	8
OG0014862	1	2	1	1	1	1	1	8
OG0014863	1	3	1	1	1	0	1	8
OG0014864	6	2	0	0	0	0	0	8
OG0014865	1	2	1	1	1	1	1	8
OG0014866	1	1	1	1	1	1	2	8
OG0014867	2	1	1	1	1	1	1	8
OG0014868	3	0	1	1	1	1	1	8
OG0014869	2	1	1	1	1	1	1	8
OG0014870	2	1	1	1	1	1	1	8
OG0014871	2	1	1	1	1	1	1	8
OG0014872	1	2	1	1	1	1	1	8
OG0014873	2	2	1	1	1	0	1	8
OG0014874	2	1	1	1	1	0	2	8
OG0014875	1	1	1	1	1	1	2	8
OG0014876	2	2	1	1	1	0	1	8
OG0014877	3	0	1	1	1	1	1	8
OG0014878	1	3	1	1	1	1	0	8
OG0014879	8	0	0	0	0	0	0	8
OG0014880	2	1	1	1	1	1	1	8
OG0014881	1	3	1	1	1	0	1	8
OG0014882	2	1	1	1	1	1	1	8
OG0014883	2	2	1	1	1	0	1	8
OG0014884	1	2	1	1	1	1	1	8
OG0014885	1	2	1	1	1	1	1	8
OG0014886	2	2	1	0	1	1	1	8
OG0014887	1	2	1	1	1	1	1	8
OG0014888	2	1	1	1	1	1	1	8
OG0014889	7	0	1	0	0	0	0	8
OG0014890	3	3	0	1	0	1	0	8
OG0014891	2	1	1	1	1	1	1	8
OG0014892	2	1	1	1	1	1	1	8
OG0014893	1	2	1	1	1	1	1	8
OG0014894	1	2	1	1	1	1	1	8
OG0014895	2	3	1	1	0	0	1	8
OG0014896	1	2	1	1	1	1	1	8
OG0014897	2	2	1	1	1	0	1	8
OG0014898	1	2	1	1	1	1	1	8
OG0014899	3	1	1	1	1	0	1	8
OG0014900	1	4	0	1	0	1	1	8
OG0014901	1	4	1	1	0	0	1	8
OG0014902	1	0	1	0	0	2	4	8
OG0014903	2	2	1	1	1	0	1	8
OG0014904	1	2	1	1	1	1	1	8
OG0014905	2	1	1	1	1	1	1	8
OG0014906	2	2	1	1	1	1	0	8
OG0014907	2	1	1	1	1	1	1	8
OG0014908	2	1	1	1	1	1	1	8
OG0014909	2	2	1	1	1	1	0	8
OG0014910	1	2	1	1	1	1	1	8
OG0014911	2	5	1	0	0	0	0	8
OG0014912	1	1	2	1	1	1	1	8
OG0014913	2	2	1	1	1	0	1	8
OG0014914	1	2	1	1	1	1	1	8
OG0014915	3	1	1	1	1	0	1	8
OG0014916	2	2	1	1	0	1	1	8
OG0014917	1	3	1	1	1	0	1	8
OG0014918	2	1	1	1	1	1	1	8
OG0014919	1	2	1	1	1	1	1	8
OG0014920	8	0	0	0	0	0	0	8
OG0014921	2	1	1	1	1	1	1	8
OG0014922	3	1	1	1	1	0	1	8
OG0014923	1	2	1	1	1	1	1	8
OG0014924	2	1	1	1	1	1	1	8
OG0014925	1	5	0	2	0	0	0	8
OG0014926	2	1	1	1	1	1	1	8
OG0014927	2	1	1	1	1	1	1	8
OG0014928	2	1	1	1	1	1	1	8
OG0014929	4	4	0	0	0	0	0	8
OG0014930	1	2	1	1	1	1	1	8
OG0014931	1	3	1	1	0	1	1	8
OG0014932	1	2	1	1	1	1	1	8
OG0014933	2	1	1	1	0	2	1	8
OG0014934	2	1	1	1	1	1	1	8
OG0014935	8	0	0	0	0	0	0	8
OG0014936	7	0	1	0	0	0	0	8
OG0014937	1	3	0	1	1	1	1	8
OG0014938	1	2	1	1	1	1	1	8
OG0014939	1	2	1	1	1	1	1	8
OG0014940	1	3	1	1	1	0	1	8
OG0014941	1	2	1	1	1	1	1	8
OG0014942	2	3	1	1	0	1	0	8
OG0014943	2	3	1	0	1	0	1	8
OG0014944	1	2	1	1	1	1	1	8
OG0014945	4	0	3	1	0	0	0	8
OG0014946	1	2	1	1	1	1	1	8
OG0014947	1	2	1	1	1	1	1	8
OG0014948	1	3	1	1	1	0	1	8
OG0014949	2	0	1	1	1	1	2	8
OG0014950	1	2	1	1	1	1	1	8
OG0014951	2	1	1	1	1	1	1	8
OG0014952	1	2	1	1	1	1	1	8
OG0014953	2	1	1	1	1	1	1	8
OG0014954	1	2	1	1	1	1	1	8
OG0014955	3	2	1	0	0	1	1	8
OG0014956	2	2	1	1	1	0	1	8
OG0014957	2	1	1	1	1	1	1	8
OG0014958	2	2	1	1	1	1	0	8
OG0014959	1	4	1	1	0	0	1	8
OG0014960	2	1	1	1	1	1	1	8
OG0014961	1	2	1	1	1	1	1	8
OG0014962	2	1	1	1	1	1	1	8
OG0014963	1	3	1	1	1	1	0	8
OG0014964	2	3	0	1	1	0	1	8
OG0014965	2	2	0	1	1	1	1	8
OG0014966	2	2	1	1	1	0	1	8
OG0014967	2	2	1	1	1	1	0	8
OG0014968	1	2	1	1	1	1	1	8
OG0014969	2	3	1	1	0	0	1	8
OG0014970	2	1	1	1	1	1	1	8
OG0014971	2	1	1	1	1	1	1	8
OG0014972	1	2	1	1	1	1	1	8
OG0014973	1	3	1	1	1	0	1	8
OG0014974	1	2	1	1	1	1	1	8
OG0014975	2	2	1	1	1	0	1	8
OG0014976	2	3	0	0	1	0	2	8
OG0014977	2	2	1	0	1	1	1	8
OG0014978	1	2	1	1	1	1	1	8
OG0014979	2	0	2	1	1	1	1	8
OG0014980	2	3	1	1	0	1	0	8
OG0014981	2	1	1	1	1	1	1	8
OG0014982	2	1	1	1	1	1	1	8
OG0014983	1	2	1	1	1	1	1	8
OG0014984	1	3	1	1	1	0	1	8
OG0014985	1	2	1	1	1	1	1	8
OG0014986	1	2	1	1	1	1	1	8
OG0014987	2	1	1	1	1	1	1	8
OG0014988	1	2	1	1	1	1	1	8
OG0014989	2	2	1	1	1	0	1	8
OG0014990	2	1	1	1	1	1	1	8
OG0014991	2	1	1	1	1	0	2	8
OG0014992	2	1	1	1	1	1	1	8
OG0014993	1	2	1	1	1	1	1	8
OG0014994	1	2	1	1	1	1	1	8
OG0014995	2	2	1	1	1	1	0	8
OG0014996	1	2	1	2	1	0	1	8
OG0014997	1	2	1	1	1	1	1	8
OG0014998	2	2	1	1	1	1	0	8
OG0014999	2	1	1	0	2	1	1	8
OG0015000	2	3	1	1	0	0	1	8
OG0015001	1	3	1	1	1	0	1	8
OG0015002	1	2	1	1	1	1	1	8
OG0015003	3	1	1	1	1	1	0	8
OG0015004	1	4	1	0	0	2	0	8
OG0015005	1	2	1	1	1	1	1	8
OG0015006	1	2	1	1	1	1	1	8
OG0015007	1	2	1	1	1	1	1	8
OG0015008	1	2	1	1	1	1	1	8
OG0015009	2	1	1	1	1	1	1	8
OG0015010	2	1	1	1	1	1	1	8
OG0015011	2	1	1	1	1	1	1	8
OG0015012	1	3	1	1	1	1	0	8
OG0015013	2	2	1	1	1	0	1	8
OG0015014	2	1	1	1	1	1	1	8
OG0015015	2	1	1	1	1	1	1	8
OG0015016	1	3	0	1	1	1	1	8
OG0015017	2	2	1	1	1	0	1	8
OG0015018	1	2	1	1	1	1	1	8
OG0015019	2	1	1	1	1	1	1	8
OG0015020	2	1	1	1	1	1	1	8
OG0015021	1	3	1	1	1	1	0	8
OG0015022	2	2	1	1	1	0	1	8
OG0015023	2	2	1	1	1	0	1	8
OG0015024	2	1	1	1	1	1	1	8
OG0015025	2	1	1	1	1	1	1	8
OG0015026	2	1	1	1	1	1	1	8
OG0015027	2	2	1	1	1	1	0	8
OG0015028	1	2	1	1	1	1	1	8
OG0015029	1	3	1	1	0	1	1	8
OG0015030	1	3	1	1	1	0	1	8
OG0015031	2	1	1	1	1	1	1	8
OG0015032	1	2	1	1	1	1	1	8
OG0015033	1	3	1	0	1	1	1	8
OG0015034	2	2	1	1	1	1	0	8
OG0015035	1	2	1	1	1	1	1	8
OG0015036	1	3	1	1	1	0	1	8
OG0015037	1	4	1	1	1	0	0	8
OG0015038	2	1	1	1	1	1	1	8
OG0015039	2	2	2	0	1	0	1	8
OG0015040	1	2	1	1	1	1	1	8
OG0015041	3	1	1	0	1	1	1	8
OG0015042	2	1	1	1	1	1	1	8
OG0015043	1	2	1	1	1	1	1	8
OG0015044	2	1	1	1	1	1	1	8
OG0015045	2	2	1	1	0	1	1	8
OG0015046	2	1	1	1	1	1	1	8
OG0015047	2	1	1	1	1	1	1	8
OG0015048	2	1	1	1	1	1	1	8
OG0015049	2	2	1	1	1	0	1	8
OG0015050	2	1	1	1	1	1	1	8
OG0015051	1	3	1	1	1	0	1	8
OG0015052	2	0	1	1	1	1	2	8
OG0015053	2	1	1	1	1	1	1	8
OG0015054	2	1	1	1	1	1	1	8
OG0015055	2	1	1	1	1	1	1	8
OG0015056	2	1	1	1	1	1	1	8
OG0015057	2	1	1	1	1	1	1	8
OG0015058	2	2	1	1	1	0	1	8
OG0015059	2	1	1	1	1	1	1	8
OG0015060	2	1	1	1	1	1	1	8
OG0015061	1	3	1	1	1	1	0	8
OG0015062	1	2	1	1	1	1	1	8
OG0015063	2	1	1	1	1	1	1	8
OG0015064	5	2	0	0	0	0	1	8
OG0015065	2	1	1	1	1	1	1	8
OG0015066	1	2	1	1	1	1	1	8
OG0015067	1	3	1	1	1	1	0	8
OG0015068	1	2	1	1	1	1	1	8
OG0015069	1	2	1	1	1	1	1	8
OG0015070	1	2	1	1	1	1	1	8
OG0015071	1	1	1	2	0	2	1	8
OG0015072	1	1	1	1	1	2	1	8
OG0015073	2	1	1	1	1	1	1	8
OG0015074	2	1	1	1	1	1	1	8
OG0015075	5	0	1	0	0	0	2	8
OG0015076	2	2	2	1	0	0	1	8
OG0015077	3	2	1	0	0	1	1	8
OG0015078	2	1	1	1	1	1	1	8
OG0015079	1	2	1	1	1	1	1	8
OG0015080	1	2	1	1	1	1	1	8
OG0015081	1	3	1	1	1	0	1	8
OG0015082	2	1	1	1	1	1	1	8
OG0015083	8	0	0	0	0	0	0	8
OG0015084	1	3	1	0	1	1	1	8
OG0015085	2	1	1	1	1	1	1	8
OG0015086	2	1	1	1	1	1	1	8
OG0015087	2	1	1	1	1	1	1	8
OG0015088	1	2	1	1	1	1	1	8
OG0015089	1	1	1	2	1	1	1	8
OG0015090	1	2	1	1	1	1	1	8
OG0015091	1	2	1	1	1	1	1	8
OG0015092	2	2	1	1	0	1	1	8
OG0015093	2	1	1	1	1	1	1	8
OG0015094	2	3	1	1	0	1	0	8
OG0015095	2	1	1	1	1	1	1	8
OG0015096	2	1	1	1	1	1	1	8
OG0015097	2	1	1	1	1	1	1	8
OG0015098	2	2	1	1	1	0	1	8
OG0015099	1	2	1	1	0	1	2	8
OG0015100	1	2	1	1	1	1	1	8
OG0015101	2	1	1	1	1	1	1	8
OG0015102	2	0	1	1	1	2	1	8
OG0015103	1	2	1	1	1	1	1	8
OG0015104	1	3	1	1	1	0	1	8
OG0015105	1	2	1	1	1	1	1	8
OG0015106	1	2	1	1	1	1	1	8
OG0015107	1	1	1	1	1	1	2	8
OG0015108	2	2	1	1	1	0	1	8
OG0015109	3	1	1	1	1	0	1	8
OG0015110	2	1	1	1	1	1	1	8
OG0015111	3	1	1	1	1	0	1	8
OG0015112	1	2	1	1	1	1	1	8
OG0015113	2	0	1	1	1	1	2	8
OG0015114	2	3	1	0	0	1	1	8
OG0015115	2	1	1	1	1	1	1	8
OG0015116	1	2	1	1	1	1	1	8
OG0015117	2	1	1	1	1	1	1	8
OG0015118	2	1	1	1	1	1	1	8
OG0015119	2	1	1	1	1	1	1	8
OG0015120	1	2	1	1	1	1	1	8
OG0015121	2	3	1	0	0	0	2	8
OG0015122	1	2	1	1	1	1	1	8
OG0015123	2	1	1	1	1	1	1	8
OG0015124	1	1	2	1	1	1	1	8
OG0015125	3	2	1	1	0	0	1	8
OG0015126	2	2	1	1	0	1	1	8
OG0015127	2	2	1	1	1	1	0	8
OG0015128	2	2	1	1	1	1	0	8
OG0015129	2	1	1	1	1	1	1	8
OG0015130	1	2	1	1	1	1	1	8
OG0015131	1	3	1	1	0	1	1	8
OG0015132	2	1	1	1	1	1	1	8
OG0015133	2	1	1	1	1	1	1	8
OG0015134	2	1	1	1	1	1	1	8
OG0015135	3	0	1	1	1	1	1	8
OG0015136	1	2	1	1	1	1	1	8
OG0015137	2	1	1	1	1	1	1	8
OG0015138	1	2	1	0	1	1	2	8
OG0015139	2	1	1	1	1	1	1	8
OG0015140	2	1	1	1	1	1	1	8
OG0015141	1	2	1	1	1	1	1	8
OG0015142	2	4	1	0	0	0	1	8
OG0015143	1	2	1	1	1	1	1	8
OG0015144	2	1	1	1	1	1	1	8
OG0015145	2	2	1	1	1	0	1	8
OG0015146	1	3	1	1	0	1	1	8
OG0015147	1	0	2	2	1	2	0	8
OG0015148	3	0	1	1	1	1	1	8
OG0015149	1	2	1	1	1	1	1	8
OG0015150	2	1	1	1	1	1	1	8
OG0015151	5	1	1	0	0	0	1	8
OG0015152	1	2	1	1	1	1	1	8
OG0015153	1	2	1	1	1	1	1	8
OG0015154	2	3	1	1	0	0	1	8
OG0015155	1	2	1	1	1	1	1	8
OG0015156	2	2	1	1	0	1	1	8
OG0015157	1	2	1	1	1	1	1	8
OG0015158	1	2	1	1	1	1	1	8
OG0015159	1	2	1	1	1	1	1	8
OG0015160	8	0	0	0	0	0	0	8
OG0015161	1	2	0	0	0	0	5	8
OG0015162	2	1	1	1	1	1	1	8
OG0015163	2	1	1	1	1	1	1	8
OG0015164	3	2	1	1	0	1	0	8
OG0015165	1	3	1	1	1	0	1	8
OG0015166	2	2	1	1	0	1	1	8
OG0015167	2	1	1	1	1	1	1	8
OG0015168	2	1	1	1	1	1	1	8
OG0015169	1	2	1	1	1	1	1	8
OG0015170	2	2	1	1	1	0	1	8
OG0015171	2	1	1	1	1	1	1	8
OG0015172	3	2	2	0	0	0	1	8
OG0015173	2	1	1	1	1	1	1	8
OG0015174	1	2	1	1	1	1	1	8
OG0015175	2	4	1	0	0	0	1	8
OG0015176	3	0	1	1	1	1	1	8
OG0015177	1	2	1	1	1	1	1	8
OG0015178	1	2	1	1	1	1	1	8
OG0015179	1	2	1	1	1	1	1	8
OG0015180	2	1	1	1	1	1	1	8
OG0015181	2	1	1	1	1	1	1	8
OG0015182	2	1	1	1	1	1	1	8
OG0015183	2	1	1	1	1	1	1	8
OG0015184	1	2	1	1	1	1	1	8
OG0015185	1	2	1	1	1	1	1	8
OG0015186	2	2	1	1	1	0	1	8
OG0015187	2	1	1	1	1	1	1	8
OG0015188	1	2	1	1	1	1	1	8
OG0015189	1	2	1	1	1	1	1	8
OG0015190	2	1	1	1	0	2	1	8
OG0015191	2	2	1	0	1	1	1	8
OG0015192	2	1	1	1	1	1	1	8
OG0015193	1	2	1	1	1	1	1	8
OG0015194	1	2	1	1	1	1	1	8
OG0015195	1	2	1	1	1	1	1	8
OG0015196	4	1	1	0	0	1	1	8
OG0015197	1	1	2	1	1	1	1	8
OG0015198	2	1	1	1	2	0	1	8
OG0015199	4	2	0	1	0	1	0	8
OG0015200	1	3	1	1	1	0	1	8
OG0015201	8	0	0	0	0	0	0	8
OG0015202	2	1	1	1	1	1	1	8
OG0015203	2	2	1	1	1	0	1	8
OG0015204	2	2	2	1	1	0	0	8
OG0015205	1	3	1	1	1	0	1	8
OG0015206	1	3	1	1	0	1	1	8
OG0015207	1	2	1	1	1	1	1	8
OG0015208	1	2	1	1	1	1	1	8
OG0015209	1	2	1	1	1	1	1	8
OG0015210	2	2	1	1	1	1	0	8
OG0015211	2	1	1	1	1	1	1	8
OG0015212	1	4	1	0	0	1	1	8
OG0015213	2	1	1	1	1	1	1	8
OG0015214	1	3	1	1	1	0	1	8
OG0015215	2	1	1	1	1	1	1	8
OG0015216	2	1	1	1	1	1	1	8
OG0015217	1	1	1	1	1	2	1	8
OG0015218	1	3	1	1	1	0	1	8
OG0015219	1	4	0	0	0	0	3	8
OG0015220	2	0	1	1	1	1	2	8
OG0015221	2	1	1	1	1	1	1	8
OG0015222	2	1	1	1	1	1	1	8
OG0015223	1	2	1	1	1	1	1	8
OG0015224	3	0	1	1	1	1	1	8
OG0015225	2	1	1	1	1	1	1	8
OG0015226	2	3	1	1	1	0	0	8
OG0015227	1	2	1	1	1	1	1	8
OG0015228	1	2	1	1	1	1	1	8
OG0015229	2	3	1	0	0	1	1	8
OG0015230	2	1	1	1	1	1	1	8
OG0015231	1	2	1	1	1	1	1	8
OG0015232	1	3	1	1	1	1	0	8
OG0015233	4	1	2	0	0	0	1	8
OG0015234	1	2	1	1	1	1	1	8
OG0015235	1	2	1	1	1	1	1	8
OG0015236	1	2	1	1	1	1	1	8
OG0015237	2	1	1	1	1	1	1	8
OG0015238	1	2	1	1	1	1	1	8
OG0015239	1	2	1	1	1	1	1	8
OG0015240	1	2	1	2	1	1	0	8
OG0015241	1	3	1	0	1	1	1	8
OG0015242	1	2	1	1	1	1	1	8
OG0015243	1	2	1	1	1	1	1	8
OG0015244	1	2	1	1	1	1	1	8
OG0015245	2	2	1	1	1	0	1	8
OG0015246	1	3	1	1	1	1	0	8
OG0015247	1	2	1	1	1	1	1	8
OG0015248	2	1	1	1	1	1	1	8
OG0015249	1	2	1	1	1	1	1	8
OG0015250	2	2	1	1	1	1	0	8
OG0015251	1	2	1	1	1	1	1	8
OG0015252	2	2	1	1	1	0	1	8
OG0015253	4	2	1	0	0	0	1	8
OG0015254	1	2	1	1	1	1	1	8
OG0015255	2	2	1	1	1	1	0	8
OG0015256	1	3	1	1	1	1	0	8
OG0015257	2	1	1	1	1	1	1	8
OG0015258	2	5	0	1	0	0	0	8
OG0015259	2	2	1	1	0	1	1	8
OG0015260	1	2	1	1	1	1	1	8
OG0015261	1	2	1	1	1	1	1	8
OG0015262	1	3	1	1	0	1	1	8
OG0015263	1	3	1	1	0	1	1	8
OG0015264	1	2	1	1	1	1	1	8
OG0015265	2	1	1	1	1	1	1	8
OG0015266	2	1	1	1	1	1	1	8
OG0015267	1	2	1	1	1	1	1	8
OG0015268	1	3	0	1	2	1	0	8
OG0015269	1	3	1	1	1	1	0	8
OG0015270	2	1	1	1	1	1	1	8
OG0015271	2	1	1	1	1	1	1	8
OG0015272	2	3	0	0	2	1	0	8
OG0015273	2	1	1	1	1	1	1	8
OG0015274	2	1	1	1	1	1	1	8
OG0015275	1	2	1	1	1	1	1	8
OG0015276	2	2	1	1	1	1	0	8
OG0015277	2	1	1	1	1	1	1	8
OG0015278	2	1	1	1	1	1	1	8
OG0015279	1	4	0	1	0	1	1	8
OG0015280	1	2	1	1	1	1	1	8
OG0015281	1	3	1	1	1	0	1	8
OG0015282	1	2	1	1	1	1	1	8
OG0015283	1	2	1	1	1	1	1	8
OG0015284	2	1	1	1	1	1	1	8
OG0015285	2	1	1	1	1	1	1	8
OG0015286	2	2	1	1	1	1	0	8
OG0015287	3	2	1	1	0	0	1	8
OG0015288	2	2	1	1	1	1	0	8
OG0015289	1	2	1	1	1	1	1	8
OG0015290	1	2	1	1	1	1	1	8
OG0015291	2	0	1	1	1	2	1	8
OG0015292	2	1	1	1	1	1	1	8
OG0015293	2	1	1	1	1	1	1	8
OG0015294	1	2	1	1	1	1	1	8
OG0015295	1	2	1	1	1	1	1	8
OG0015296	2	1	1	1	1	1	1	8
OG0015297	2	1	1	1	1	1	1	8
OG0015298	2	1	1	1	1	1	1	8
OG0015299	2	1	1	1	1	1	1	8
OG0015300	2	0	1	1	2	1	1	8
OG0015301	1	2	1	1	1	1	1	8
OG0015302	1	2	1	1	1	1	1	8
OG0015303	3	1	1	1	1	1	0	8
OG0015304	1	2	1	1	1	1	1	8
OG0015305	1	2	1	1	1	1	1	8
OG0015306	2	1	1	1	1	1	1	8
OG0015307	1	5	0	1	0	0	1	8
OG0015308	1	1	1	2	1	0	2	8
OG0015309	2	1	1	1	1	1	1	8
OG0015310	2	2	1	1	1	1	0	8
OG0015311	2	2	1	1	0	1	1	8
OG0015312	2	1	1	1	1	1	1	8
OG0015313	2	1	1	1	1	1	1	8
OG0015314	1	1	1	1	1	1	2	8
OG0015315	2	1	1	1	1	1	1	8
OG0015316	1	2	1	1	1	1	1	8
OG0015317	1	1	1	1	1	2	1	8
OG0015318	2	3	1	1	1	0	0	8
OG0015319	2	1	1	1	1	1	1	8
OG0015320	3	2	1	1	0	0	1	8
OG0015321	1	3	1	1	1	1	0	8
OG0015322	1	3	1	1	1	0	1	8
OG0015323	1	2	1	1	2	0	1	8
OG0015324	3	0	1	1	1	1	1	8
OG0015325	2	1	1	1	1	1	1	8
OG0015326	3	0	1	1	1	1	1	8
OG0015327	1	2	1	1	1	1	1	8
OG0015328	1	2	1	1	1	1	1	8
OG0015329	2	1	1	1	1	1	1	8
OG0015330	2	3	1	0	0	0	2	8
OG0015331	2	1	1	1	1	1	1	8
OG0015332	1	2	1	1	1	1	1	8
OG0015333	2	1	1	1	1	1	1	8
OG0015334	2	1	1	1	1	1	1	8
OG0015335	2	2	1	1	1	0	1	8
OG0015336	2	1	1	1	1	1	1	8
OG0015337	2	2	1	0	1	1	1	8
OG0015338	2	2	1	0	1	1	1	8
OG0015339	1	2	1	1	1	1	1	8
OG0015340	2	1	1	1	1	1	1	8
OG0015341	2	1	1	1	1	1	1	8
OG0015342	1	2	1	1	1	1	1	8
OG0015343	2	3	1	1	1	0	0	8
OG0015344	2	2	1	1	1	1	0	8
OG0015345	1	3	1	1	1	1	0	8
OG0015346	2	1	1	1	1	1	1	8
OG0015347	1	2	1	1	1	1	1	8
OG0015348	1	2	1	1	1	1	1	8
OG0015349	2	1	1	1	1	1	1	8
OG0015350	2	2	1	1	1	1	0	8
OG0015351	1	2	1	1	1	1	1	8
OG0015352	2	1	1	1	1	1	1	8
OG0015353	1	3	1	1	0	1	1	8
OG0015354	2	2	0	1	1	1	1	8
OG0015355	1	2	1	1	1	1	1	8
OG0015356	2	1	1	1	1	1	1	8
OG0015357	1	2	1	1	1	1	1	8
OG0015358	2	2	1	0	1	1	1	8
OG0015359	2	1	1	0	1	1	2	8
OG0015360	2	2	1	1	1	0	1	8
OG0015361	2	1	1	1	1	1	1	8
OG0015362	2	2	1	1	0	1	1	8
OG0015363	1	2	1	1	1	1	1	8
OG0015364	1	2	1	1	1	1	1	8
OG0015365	2	1	1	1	1	1	1	8
OG0015366	2	1	1	1	1	1	1	8
OG0015367	2	1	1	1	1	1	1	8
OG0015368	2	2	1	1	0	1	1	8
OG0015369	2	1	1	1	1	1	1	8
OG0015370	1	2	1	1	1	1	1	8
OG0015371	2	2	1	0	1	1	1	8
OG0015372	2	0	1	1	1	1	2	8
OG0015373	2	1	1	1	1	1	1	8
OG0015374	1	3	1	0	1	1	1	8
OG0015375	1	2	1	1	1	1	1	8
OG0015376	1	2	1	1	1	1	1	8
OG0015377	2	1	1	1	1	1	1	8
OG0015378	1	2	1	1	1	1	1	8
OG0015379	2	1	1	1	1	1	1	8
OG0015380	2	1	1	1	1	1	1	8
OG0015381	2	2	1	1	1	1	0	8
OG0015382	2	1	1	1	1	1	1	8
OG0015383	3	1	1	1	1	0	1	8
OG0015384	1	2	1	1	1	1	1	8
OG0015385	2	1	1	1	1	1	1	8
OG0015386	2	1	1	1	1	1	1	8
OG0015387	1	2	1	1	1	1	1	8
OG0015388	4	1	1	1	1	0	0	8
OG0015389	2	1	1	1	1	1	1	8
OG0015390	1	3	1	1	1	1	0	8
OG0015391	1	4	1	0	0	1	1	8
OG0015392	1	2	1	1	1	1	1	8
OG0015393	1	2	1	1	1	1	1	8
OG0015394	1	2	1	1	1	1	1	8
OG0015395	1	2	1	1	1	1	1	8
OG0015396	2	1	1	1	1	1	1	8
OG0015397	2	1	1	1	1	1	1	8
OG0015398	1	3	1	1	1	0	1	8
OG0015399	1	2	1	1	1	1	1	8
OG0015400	2	1	1	1	1	1	1	8
OG0015401	1	2	1	1	1	1	1	8
OG0015402	1	2	1	1	1	1	1	8
OG0015403	2	1	1	1	1	1	1	8
OG0015404	1	2	1	1	1	1	1	8
OG0015405	2	1	1	1	1	1	1	8
OG0015406	2	1	1	1	1	1	1	8
OG0015407	1	2	1	1	1	1	1	8
OG0015408	2	2	1	0	1	1	1	8
OG0015409	1	2	1	1	1	1	1	8
OG0015410	1	1	1	2	1	1	1	8
OG0015411	2	2	0	1	1	1	1	8
OG0015412	1	2	1	1	1	1	1	8
OG0015413	2	1	1	1	1	1	1	8
OG0015414	2	1	1	1	1	1	1	8
OG0015415	1	2	1	1	1	1	1	8
OG0015416	2	2	1	1	1	1	0	8
OG0015417	1	2	1	1	1	1	1	8
OG0015418	2	1	1	1	1	1	1	8
OG0015419	2	1	1	1	1	1	1	8
OG0015420	2	3	1	0	0	1	1	8
OG0015421	1	1	1	1	1	1	2	8
OG0015422	2	2	1	1	1	1	0	8
OG0015423	1	3	1	0	1	1	1	8
OG0015424	2	2	1	1	1	0	1	8
OG0015425	2	2	1	1	1	0	1	8
OG0015426	1	2	1	1	1	1	1	8
OG0015427	1	2	1	1	1	1	1	8
OG0015428	2	1	1	1	1	1	1	8
OG0015429	3	2	1	1	0	0	1	8
OG0015430	1	2	1	1	1	1	1	8
OG0015431	2	3	1	1	1	0	0	8
OG0015432	1	2	1	1	1	1	1	8
OG0015433	3	4	1	0	0	0	0	8
OG0015434	1	1	1	1	1	1	2	8
OG0015435	3	2	1	1	1	0	0	8
OG0015436	2	1	1	1	1	1	1	8
OG0015437	1	2	1	1	1	1	1	8
OG0015438	2	2	1	1	1	1	0	8
OG0015439	1	3	1	1	1	0	1	8
OG0015440	1	2	1	1	1	1	1	8
OG0015441	1	3	0	1	1	1	1	8
OG0015442	2	1	1	1	1	1	1	8
OG0015443	2	1	1	1	1	1	1	8
OG0015444	1	2	1	1	1	1	1	8
OG0015445	2	2	1	1	1	1	0	8
OG0015446	2	2	1	0	1	1	1	8
OG0015447	2	1	1	1	1	1	1	8
OG0015448	2	2	1	1	1	1	0	8
OG0015449	1	3	1	1	1	0	1	8
OG0015450	2	1	1	1	1	0	2	8
OG0015451	1	2	1	1	1	1	1	8
OG0015452	3	0	0	2	1	1	1	8
OG0015453	2	1	1	1	1	1	1	8
OG0015454	2	2	1	1	0	1	1	8
OG0015455	2	1	1	1	1	1	1	8
OG0015456	1	3	1	1	1	0	1	8
OG0015457	2	1	1	1	1	1	1	8
OG0015458	2	3	1	0	0	1	1	8
OG0015459	2	1	1	1	1	1	1	8
OG0015460	1	2	1	1	1	1	1	8
OG0015461	1	2	1	1	1	1	1	8
OG0015462	1	2	1	1	1	1	1	8
OG0015463	2	1	1	1	1	1	1	8
OG0015464	2	1	1	1	1	1	1	8
OG0015465	1	2	1	1	1	1	1	8
OG0015466	2	1	1	1	1	1	1	8
OG0015467	2	2	1	1	0	1	1	8
OG0015468	1	3	1	1	1	1	0	8
OG0015469	2	1	1	1	1	1	1	8
OG0015470	2	2	1	1	1	0	1	8
OG0015471	1	2	2	1	0	1	1	8
OG0015472	2	1	1	1	1	1	1	8
OG0015473	1	2	1	1	1	1	1	8
OG0015474	2	5	1	0	0	0	0	8
OG0015475	1	2	1	1	1	1	1	8
OG0015476	1	4	1	1	0	0	1	8
OG0015477	1	0	1	0	0	0	6	8
OG0015478	1	2	1	1	1	1	1	8
OG0015479	1	1	1	1	2	0	2	8
OG0015480	2	2	1	1	1	0	1	8
OG0015481	1	2	1	1	1	1	1	8
OG0015482	1	2	1	1	1	1	1	8
OG0015483	1	2	1	1	1	1	1	8
OG0015484	2	1	1	1	1	1	1	8
OG0015485	2	1	1	1	1	1	1	8
OG0015486	1	3	1	2	0	0	1	8
OG0015487	1	1	1	2	1	1	1	8
OG0015488	1	2	1	1	1	1	1	8
OG0015489	2	1	1	1	1	1	1	8
OG0015490	2	1	1	1	1	1	1	8
OG0015491	2	1	1	1	1	1	1	8
OG0015492	2	2	1	1	1	1	0	8
OG0015493	1	4	1	1	0	0	1	8
OG0015494	2	1	1	1	1	1	1	8
OG0015495	1	2	1	1	1	1	1	8
OG0015496	2	1	1	1	1	1	1	8
OG0015497	2	1	1	1	1	1	1	8
OG0015498	1	2	1	1	1	1	1	8
OG0015499	2	2	1	1	1	0	1	8
OG0015500	2	1	1	1	1	1	1	8
OG0015501	1	3	0	1	1	1	1	8
OG0015502	2	2	1	1	0	1	1	8
OG0015503	1	3	1	1	0	1	1	8
OG0015504	2	1	1	1	1	1	1	8
OG0015505	2	1	1	1	1	1	1	8
OG0015506	2	1	1	1	1	1	1	8
OG0015507	2	2	1	1	1	0	1	8
OG0015508	1	3	1	1	1	1	0	8
OG0015509	1	2	1	1	1	1	1	8
OG0015510	1	2	1	1	1	1	1	8
OG0015511	1	3	0	1	1	1	1	8
OG0015512	1	2	1	1	1	1	1	8
OG0015513	1	2	1	1	1	1	1	8
OG0015514	2	4	0	0	1	1	0	8
OG0015515	2	4	0	0	0	1	1	8
OG0015516	1	2	1	1	1	1	1	8
OG0015517	2	1	1	1	1	1	1	8
OG0015518	1	2	1	1	1	1	1	8
OG0015519	2	2	1	2	0	0	1	8
OG0015520	1	2	1	1	1	1	1	8
OG0015521	2	1	1	1	1	1	1	8
OG0015522	1	2	1	1	1	1	1	8
OG0015523	1	2	1	1	1	1	1	8
OG0015524	2	4	1	0	0	0	1	8
OG0015525	1	3	1	1	1	0	1	8
OG0015526	1	3	1	1	0	1	1	8
OG0015527	2	1	1	1	1	1	1	8
OG0015528	2	1	1	1	1	1	1	8
OG0015529	2	1	1	1	1	1	1	8
OG0015530	2	3	1	0	0	1	1	8
OG0015531	2	2	1	1	1	0	1	8
OG0015532	1	3	1	1	1	1	0	8
OG0015533	1	2	1	1	1	1	1	8
OG0015534	1	2	1	1	1	1	1	8
OG0015535	2	3	1	1	0	0	1	8
OG0015536	2	3	1	1	0	0	1	8
OG0015537	2	1	1	1	1	1	1	8
OG0015538	1	2	1	1	1	1	1	8
OG0015539	2	2	1	0	1	1	1	8
OG0015540	2	1	1	1	1	1	1	8
OG0015541	2	1	1	1	1	1	1	8
OG0015542	2	1	1	1	1	1	1	8
OG0015543	1	2	1	1	1	1	1	8
OG0015544	2	2	1	1	1	1	0	8
OG0015545	2	0	1	1	2	1	1	8
OG0015546	1	2	1	1	1	1	1	8
OG0015547	2	1	1	1	1	1	1	8
OG0015548	1	2	1	1	1	0	2	8
OG0015549	2	1	1	1	1	1	1	8
OG0015550	1	3	0	1	1	1	1	8
OG0015551	1	2	1	1	1	1	1	8
OG0015552	1	2	1	1	1	1	1	8
OG0015553	2	2	1	1	0	1	1	8
OG0015554	1	2	1	1	1	1	1	8
OG0015555	3	2	1	1	0	1	0	8
OG0015556	1	4	1	1	1	0	0	8
OG0015557	2	1	1	1	1	1	1	8
OG0015558	2	1	1	1	1	1	1	8
OG0015559	2	2	1	1	1	1	0	8
OG0015560	2	2	1	0	1	1	1	8
OG0015561	2	3	1	0	0	1	1	8
OG0015562	1	4	1	1	0	1	0	8
OG0015563	2	1	1	1	1	1	1	8
OG0015564	2	1	1	1	1	1	1	8
OG0015565	1	3	0	0	1	2	1	8
OG0015566	2	2	1	1	1	0	1	8
OG0015567	1	2	1	1	1	1	1	8
OG0015568	1	3	1	1	1	1	0	8
OG0015569	3	0	1	0	0	0	4	8
OG0015570	1	2	1	1	1	1	1	8
OG0015571	2	1	1	1	1	1	1	8
OG0015572	2	1	1	1	1	1	1	8
OG0015573	1	2	1	1	1	1	1	8
OG0015574	2	2	1	1	1	0	1	8
OG0015575	1	2	1	1	1	1	1	8
OG0015576	2	1	1	1	1	1	1	8
OG0015577	2	1	1	1	1	1	1	8
OG0015578	2	1	1	1	1	1	1	8
OG0015579	1	2	1	1	1	1	1	8
OG0015580	8	0	0	0	0	0	0	8
OG0015581	2	1	1	1	1	1	1	8
OG0015582	3	2	1	0	0	1	1	8
OG0015583	2	2	1	1	1	1	0	8
OG0015584	2	1	1	1	1	1	1	8
OG0015585	1	2	1	1	1	1	1	8
OG0015586	2	1	1	1	1	1	1	8
OG0015587	2	1	1	1	1	1	1	8
OG0015588	2	2	1	1	1	0	1	8
OG0015589	2	2	1	1	0	1	1	8
OG0015590	1	4	0	1	0	2	0	8
OG0015591	1	2	1	1	1	1	1	8
OG0015592	2	0	1	1	1	2	1	8
OG0015593	1	2	1	1	1	1	1	8
OG0015594	2	1	1	1	1	1	1	8
OG0015595	2	1	1	1	1	1	1	8
OG0015596	1	2	1	1	1	1	1	8
OG0015597	1	2	1	1	1	1	1	8
OG0015598	1	2	1	1	1	1	1	8
OG0015599	1	2	1	1	1	1	1	8
OG0015600	1	2	1	1	1	1	1	8
OG0015601	2	1	1	1	1	1	1	8
OG0015602	1	3	1	1	1	0	1	8
OG0015603	2	1	1	1	1	1	1	8
OG0015604	1	2	1	1	1	1	1	8
OG0015605	1	3	1	1	0	1	1	8
OG0015606	2	1	1	1	1	1	1	8
OG0015607	2	1	1	1	1	1	1	8
OG0015608	1	3	1	1	1	0	1	8
OG0015609	2	1	1	1	1	1	1	8
OG0015610	1	2	1	1	1	1	1	8
OG0015611	1	1	1	1	1	1	2	8
OG0015612	2	1	1	1	1	1	1	8
OG0015613	2	1	1	1	1	1	1	8
OG0015614	1	2	1	1	1	1	1	8
OG0015615	2	1	1	1	1	1	1	8
OG0015616	2	2	1	1	0	0	2	8
OG0015617	1	2	1	1	1	1	1	8
OG0015618	2	3	0	0	1	1	1	8
OG0015619	2	1	1	1	1	1	1	8
OG0015620	1	2	1	1	1	1	1	8
OG0015621	3	1	0	1	1	0	2	8
OG0015622	2	2	1	1	1	1	0	8
OG0015623	2	2	1	1	1	1	0	8
OG0015624	2	1	1	1	1	1	1	8
OG0015625	1	3	1	0	1	1	1	8
OG0015626	1	2	1	1	1	1	1	8
OG0015627	1	1	1	1	1	1	2	8
OG0015628	2	1	1	1	1	1	1	8
OG0015629	2	1	1	1	1	1	1	8
OG0015630	1	2	1	1	1	1	1	8
OG0015631	2	1	1	1	1	1	1	8
OG0015632	1	2	1	1	1	1	1	8
OG0015633	1	3	1	0	1	1	1	8
OG0015634	1	2	1	1	1	1	1	8
OG0015635	2	2	1	1	0	1	1	8
OG0015636	1	2	1	1	1	1	1	8
OG0015637	1	2	1	1	1	1	1	8
OG0015638	2	2	0	1	1	1	1	8
OG0015639	1	2	1	1	1	1	1	8
OG0015640	2	1	1	1	1	1	1	8
OG0015641	2	1	1	1	1	1	1	8
OG0015642	1	2	1	1	1	1	1	8
OG0015643	1	3	1	1	1	1	0	8
OG0015644	1	3	1	1	1	0	1	8
OG0015645	2	3	1	1	0	0	1	8
OG0015646	1	3	1	1	0	1	1	8
OG0015647	1	3	1	1	0	1	1	8
OG0015648	2	1	1	1	1	1	1	8
OG0015649	1	4	2	0	0	0	1	8
OG0015650	2	1	1	1	1	1	1	8
OG0015651	1	2	1	1	1	1	1	8
OG0015652	1	3	1	1	0	1	1	8
OG0015653	1	3	0	1	1	1	1	8
OG0015654	2	1	1	1	1	1	1	8
OG0015655	2	1	1	1	1	1	1	8
OG0015656	1	2	1	1	1	1	1	8
OG0015657	1	3	0	1	1	1	1	8
OG0015658	1	2	1	1	1	1	1	8
OG0015659	2	2	1	1	1	1	0	8
OG0015660	2	2	1	0	0	0	3	8
OG0015661	3	1	1	0	1	1	1	8
OG0015662	3	0	2	0	0	0	3	8
OG0015663	2	1	1	1	1	1	1	8
OG0015664	2	2	1	1	1	1	0	8
OG0015665	1	2	1	1	1	1	1	8
OG0015666	1	2	1	1	1	1	1	8
OG0015667	1	2	1	1	1	1	1	8
OG0015668	2	2	0	1	1	1	1	8
OG0015669	1	4	1	1	0	0	1	8
OG0015670	2	1	1	1	1	1	1	8
OG0015671	1	2	1	1	1	1	1	8
OG0015672	1	2	1	1	1	1	1	8
OG0015673	1	2	1	1	1	1	1	8
OG0015674	1	2	1	1	1	1	1	8
OG0015675	1	4	0	1	0	1	1	8
OG0015676	1	2	1	1	1	1	1	8
OG0015677	2	1	1	1	1	1	1	8
OG0015678	2	2	1	1	1	0	1	8
OG0015679	2	1	1	1	1	1	1	8
OG0015680	2	1	1	1	1	1	1	8
OG0015681	1	1	1	2	1	1	1	8
OG0015682	1	2	1	1	1	1	1	8
OG0015683	1	2	1	1	1	1	1	8
OG0015684	2	3	1	1	0	0	1	8
OG0015685	2	1	1	1	1	1	1	8
OG0015686	1	3	1	1	0	1	1	8
OG0015687	1	2	1	1	1	1	1	8
OG0015688	1	2	1	1	1	1	1	8
OG0015689	2	3	1	0	0	1	1	8
OG0015690	2	2	1	1	1	0	1	8
OG0015691	1	3	0	0	2	1	1	8
OG0015692	1	3	1	1	0	1	1	8
OG0015693	2	4	1	0	0	0	1	8
OG0015694	2	2	1	1	1	0	1	8
OG0015695	2	2	1	1	1	0	1	8
OG0015696	1	2	1	1	1	1	1	8
OG0015697	2	1	1	1	1	0	2	8
OG0015698	2	1	1	1	1	1	1	8
OG0015699	1	2	1	1	1	1	1	8
OG0015700	1	2	1	1	1	1	1	8
OG0015701	1	2	1	1	1	1	1	8
OG0015702	1	2	1	1	1	1	1	8
OG0015703	2	1	1	1	1	1	1	8
OG0015704	2	1	1	1	1	1	1	8
OG0015705	1	2	1	1	1	1	1	8
OG0015706	1	2	1	1	1	1	1	8
OG0015707	2	2	1	2	0	0	1	8
OG0015708	2	1	1	1	1	1	1	8
OG0015709	1	2	1	1	1	1	1	8
OG0015710	2	2	1	0	1	0	2	8
OG0015711	2	2	1	1	1	0	1	8
OG0015712	2	1	1	1	1	1	1	8
OG0015713	1	2	1	1	1	1	1	8
OG0015714	1	2	1	1	1	1	1	8
OG0015715	1	3	1	1	0	1	1	8
OG0015716	2	1	1	1	1	1	1	8
OG0015717	2	1	1	1	1	1	1	8
OG0015718	1	3	1	1	1	1	0	8
OG0015719	2	2	1	1	1	0	1	8
OG0015720	1	2	1	1	1	1	1	8
OG0015721	2	1	1	1	1	1	1	8
OG0015722	3	2	1	0	1	0	1	8
OG0015723	1	2	1	1	1	1	1	8
OG0015724	1	3	1	1	1	1	0	8
OG0015725	1	1	2	1	1	1	1	8
OG0015726	2	1	1	1	1	0	2	8
OG0015727	2	1	1	1	1	1	1	8
OG0015728	1	2	1	1	1	1	1	8
OG0015729	1	2	1	1	1	1	1	8
OG0015730	1	2	1	1	1	1	1	8
OG0015731	2	1	1	1	1	1	1	8
OG0015732	1	2	1	1	1	1	1	8
OG0015733	2	3	1	0	0	1	1	8
OG0015734	2	1	1	1	1	1	1	8
OG0015735	1	2	1	1	1	1	1	8
OG0015736	1	3	1	1	1	0	1	8
OG0015737	1	2	1	1	1	1	1	8
OG0015738	1	2	1	1	1	1	1	8
OG0015739	1	2	1	1	1	1	1	8
OG0015740	1	5	0	0	0	1	1	8
OG0015741	2	1	1	1	1	1	1	8
OG0015742	8	0	0	0	0	0	0	8
OG0015743	2	1	1	1	1	1	1	8
OG0015744	1	2	1	1	1	1	1	8
OG0015745	2	2	1	1	1	0	1	8
OG0015746	2	2	1	1	0	1	1	8
OG0015747	1	3	1	1	1	0	1	8
OG0015748	2	1	1	1	1	1	1	8
OG0015749	2	3	1	1	0	1	0	8
OG0015750	2	1	1	1	1	1	1	8
OG0015751	1	2	1	1	1	1	1	8
OG0015752	1	3	1	1	1	0	1	8
OG0015753	2	3	1	1	0	0	1	8
OG0015754	2	3	1	1	1	0	0	8
OG0015755	1	3	1	1	0	1	1	8
OG0015756	1	2	1	1	1	1	1	8
OG0015757	1	2	1	1	1	1	1	8
OG0015758	6	1	0	0	0	0	1	8
OG0015759	1	2	1	1	1	1	1	8
OG0015760	1	2	1	1	1	1	1	8
OG0015761	2	2	1	0	1	1	1	8
OG0015762	2	1	1	1	1	1	1	8
OG0015763	2	1	1	1	1	1	1	8
OG0015764	1	2	1	1	1	1	1	8
OG0015765	2	1	1	1	1	1	1	8
OG0015766	1	2	1	1	1	1	1	8
OG0015767	2	2	1	1	1	0	1	8
OG0015768	2	1	1	1	1	1	1	8
OG0015769	2	2	0	1	1	1	1	8
OG0015770	1	3	1	1	0	1	1	8
OG0015771	1	2	1	1	1	1	1	8
OG0015772	2	3	1	1	1	0	0	8
OG0015773	2	2	1	1	1	0	1	8
OG0015774	1	2	1	1	1	1	1	8
OG0015775	2	1	1	1	1	1	1	8
OG0015776	1	2	1	1	1	1	1	8
OG0015777	2	2	1	0	1	1	1	8
OG0015778	1	2	1	1	1	1	1	8
OG0015779	2	2	1	1	1	0	1	8
OG0015780	2	2	1	1	0	1	1	8
OG0015781	1	3	2	0	0	1	1	8
OG0015782	1	2	1	1	1	1	1	8
OG0015783	2	1	1	1	1	1	1	8
OG0015784	1	2	1	1	1	1	1	8
OG0015785	2	1	1	1	1	1	1	8
OG0015786	1	3	1	1	1	0	1	8
OG0015787	1	1	2	1	1	1	1	8
OG0015788	1	3	1	0	1	1	1	8
OG0015789	2	2	1	1	1	0	1	8
OG0015790	1	2	1	1	1	1	1	8
OG0015791	2	1	1	1	1	1	1	8
OG0015792	2	3	1	1	0	0	1	8
OG0015793	1	3	1	1	1	0	1	8
OG0015794	2	2	1	1	1	1	0	8
OG0015795	2	1	1	1	1	1	1	8
OG0015796	2	1	1	1	1	1	1	8
OG0015797	2	3	1	1	1	0	0	8
OG0015798	2	1	1	1	1	1	1	8
OG0015799	1	2	1	1	1	1	1	8
OG0015800	2	2	1	1	1	1	0	8
OG0015801	1	2	1	1	1	1	1	8
OG0015802	1	3	1	1	0	1	1	8
OG0015803	1	2	1	1	1	1	1	8
OG0015804	1	2	1	1	1	1	1	8
OG0015805	2	2	1	1	1	0	1	8
OG0015806	1	4	2	0	0	0	1	8
OG0015807	1	2	1	1	1	1	1	8
OG0015808	1	2	1	1	1	1	1	8
OG0015809	2	4	1	0	0	0	1	8
OG0015810	2	1	1	1	1	1	1	8
OG0015811	1	2	1	1	1	1	1	8
OG0015812	1	2	1	1	1	1	1	8
OG0015813	1	5	0	1	1	0	0	8
OG0015814	1	2	1	1	1	1	1	8
OG0015815	2	2	1	1	1	1	0	8
OG0015816	2	1	1	1	1	1	1	8
OG0015817	1	2	1	1	1	1	1	8
OG0015818	1	2	1	1	1	1	1	8
OG0015819	2	1	1	1	1	1	1	8
OG0015820	1	2	1	1	1	1	1	8
OG0015821	2	1	1	1	1	1	1	8
OG0015822	1	2	1	1	1	1	1	8
OG0015823	1	2	1	1	1	1	1	8
OG0015824	1	2	1	1	2	0	1	8
OG0015825	1	2	1	1	1	1	1	8
OG0015826	2	3	1	1	0	0	1	8
OG0015827	2	1	1	1	1	1	1	8
OG0015828	1	2	1	1	1	1	1	8
OG0015829	1	2	1	1	1	1	1	8
OG0015830	1	3	0	1	1	1	1	8
OG0015831	2	1	1	1	1	1	1	8
OG0015832	2	2	1	1	1	1	0	8
OG0015833	1	2	1	1	1	1	1	8
OG0015834	1	2	1	1	1	1	1	8
OG0015835	2	1	1	1	1	1	1	8
OG0015836	2	4	1	0	0	0	1	8
OG0015837	1	2	1	1	1	1	1	8
OG0015838	2	2	1	0	1	1	1	8
OG0015839	1	2	1	1	1	1	1	8
OG0015840	1	2	1	1	1	1	1	8
OG0015841	1	2	1	1	1	1	1	8
OG0015842	2	2	1	0	1	1	1	8
OG0015843	1	3	1	1	1	1	0	8
OG0015844	1	2	1	1	1	1	1	8
OG0015845	1	3	1	1	0	1	1	8
OG0015846	1	7	0	0	0	0	0	8
OG0015847	1	2	1	1	1	1	1	8
OG0015848	2	1	1	1	1	1	1	8
OG0015849	1	2	1	1	1	1	1	8
OG0015850	1	2	1	1	1	1	1	8
OG0015851	1	3	1	1	1	1	0	8
OG0015852	1	2	1	1	1	1	1	8
OG0015853	1	2	1	1	1	1	1	8
OG0015854	1	2	1	1	1	1	1	8
OG0015855	1	2	1	1	1	1	1	8
OG0015856	2	2	1	1	1	1	0	8
OG0015857	1	2	1	1	1	1	1	8
OG0015858	1	2	1	1	1	1	1	8
OG0015859	1	3	1	1	1	1	0	8
OG0015860	3	1	1	0	1	1	1	8
OG0015861	1	2	1	1	1	1	1	8
OG0015862	1	3	1	1	1	0	1	8
OG0015863	1	2	1	1	1	1	1	8
OG0015864	1	3	1	1	1	1	0	8
OG0015865	1	2	1	1	1	1	1	8
OG0015866	1	2	1	1	1	1	1	8
OG0015867	2	1	1	1	1	1	1	8
OG0015868	2	3	1	0	1	1	0	8
OG0015869	1	2	1	1	1	1	1	8
OG0015870	2	1	1	1	1	1	1	8
OG0015871	3	0	1	1	1	1	1	8
OG0015872	2	3	1	1	0	0	1	8
OG0015873	1	2	1	1	1	1	1	8
OG0015874	2	3	1	1	0	0	1	8
OG0015875	1	3	1	1	1	0	1	8
OG0015876	2	1	1	1	1	1	1	8
OG0015877	2	2	1	1	1	1	0	8
OG0015878	1	5	1	0	0	0	1	8
OG0015879	1	2	1	1	1	1	1	8
OG0015880	1	2	1	1	1	1	1	8
OG0015881	1	4	2	0	1	0	0	8
OG0015882	2	2	1	1	1	1	0	8
OG0015883	1	2	1	1	1	1	1	8
OG0015884	1	1	1	1	1	1	2	8
OG0015885	1	2	1	1	1	1	1	8
OG0015886	2	2	1	0	1	1	1	8
OG0015887	3	2	2	0	0	1	0	8
OG0015888	1	2	1	1	1	1	1	8
OG0015889	2	1	0	0	1	2	2	8
OG0015890	1	7	0	0	0	0	0	8
OG0015891	1	2	1	1	1	1	1	8
OG0015892	2	1	1	0	1	1	2	8
OG0015893	1	2	1	1	1	1	1	8
OG0015894	2	1	1	1	1	1	1	8
OG0015895	2	1	1	1	1	1	1	8
OG0015896	1	5	1	0	0	0	1	8
OG0015897	2	2	1	1	1	1	0	8
OG0015898	1	3	1	2	0	0	1	8
OG0015899	1	3	1	1	1	0	1	8
OG0015900	1	2	1	1	1	1	1	8
OG0015901	2	1	1	1	1	1	1	8
OG0015902	2	1	1	1	1	1	1	8
OG0015903	1	2	1	1	1	1	1	8
OG0015904	2	2	1	1	0	1	1	8
OG0015905	1	2	1	1	1	1	1	8
OG0015906	2	1	1	1	1	1	1	8
OG0015907	1	1	1	1	2	1	1	8
OG0015908	1	2	1	1	1	1	1	8
OG0015909	2	1	1	1	1	1	1	8
OG0015910	2	1	1	1	1	1	1	8
OG0015911	1	2	1	0	1	2	1	8
OG0015912	1	2	1	1	1	1	1	8
OG0015913	1	3	1	1	1	0	1	8
OG0015914	1	2	1	1	1	1	1	8
OG0015915	2	1	1	1	1	1	1	8
OG0015916	2	2	1	1	1	0	1	8
OG0015917	2	1	1	1	1	1	1	8
OG0015918	1	2	1	1	1	1	1	8
OG0015919	1	2	1	1	1	1	1	8
OG0015920	1	2	1	1	1	1	1	8
OG0015921	1	3	1	0	1	1	1	8
OG0015922	1	2	1	1	1	1	1	8
OG0015923	2	4	0	1	0	0	1	8
OG0015924	1	2	1	1	1	1	1	8
OG0015925	1	3	1	0	1	1	1	8
OG0015926	2	1	1	1	1	1	1	8
OG0015927	1	2	1	1	1	1	1	8
OG0015928	1	1	2	1	1	1	1	8
OG0015929	1	2	1	1	1	1	1	8
OG0015930	2	1	1	1	1	1	1	8
OG0015931	1	3	1	1	1	1	0	8
OG0015932	2	2	1	1	1	1	0	8
OG0015933	1	2	1	1	1	1	1	8
OG0015934	2	2	0	1	1	1	1	8
OG0015935	1	2	1	1	1	1	1	8
OG0015936	2	1	1	2	0	1	1	8
OG0015937	1	1	1	2	1	1	1	8
OG0015938	1	4	1	1	1	0	0	8
OG0015939	1	3	1	0	1	1	1	8
OG0015940	1	2	1	1	1	1	1	8
OG0015941	1	2	1	1	1	1	1	8
OG0015942	2	3	1	0	0	1	1	8
OG0015943	1	3	1	1	1	0	1	8
OG0015944	1	4	0	1	1	1	0	8
OG0015945	2	1	1	1	1	1	1	8
OG0015946	2	3	1	0	1	0	1	8
OG0015947	2	1	1	1	1	1	1	8
OG0015948	1	1	1	1	1	1	2	8
OG0015949	2	3	1	1	0	0	1	8
OG0015950	1	2	1	1	1	1	1	8
OG0015951	2	1	1	1	1	1	1	8
OG0015952	2	1	1	1	1	1	1	8
OG0015953	1	2	1	1	1	1	1	8
OG0015954	2	2	1	0	1	1	1	8
OG0015955	1	2	1	1	1	1	1	8
OG0015956	1	2	1	1	1	1	1	8
OG0015957	2	1	1	1	1	1	1	8
OG0015958	1	2	1	1	1	1	1	8
OG0015959	1	4	1	1	1	0	0	8
OG0015960	1	2	1	1	1	1	1	8
OG0015961	3	4	1	0	0	0	0	8
OG0015962	1	2	1	1	1	1	1	8
OG0015963	2	2	1	1	1	0	1	8
OG0015964	1	2	1	1	1	1	1	8
OG0015965	1	1	1	1	1	2	1	8
OG0015966	1	2	1	1	1	1	1	8
OG0015967	2	2	1	1	1	0	1	8
OG0015968	2	4	1	0	0	0	1	8
OG0015969	1	2	1	1	1	1	1	8
OG0015970	1	4	1	1	1	0	0	8
OG0015971	2	1	1	1	1	1	1	8
OG0015972	1	3	1	1	1	0	1	8
OG0015973	2	2	1	1	1	1	0	8
OG0015974	2	0	1	0	0	0	5	8
OG0015975	1	2	1	1	1	1	1	8
OG0015976	2	2	1	0	1	1	1	8
OG0015977	1	2	1	1	1	1	1	8
OG0015978	1	2	1	1	1	1	1	8
OG0015979	1	3	1	1	0	1	1	8
OG0015980	1	2	1	1	1	1	1	8
OG0015981	1	3	1	1	1	0	1	8
OG0015982	1	2	1	1	1	1	1	8
OG0015983	1	3	1	1	1	0	1	8
OG0015984	1	2	1	1	1	1	1	8
OG0015985	1	2	1	1	1	1	1	8
OG0015986	2	3	1	1	0	0	1	8
OG0015987	1	1	1	1	1	1	2	8
OG0015988	1	2	1	1	1	1	1	8
OG0015989	1	2	1	1	1	1	1	8
OG0015990	1	2	1	1	1	1	1	8
OG0015991	1	4	1	1	0	0	1	8
OG0015992	1	2	1	1	1	1	1	8
OG0015993	1	2	1	1	1	1	1	8
OG0015994	1	2	1	1	1	1	1	8
OG0015995	1	1	1	2	1	1	1	8
OG0015996	1	2	1	1	1	1	1	8
OG0015997	2	1	1	1	1	1	1	8
OG0015998	2	2	1	1	1	1	0	8
OG0015999	2	2	1	1	1	1	0	8
OG0016000	2	0	2	1	1	1	1	8
OG0016001	1	2	1	1	1	1	1	8
OG0016002	1	2	1	1	1	1	1	8
OG0016003	2	1	1	1	1	1	1	8
OG0016004	1	2	1	1	1	1	1	8
OG0016005	2	1	1	1	1	1	1	8
OG0016006	2	2	1	0	1	1	1	8
OG0016007	1	2	1	1	1	1	1	8
OG0016008	2	1	1	1	1	1	1	8
OG0016009	1	2	1	1	1	1	1	8
OG0016010	1	2	1	1	1	1	1	8
OG0016011	2	2	1	1	1	0	1	8
OG0016012	1	3	1	0	1	1	1	8
OG0016013	1	3	1	0	1	1	1	8
OG0016014	2	1	1	1	1	1	1	8
OG0016015	1	2	1	1	1	1	1	8
OG0016016	2	1	1	1	1	1	1	8
OG0016017	1	3	1	0	1	1	1	8
OG0016018	2	0	1	2	1	1	1	8
OG0016019	1	2	1	1	1	1	1	8
OG0016020	1	1	1	1	1	1	2	8
OG0016021	1	2	1	1	1	1	1	8
OG0016022	2	2	1	1	1	0	1	8
OG0016023	1	1	1	1	1	2	1	8
OG0016024	1	3	1	1	0	1	1	8
OG0016025	1	2	1	1	1	1	1	8
OG0016026	2	2	1	1	1	1	0	8
OG0016027	1	2	1	1	1	1	1	8
OG0016028	2	3	1	0	0	1	1	8
OG0016029	1	2	1	1	1	1	1	8
OG0016030	1	4	1	0	0	1	1	8
OG0016031	2	2	1	1	0	1	1	8
OG0016032	2	1	1	1	1	1	1	8
OG0016033	1	2	1	1	1	1	1	8
OG0016034	1	3	1	1	0	1	1	8
OG0016035	1	2	1	1	1	1	1	8
OG0016036	2	4	1	0	0	0	1	8
OG0016037	1	2	1	1	1	1	1	8
OG0016038	1	2	1	1	1	1	1	8
OG0016039	1	2	1	1	1	1	1	8
OG0016040	1	2	1	1	1	1	1	8
OG0016041	1	5	1	0	0	0	1	8
OG0016042	1	3	1	1	1	1	0	8
OG0016043	1	2	1	1	1	1	1	8
OG0016044	1	2	1	1	1	1	1	8
OG0016045	2	1	1	1	1	1	1	8
OG0016046	2	1	1	1	1	1	1	8
OG0016047	1	3	1	1	1	1	0	8
OG0016048	2	4	1	1	0	0	0	8
OG0016049	1	2	1	1	1	1	1	8
OG0016050	1	3	1	1	0	1	1	8
OG0016051	1	2	1	1	1	1	1	8
OG0016052	2	1	1	1	1	1	1	8
OG0016053	2	1	1	1	1	1	1	8
OG0016054	1	3	1	1	1	0	1	8
OG0016055	1	2	1	1	1	1	1	8
OG0016056	2	2	0	1	1	1	1	8
OG0016057	3	2	1	1	0	0	1	8
OG0016058	2	1	1	1	1	1	1	8
OG0016059	1	2	1	1	1	1	1	8
OG0016060	1	3	1	1	1	1	0	8
OG0016061	1	2	1	1	1	1	1	8
OG0016062	1	2	1	1	1	1	1	8
OG0016063	1	2	1	1	1	1	1	8
OG0016064	1	3	1	1	1	1	0	8
OG0016065	1	2	1	1	1	1	1	8
OG0016066	1	2	1	2	1	1	0	8
OG0016067	1	3	1	1	1	1	0	8
OG0016068	2	3	1	0	1	1	0	8
OG0016069	2	1	1	1	1	1	1	8
OG0016070	1	2	1	1	1	1	1	8
OG0016071	2	2	1	1	0	1	1	8
OG0016072	1	2	1	1	1	1	1	8
OG0016073	1	3	1	1	1	1	0	8
OG0016074	1	2	1	1	1	1	1	8
OG0016075	1	3	0	1	1	1	1	8
OG0016076	1	2	1	1	1	1	1	8
OG0016077	2	4	0	0	0	1	1	8
OG0016078	1	2	1	1	1	1	1	8
OG0016079	1	2	1	1	1	1	1	8
OG0016080	2	1	1	1	1	1	1	8
OG0016081	1	2	1	1	1	1	1	8
OG0016082	1	2	1	1	1	1	1	8
OG0016083	2	3	1	0	0	1	1	8
OG0016084	1	3	1	1	1	0	1	8
OG0016085	1	2	1	1	1	1	1	8
OG0016086	1	2	1	1	1	1	1	8
OG0016087	1	2	1	1	1	1	1	8
OG0016088	1	3	1	0	0	0	3	8
OG0016089	1	2	1	1	1	1	1	8
OG0016090	1	2	1	1	1	1	1	8
OG0016091	1	2	1	1	1	1	1	8
OG0016092	1	2	1	1	1	1	1	8
OG0016093	2	3	1	1	0	1	0	8
OG0016094	1	2	2	1	1	1	0	8
OG0016095	1	3	1	0	1	1	1	8
OG0016096	2	2	1	1	1	1	0	8
OG0016097	1	3	1	1	1	1	0	8
OG0016098	1	2	1	1	1	1	1	8
OG0016099	1	2	1	1	1	1	1	8
OG0016100	1	2	1	1	1	1	1	8
OG0016101	1	3	1	1	1	1	0	8
OG0016102	1	2	1	1	1	1	1	8
OG0016103	1	2	1	1	1	1	1	8
OG0016104	1	3	1	1	1	0	1	8
OG0016105	2	2	1	1	1	0	1	8
OG0016106	1	2	1	1	1	1	1	8
OG0016107	1	2	1	1	1	1	1	8
OG0016108	1	2	1	1	2	0	1	8
OG0016109	1	2	1	1	1	1	1	8
OG0016110	1	2	1	1	1	1	1	8
OG0016111	1	2	1	1	1	1	1	8
OG0016112	1	2	1	1	1	1	1	8
OG0016113	1	3	1	1	1	0	1	8
OG0016114	1	2	1	1	1	1	1	8
OG0016115	2	1	1	1	1	1	1	8
OG0016116	2	1	1	1	1	1	1	8
OG0016117	2	2	1	0	1	1	1	8
OG0016118	2	2	1	1	0	1	1	8
OG0016119	1	3	1	1	1	0	1	8
OG0016120	1	2	1	1	1	1	1	8
OG0016121	2	2	1	1	1	0	1	8
OG0016122	1	2	1	1	1	0	2	8
OG0016123	1	2	1	1	1	1	1	8
OG0016124	1	2	1	1	1	1	1	8
OG0016125	2	1	1	1	1	1	1	8
OG0016126	2	1	1	1	1	1	1	8
OG0016127	1	6	0	1	0	0	0	8
OG0016128	2	2	1	0	1	1	1	8
OG0016129	1	2	1	1	1	1	1	8
OG0016130	2	1	1	1	1	1	1	8
OG0016131	2	1	1	1	1	1	1	8
OG0016132	1	2	1	1	1	1	1	8
OG0016133	1	2	1	1	1	1	1	8
OG0016134	1	2	1	1	1	1	1	8
OG0016135	1	4	1	0	0	1	1	8
OG0016136	1	3	1	1	1	0	1	8
OG0016137	1	2	1	1	1	1	1	8
OG0016138	2	1	1	1	1	1	1	8
OG0016139	2	2	1	1	1	0	1	8
OG0016140	2	3	1	1	0	0	1	8
OG0016141	1	2	1	1	1	1	1	8
OG0016142	1	2	1	1	1	1	1	8
OG0016143	1	1	1	1	0	2	2	8
OG0016144	1	2	1	1	1	1	1	8
OG0016145	1	2	1	1	1	1	1	8
OG0016146	2	1	1	1	1	1	1	8
OG0016147	1	2	1	1	1	1	1	8
OG0016148	1	2	1	1	1	1	1	8
OG0016149	2	1	1	1	1	1	1	8
OG0016150	2	0	0	1	2	3	0	8
OG0016151	1	2	1	1	1	1	1	8
OG0016152	1	2	1	1	1	1	1	8
OG0016153	2	1	1	1	1	1	1	8
OG0016154	2	1	1	1	1	1	1	8
OG0016155	1	1	1	1	1	1	2	8
OG0016156	1	2	1	1	1	1	1	8
OG0016157	1	1	1	1	1	1	2	8
OG0016158	2	2	1	1	1	1	0	8
OG0016159	1	2	1	1	1	1	1	8
OG0016160	1	2	1	1	1	1	1	8
OG0016161	1	2	1	1	1	1	1	8
OG0016162	1	0	1	1	1	2	2	8
OG0016163	1	2	1	1	1	0	2	8
OG0016164	2	1	1	1	1	1	1	8
OG0016165	2	1	1	1	1	1	1	8
OG0016166	1	2	1	1	1	1	1	8
OG0016167	1	3	1	1	1	1	0	8
OG0016168	1	2	1	1	1	1	1	8
OG0016169	2	1	1	1	1	1	1	8
OG0016170	1	3	1	1	1	0	1	8
OG0016171	2	2	1	1	1	0	1	8
OG0016172	2	3	1	0	1	0	1	8
OG0016173	1	2	1	1	1	1	1	8
OG0016174	2	1	1	1	1	1	1	8
OG0016175	1	2	1	2	1	1	0	8
OG0016176	2	1	1	1	1	1	1	8
OG0016177	1	3	1	1	0	1	1	8
OG0016178	1	3	1	1	1	1	0	8
OG0016179	2	1	1	1	1	1	1	8
OG0016180	1	2	1	1	1	1	1	8
OG0016181	1	2	1	1	1	1	1	8
OG0016182	1	3	1	1	0	1	1	8
OG0016183	1	3	1	0	1	1	1	8
OG0016184	1	1	1	1	1	1	2	8
OG0016185	1	2	1	1	1	1	1	8
OG0016186	1	2	1	1	1	1	1	8
OG0016187	1	2	1	1	1	1	1	8
OG0016188	1	2	1	1	1	1	1	8
OG0016189	2	2	1	0	1	1	1	8
OG0016190	1	3	1	1	1	1	0	8
OG0016191	2	3	1	0	1	1	0	8
OG0016192	2	2	1	1	1	0	1	8
OG0016193	2	3	1	1	0	1	0	8
OG0016194	1	2	1	1	1	1	1	8
OG0016195	2	1	1	1	1	1	1	8
OG0016196	1	2	1	1	1	1	1	8
OG0016197	1	4	1	0	0	0	2	8
OG0016198	1	4	1	1	1	0	0	8
OG0016199	1	2	1	1	1	1	1	8
OG0016200	2	2	1	1	1	0	1	8
OG0016201	1	3	2	0	0	0	2	8
OG0016202	1	2	1	1	1	1	1	8
OG0016203	1	2	1	1	1	1	1	8
OG0016204	1	2	1	1	1	1	1	8
OG0016205	1	3	0	1	1	1	1	8
OG0016206	1	2	1	1	1	1	1	8
OG0016207	2	1	1	1	1	1	1	8
OG0016208	2	0	0	2	3	1	0	8
OG0016209	2	1	1	1	1	1	1	8
OG0016210	1	2	1	1	1	1	1	8
OG0016211	1	3	1	1	0	1	1	8
OG0016212	2	2	1	1	1	1	0	8
OG0016213	1	2	1	1	1	1	1	8
OG0016214	1	2	1	1	1	1	1	8
OG0016215	1	2	1	1	1	1	1	8
OG0016216	1	2	1	1	1	1	1	8
OG0016217	1	3	1	0	1	1	1	8
OG0016218	1	2	1	1	1	1	1	8
OG0016219	1	2	1	1	1	1	1	8
OG0016220	1	3	1	1	1	0	1	8
OG0016221	1	2	1	1	1	1	1	8
OG0016222	2	2	1	1	1	1	0	8
OG0016223	2	1	1	1	1	1	1	8
OG0016224	1	2	1	1	1	1	1	8
OG0016225	1	2	1	1	1	1	1	8
OG0016226	1	4	1	1	0	0	1	8
OG0016227	1	2	1	1	1	1	1	8
OG0016228	2	4	1	0	0	0	1	8
OG0016229	2	1	1	1	1	1	1	8
OG0016230	1	2	1	1	1	1	1	8
OG0016231	1	2	1	1	1	1	1	8
OG0016232	1	2	1	1	1	1	1	8
OG0016233	1	2	1	1	1	1	1	8
OG0016234	1	3	1	1	1	0	1	8
OG0016235	1	2	1	1	1	1	1	8
OG0016236	1	2	1	1	1	1	1	8
OG0016237	1	1	1	2	1	1	1	8
OG0016238	2	1	1	1	1	1	1	8
OG0016239	1	2	1	1	1	0	2	8
OG0016240	3	0	1	1	1	1	1	8
OG0016241	1	3	1	1	1	1	0	8
OG0016242	1	1	1	2	1	1	1	8
OG0016243	1	3	1	1	1	0	1	8
OG0016244	2	1	1	1	1	1	1	8
OG0016245	1	2	1	1	1	1	1	8
OG0016246	1	2	1	1	1	1	1	8
OG0016247	1	2	1	1	1	1	1	8
OG0016248	1	2	1	1	1	1	1	8
OG0016249	2	2	1	1	1	1	0	8
OG0016250	1	2	1	1	1	1	1	8
OG0016251	1	2	1	1	1	1	1	8
OG0016252	1	4	1	0	0	1	1	8
OG0016253	1	2	1	1	1	1	1	8
OG0016254	1	2	1	1	1	1	1	8
OG0016255	2	1	1	1	1	1	1	8
OG0016256	1	2	1	1	1	1	1	8
OG0016257	1	2	1	1	1	1	1	8
OG0016258	1	3	1	1	1	0	1	8
OG0016259	2	1	1	1	1	1	1	8
OG0016260	2	1	1	1	1	1	1	8
OG0016261	1	2	1	1	1	1	1	8
OG0016262	1	2	1	1	1	1	1	8
OG0016263	2	2	1	1	1	0	1	8
OG0016264	1	3	1	1	1	0	1	8
OG0016265	1	2	1	1	1	1	1	8
OG0016266	2	1	1	1	1	1	1	8
OG0016267	1	2	0	1	2	1	1	8
OG0016268	1	2	1	1	1	1	1	8
OG0016269	1	2	1	1	1	1	1	8
OG0016270	2	2	1	1	1	0	1	8
OG0016271	1	2	1	1	1	1	1	8
OG0016272	1	2	1	0	1	1	2	8
OG0016273	2	2	1	1	1	1	0	8
OG0016274	1	2	1	1	1	1	1	8
OG0016275	1	2	1	1	1	1	1	8
OG0016276	1	5	1	1	0	0	0	8
OG0016277	1	2	1	1	1	1	1	8
OG0016278	1	3	1	1	1	0	1	8
OG0016279	1	2	1	1	1	1	1	8
OG0016280	1	3	1	1	1	1	0	8
OG0016281	1	2	1	1	1	1	1	8
OG0016282	2	1	1	1	1	1	1	8
OG0016283	2	1	1	1	1	1	1	8
OG0016284	1	3	1	1	1	0	1	8
OG0016285	2	1	1	1	1	1	1	8
OG0016286	1	1	1	1	1	1	2	8
OG0016287	2	1	1	1	1	1	1	8
OG0016288	1	2	1	1	1	1	1	8
OG0016289	1	2	1	1	1	1	1	8
OG0016290	1	3	1	1	1	0	1	8
OG0016291	1	6	1	0	0	0	0	8
OG0016292	1	1	1	1	1	1	2	8
OG0016293	1	4	1	0	1	0	1	8
OG0016294	1	2	1	1	1	1	1	8
OG0016295	2	3	1	0	0	1	1	8
OG0016296	1	2	1	1	1	1	1	8
OG0016297	1	3	1	1	1	1	0	8
OG0016298	1	3	1	1	1	1	0	8
OG0016299	1	2	1	1	1	1	1	8
OG0016300	2	2	1	1	0	1	1	8
OG0016301	1	3	1	1	0	1	1	8
OG0016302	1	2	1	1	1	1	1	8
OG0016303	2	1	1	1	1	1	1	8
OG0016304	1	2	1	1	1	1	1	8
OG0016305	1	2	1	1	1	1	1	8
OG0016306	1	5	0	2	0	0	0	8
OG0016307	2	2	1	1	1	1	0	8
OG0016308	1	4	1	1	0	0	1	8
OG0016309	1	3	1	1	0	1	1	8
OG0016310	1	2	1	1	1	1	1	8
OG0016311	1	2	1	1	1	1	1	8
OG0016312	2	2	1	1	0	1	1	8
OG0016313	1	2	1	1	1	1	1	8
OG0016314	1	2	1	1	1	1	1	8
OG0016315	1	3	1	1	1	0	1	8
OG0016316	1	2	1	1	1	1	1	8
OG0016317	2	1	1	1	1	1	1	8
OG0016318	1	2	1	1	1	1	1	8
OG0016319	1	3	1	1	1	1	0	8
OG0016320	1	2	1	1	1	1	1	8
OG0016321	2	2	1	1	1	0	1	8
OG0016322	2	1	1	1	1	1	1	8
OG0016323	1	2	1	1	1	1	1	8
OG0016324	1	2	1	1	1	1	1	8
OG0016325	1	2	1	1	1	1	1	8
OG0016326	1	3	1	0	1	1	1	8
OG0016327	2	1	1	1	1	1	1	8
OG0016328	1	1	2	1	1	1	1	8
OG0016329	1	4	1	1	0	0	1	8
OG0016330	1	4	1	0	0	1	1	8
OG0016331	2	2	1	1	1	0	1	8
OG0016332	1	2	1	1	1	2	0	8
OG0016333	1	3	1	0	1	1	1	8
OG0016334	1	1	1	1	2	1	1	8
OG0016335	1	2	1	1	1	1	1	8
OG0016336	1	2	1	1	1	1	1	8
OG0016337	1	4	1	1	0	0	1	8
OG0016338	1	4	1	0	0	1	1	8
OG0016339	1	2	1	1	1	1	1	8
OG0016340	1	3	1	1	0	1	1	8
OG0016341	1	2	1	1	1	1	1	8
OG0016342	2	1	1	1	1	1	1	8
OG0016343	1	2	1	1	1	1	1	8
OG0016344	1	2	1	1	1	1	1	8
OG0016345	1	2	1	1	1	1	1	8
OG0016346	1	2	1	1	1	1	1	8
OG0016347	1	2	1	1	1	1	1	8
OG0016348	1	2	1	1	1	1	1	8
OG0016349	2	2	1	1	0	0	2	8
OG0016350	1	2	1	1	1	1	1	8
OG0016351	1	2	1	1	1	1	1	8
OG0016352	1	2	1	1	1	1	1	8
OG0016353	1	3	1	1	1	0	1	8
OG0016354	1	2	1	1	1	1	1	8
OG0016355	1	2	1	1	1	1	1	8
OG0016356	1	2	1	1	1	1	1	8
OG0016357	1	3	1	1	1	1	0	8
OG0016358	1	2	1	1	1	1	1	8
OG0016359	1	2	1	1	1	1	1	8
OG0016360	1	2	1	1	1	1	1	8
OG0016361	1	1	1	1	1	2	1	8
OG0016362	1	3	1	1	1	1	0	8
OG0016363	2	1	1	1	1	1	1	8
OG0016364	1	3	1	1	1	0	1	8
OG0016365	1	2	1	1	1	1	1	8
OG0016366	1	2	1	1	1	1	1	8
OG0016367	1	2	1	1	1	1	1	8
OG0016368	1	3	1	1	1	1	0	8
OG0016369	1	2	1	1	1	1	1	8
OG0016370	1	2	1	1	1	1	1	8
OG0016371	1	2	1	1	1	1	1	8
OG0016372	1	3	1	1	1	0	1	8
OG0016373	1	2	1	1	1	1	1	8
OG0016374	1	2	1	1	1	1	1	8
OG0016375	1	2	1	1	1	1	1	8
OG0016376	1	2	1	1	1	1	1	8
OG0016377	1	3	1	1	1	1	0	8
OG0016378	1	3	1	1	1	0	1	8
OG0016379	1	2	1	1	1	1	1	8
OG0016380	1	2	1	1	1	1	1	8
OG0016381	2	1	1	1	1	1	1	8
OG0016382	1	2	1	1	1	1	1	8
OG0016383	1	2	1	1	1	1	1	8
OG0016384	1	3	1	0	1	1	1	8
OG0016385	1	3	1	1	0	1	1	8
OG0016386	1	1	1	1	1	1	2	8
OG0016387	1	2	1	1	1	1	1	8
OG0016388	1	2	1	1	1	1	1	8
OG0016389	1	2	1	1	1	1	1	8
OG0016390	1	4	1	0	0	1	1	8
OG0016391	1	2	1	1	1	1	1	8
OG0016392	1	2	1	1	1	1	1	8
OG0016393	1	2	1	1	1	1	1	8
OG0016394	1	2	1	1	1	1	1	8
OG0016395	1	3	1	0	1	1	1	8
OG0016396	1	2	1	1	1	1	1	8
OG0016397	1	2	1	1	1	1	1	8
OG0016398	1	2	1	1	1	1	1	8
OG0016399	1	4	1	1	0	0	1	8
OG0016400	2	3	1	1	0	0	1	8
OG0016401	1	3	1	1	1	1	0	8
OG0016402	1	3	1	1	1	1	0	8
OG0016403	1	2	1	1	1	1	1	8
OG0016404	1	2	1	1	1	1	1	8
OG0016405	1	2	1	1	1	1	1	8
OG0016406	1	2	1	1	1	1	1	8
OG0016407	1	2	1	1	1	1	1	8
OG0016408	1	2	1	1	1	1	1	8
OG0016409	1	2	1	1	1	1	1	8
OG0016410	1	2	1	1	1	1	1	8
OG0016411	1	3	1	1	0	1	1	8
OG0016412	1	2	1	1	1	1	1	8
OG0016413	1	3	1	1	0	1	1	8
OG0016414	1	4	0	1	1	1	0	8
OG0016415	1	2	1	1	1	1	1	8
OG0016416	2	1	1	1	1	1	1	8
OG0016417	1	2	1	1	1	1	1	8
OG0016418	1	3	0	1	1	2	0	8
OG0016419	1	2	1	1	1	1	1	8
OG0016420	1	3	1	0	1	1	1	8
OG0016421	1	2	1	1	1	1	1	8
OG0016422	2	1	1	1	1	1	1	8
OG0016423	1	2	1	1	1	1	1	8
OG0016424	1	2	1	1	1	1	1	8
OG0016425	1	3	1	1	0	1	1	8
OG0016426	1	3	1	1	1	0	1	8
OG0016427	1	2	1	2	1	0	1	8
OG0016428	1	2	1	1	1	1	1	8
OG0016429	2	2	1	1	0	1	1	8
OG0016430	1	2	1	1	1	1	1	8
OG0016431	1	3	1	1	1	1	0	8
OG0016432	1	2	1	1	1	1	1	8
OG0016433	1	2	1	1	1	1	1	8
OG0016434	1	2	1	1	1	1	1	8
OG0016435	1	2	1	1	1	1	1	8
OG0016436	1	3	1	1	1	1	0	8
OG0016437	1	2	1	1	1	1	1	8
OG0016438	1	2	1	1	1	1	1	8
OG0016439	1	2	1	1	1	1	1	8
OG0016440	2	3	1	1	0	0	1	8
OG0016441	1	2	1	1	1	1	1	8
OG0016442	1	2	1	1	1	1	1	8
OG0016443	1	4	1	1	0	0	1	8
OG0016444	1	2	1	1	1	1	1	8
OG0016445	1	2	1	1	1	1	1	8
OG0016446	1	2	1	1	1	1	1	8
OG0016447	1	3	1	1	1	1	0	8
OG0016448	1	2	1	1	1	1	1	8
OG0016449	1	3	1	1	1	1	0	8
OG0016450	1	2	1	1	1	1	1	8
OG0016451	1	6	0	0	1	0	0	8
OG0016452	1	2	1	1	1	1	1	8
OG0016453	1	3	1	0	1	1	1	8
OG0016454	1	2	1	1	1	1	1	8
OG0016455	1	3	1	1	1	0	1	8
OG0016456	1	2	1	1	1	1	1	8
OG0016457	1	3	1	1	1	1	0	8
OG0016458	1	2	1	1	1	1	1	8
OG0016459	1	2	1	1	1	1	1	8
OG0016460	1	2	1	1	1	1	1	8
OG0016461	1	2	1	1	1	1	1	8
OG0016462	1	2	1	1	1	1	1	8
OG0016463	1	2	1	1	1	1	1	8
OG0016464	1	3	1	1	1	0	1	8
OG0016465	1	2	1	1	1	1	1	8
OG0016466	1	5	1	0	0	0	1	8
OG0016467	1	3	1	1	1	0	1	8
OG0016468	1	2	1	1	1	1	1	8
OG0016469	1	2	1	1	1	1	1	8
OG0016470	1	5	1	0	0	0	1	8
OG0016471	1	2	1	1	1	1	1	8
OG0016472	1	2	1	1	1	1	1	8
OG0016473	1	2	1	1	1	1	1	8
OG0016474	1	3	1	1	1	1	0	8
OG0016475	1	3	1	0	1	1	1	8
OG0016476	1	2	1	1	1	1	1	8
OG0016477	1	2	1	1	1	1	1	8
OG0016478	1	2	1	1	1	1	1	8
OG0016479	1	2	1	1	1	1	1	8
OG0016480	1	2	1	1	1	1	1	8
OG0016481	1	2	1	1	1	1	1	8
OG0016482	1	3	1	1	1	1	0	8
OG0016483	1	3	1	0	1	1	1	8
OG0016484	1	1	2	1	1	1	1	8
OG0016485	1	2	1	1	1	1	1	8
OG0016486	1	2	1	1	1	1	1	8
OG0016487	1	3	1	1	1	1	0	8
OG0016488	1	2	2	0	1	1	1	8
OG0016489	1	3	0	1	1	1	1	8
OG0016490	1	2	1	1	1	1	1	8
OG0016491	1	3	1	1	1	1	0	8
OG0016492	1	2	1	1	1	1	1	8
OG0016493	1	2	1	1	1	1	1	8
OG0016494	1	2	1	1	1	1	1	8
OG0016495	1	2	1	1	1	1	1	8
OG0016496	1	2	1	1	1	1	1	8
OG0016497	1	2	1	1	1	1	1	8
OG0016498	1	2	1	1	1	1	1	8
OG0016499	0	3	1	1	1	1	1	8
OG0016500	0	4	1	1	1	1	0	8
OG0016501	0	3	1	1	1	1	1	8
OG0016502	0	3	1	1	1	1	1	8
OG0016503	0	3	1	1	1	1	1	8
OG0016504	0	3	4	0	0	0	1	8
OG0016505	0	2	0	1	1	2	2	8
OG0016506	0	5	1	0	0	0	2	8
OG0016507	0	5	2	0	0	0	1	8
OG0016508	0	5	0	1	0	0	2	8
OG0016509	0	4	1	1	1	0	1	8
OG0016510	0	3	1	1	1	1	1	8
OG0016511	0	4	1	1	0	1	1	8
OG0016512	0	5	0	1	0	1	1	8
OG0016513	0	3	1	1	1	1	1	8
OG0016514	0	4	0	1	0	1	2	8
OG0016515	0	8	0	0	0	0	0	8
OG0016516	0	4	1	0	1	1	1	8
OG0016517	0	5	1	1	0	0	1	8
OG0016518	0	8	0	0	0	0	0	8
OG0016519	0	4	1	1	0	0	2	8
OG0016520	0	2	1	1	1	1	2	8
OG0016521	0	3	1	1	1	1	1	8
OG0016522	0	8	0	0	0	0	0	8
OG0016523	0	6	0	1	0	1	0	8
OG0016524	0	5	0	1	0	1	1	8
OG0016525	0	6	0	0	0	0	2	8
OG0016526	0	3	1	1	1	1	1	8
OG0016527	0	3	1	1	1	1	1	8
OG0016528	0	3	1	1	1	1	1	8
OG0016529	0	2	1	2	1	1	1	8
OG0016530	0	7	0	0	0	0	1	8
OG0016531	0	5	1	0	0	0	2	8
OG0016532	0	4	1	1	1	1	0	8
OG0016533	0	4	0	1	1	0	2	8
OG0016534	0	7	1	0	0	0	0	8
OG0016535	0	4	1	0	0	2	1	8
OG0016536	0	5	1	0	0	1	1	8
OG0016537	0	5	0	1	1	0	1	8
OG0016538	0	4	0	1	2	0	1	8
OG0016539	0	6	0	0	0	1	1	8
OG0016540	0	3	1	1	1	1	1	8
OG0016541	0	6	0	0	1	0	1	8
OG0016542	0	7	0	0	0	1	0	8
OG0016543	0	8	0	0	0	0	0	8
OG0016544	0	7	0	0	0	0	1	8
OG0016545	0	3	0	1	2	1	1	8
OG0016546	0	3	1	1	1	1	1	8
OG0016547	0	5	0	1	1	1	0	8
OG0016548	0	4	2	0	0	1	1	8
OG0016549	0	4	1	1	0	1	1	8
OG0016550	0	3	1	1	1	1	1	8
OG0016551	0	3	1	1	1	1	1	8
OG0016552	0	6	0	0	1	0	1	8
OG0016553	0	3	1	1	1	1	1	8
OG0016554	0	4	1	1	1	1	0	8
OG0016555	0	4	1	1	1	1	0	8
OG0016556	0	3	1	1	1	1	1	8
OG0016557	0	3	1	1	1	1	1	8
OG0016558	0	3	1	1	1	1	1	8
OG0016559	0	3	1	1	1	1	1	8
OG0016560	0	5	0	1	1	1	0	8
OG0016561	0	3	1	1	1	1	1	8
OG0016562	0	2	2	1	1	1	1	8
OG0016563	0	2	1	1	1	1	2	8
OG0016564	0	2	1	1	1	1	2	8
OG0016565	0	4	2	0	1	0	1	8
OG0016566	0	3	1	1	1	1	1	8
OG0016567	0	3	1	1	1	1	1	8
OG0016568	0	3	2	0	1	1	1	8
OG0016569	0	5	1	0	0	1	1	8
OG0016570	0	8	0	0	0	0	0	8
OG0016571	0	3	1	1	1	1	1	8
OG0016572	0	2	0	1	1	2	2	8
OG0016573	0	4	1	1	1	1	0	8
OG0016574	0	4	1	1	1	1	0	8
OG0016575	0	3	1	1	1	1	1	8
OG0016576	0	8	0	0	0	0	0	8
OG0016577	0	8	0	0	0	0	0	8
OG0016578	0	3	1	1	1	1	1	8
OG0016579	0	3	1	1	1	1	1	8
OG0016580	0	3	1	1	1	1	1	8
OG0016581	0	3	0	0	2	1	2	8
OG0016582	0	3	1	1	1	1	1	8
OG0016583	0	8	0	0	0	0	0	8
OG0016584	0	3	1	1	3	0	0	8
OG0016585	0	3	1	1	1	1	1	8
OG0016586	0	3	1	1	1	1	1	8
OG0016587	0	6	0	0	0	0	2	8
OG0016588	0	8	0	0	0	0	0	8
OG0016589	0	3	1	1	1	1	1	8
OG0016590	0	6	1	0	0	1	0	8
OG0016591	0	3	1	1	1	1	1	8
OG0016592	0	4	0	1	1	1	1	8
OG0016593	0	4	1	0	1	1	1	8
OG0016594	0	3	1	1	1	1	1	8
OG0016595	0	3	1	1	1	1	1	8
OG0016596	0	3	1	1	1	1	1	8
OG0016597	0	2	4	0	1	0	1	8
OG0016598	0	6	0	0	0	1	1	8
OG0016599	0	7	0	0	0	0	1	8
OG0016600	0	4	1	1	1	0	1	8
OG0016601	0	8	0	0	0	0	0	8
OG0016602	0	3	1	1	1	1	1	8
OG0016603	0	8	0	0	0	0	0	8
OG0016604	0	4	1	1	1	1	0	8
OG0016605	0	3	1	1	1	1	1	8
OG0016606	0	5	1	1	0	1	0	8
OG0016607	0	3	1	1	1	1	1	8
OG0016608	0	8	0	0	0	0	0	8
OG0016609	0	4	0	1	1	1	1	8
OG0016610	0	4	1	1	1	1	0	8
OG0016611	0	4	1	1	0	1	1	8
OG0016612	0	3	1	1	1	1	1	8
OG0016613	0	3	1	1	1	1	1	8
OG0016614	0	3	1	1	1	1	1	8
OG0016615	0	3	1	1	1	1	1	8
OG0016616	0	2	1	0	1	3	1	8
OG0016617	0	4	1	0	1	1	1	8
OG0016618	0	3	1	1	1	1	1	8
OG0016619	0	4	1	1	1	0	1	8
OG0016620	0	3	1	1	1	1	1	8
OG0016621	0	4	1	1	1	0	1	8
OG0016622	0	8	0	0	0	0	0	8
OG0016623	0	4	0	1	0	2	1	8
OG0016624	0	5	0	1	1	1	0	8
OG0016625	0	4	1	1	0	1	1	8
OG0016626	0	5	1	0	0	1	1	8
OG0016627	0	5	1	0	0	1	1	8
OG0016628	0	3	1	1	1	1	1	8
OG0016629	0	8	0	0	0	0	0	8
OG0016630	0	5	1	1	1	0	0	8
OG0016631	0	6	0	1	0	0	1	8
OG0016632	0	4	1	0	1	2	0	8
OG0016633	0	4	1	0	0	2	1	8
OG0016634	0	3	1	1	1	1	1	8
OG0016635	0	5	0	0	1	1	1	8
OG0016636	0	5	1	0	1	1	0	8
OG0016637	0	4	1	0	1	1	1	8
OG0016638	0	3	1	1	1	1	1	8
OG0016639	0	3	1	1	1	1	1	8
OG0016640	0	4	1	1	1	1	0	8
OG0016641	0	2	0	0	0	0	6	8
OG0016642	0	5	1	0	1	0	1	8
OG0016643	0	3	1	1	1	1	1	8
OG0016644	0	3	1	1	1	1	1	8
OG0016645	0	8	0	0	0	0	0	8
OG0016646	0	7	0	0	0	0	1	8
OG0016647	0	4	0	0	4	0	0	8
OG0016648	0	3	1	1	1	1	1	8
OG0016649	0	8	0	0	0	0	0	8
OG0016650	0	3	1	1	1	1	1	8
OG0016651	0	3	1	1	1	1	1	8
OG0016652	0	3	1	1	1	1	1	8
OG0016653	0	6	1	0	0	1	0	8
OG0016654	0	4	1	1	1	1	0	8
OG0016655	0	2	1	1	1	1	2	8
OG0016656	0	3	1	1	1	1	1	8
OG0016657	0	4	1	0	1	1	1	8
OG0016658	0	3	1	1	1	1	1	8
OG0016659	0	3	0	0	1	3	1	8
OG0016660	0	3	1	1	1	1	1	8
OG0016661	0	3	1	1	1	1	1	8
OG0016662	0	3	1	1	1	1	1	8
OG0016663	0	4	1	1	1	1	0	8
OG0016664	0	3	1	1	1	1	1	8
OG0016665	0	3	1	1	1	1	1	8
OG0016666	0	3	1	1	1	1	1	8
OG0016667	0	4	1	1	1	1	0	8
OG0016668	0	4	2	0	0	0	2	8
OG0016669	0	2	2	1	1	1	1	8
OG0016670	0	2	1	1	1	1	2	8
OG0016671	0	7	0	0	0	0	1	8
OG0016672	0	3	1	1	1	1	1	8
OG0016673	0	3	1	1	1	1	1	8
OG0016674	0	3	1	1	1	1	1	8
OG0016675	0	3	0	1	1	2	1	8
OG0016676	0	8	0	0	0	0	0	8
OG0016677	0	3	1	1	1	1	1	8
OG0016678	0	3	1	1	1	1	1	8
OG0016679	0	3	1	1	1	1	1	8
OG0016680	0	4	1	1	1	0	1	8
OG0016681	0	3	1	1	1	1	1	8
OG0016682	0	3	1	1	1	1	1	8
OG0016683	0	3	1	1	1	1	1	8
OG0016684	0	3	1	1	1	0	2	8
OG0016685	0	3	1	1	1	1	1	8
OG0016686	0	5	1	1	1	0	0	8
OG0016687	0	3	1	1	1	1	1	8
OG0016688	0	2	1	2	1	1	1	8
OG0016689	0	3	0	0	0	0	5	8
OG0016690	0	3	1	1	1	1	1	8
OG0016691	0	3	1	1	1	1	1	8
OG0016692	0	3	1	1	1	1	1	8
OG0016693	0	5	1	1	0	0	1	8
OG0016694	0	2	1	1	1	1	2	8
OG0016695	0	3	2	1	0	1	1	8
OG0016696	0	8	0	0	0	0	0	8
OG0016697	0	3	1	1	1	1	1	8
OG0016698	0	4	2	0	0	1	1	8
OG0016699	0	3	1	1	1	1	1	8
OG0016700	0	3	1	1	1	0	2	8
OG0016701	0	6	0	1	1	0	0	8
OG0016702	0	3	1	1	1	1	1	8
OG0016703	0	7	0	0	0	1	0	8
OG0016704	0	4	1	1	1	1	0	8
OG0016705	0	8	0	0	0	0	0	8
OG0016706	0	5	1	1	1	0	0	8
OG0016707	0	3	1	1	1	1	1	8
OG0016708	0	3	0	1	1	1	2	8
OG0016709	0	3	1	1	1	1	1	8
OG0016710	0	3	0	3	0	1	1	8
OG0016711	0	3	0	4	0	0	1	8
OG0016712	0	3	0	1	1	1	2	8
OG0016713	0	3	1	1	1	1	1	8
OG0016714	0	3	1	1	1	1	1	8
OG0016715	0	3	1	1	1	1	1	8
OG0016716	0	3	1	1	1	1	1	8
OG0016717	0	6	0	0	0	0	2	8
OG0016718	0	3	2	2	1	0	0	8
OG0016719	0	8	0	0	0	0	0	8
OG0016720	0	8	0	0	0	0	0	8
OG0016721	0	7	0	1	0	0	0	8
OG0016722	0	3	1	1	1	1	1	8
OG0016723	0	3	1	1	1	1	1	8
OG0016724	0	3	1	1	1	1	1	8
OG0016725	0	4	0	2	0	1	1	8
OG0016726	0	8	0	0	0	0	0	8
OG0016727	0	3	0	2	1	1	1	8
OG0016728	0	3	3	0	2	0	0	8
OG0016729	0	3	1	2	0	1	1	8
OG0016730	0	4	0	1	1	1	1	8
OG0016731	0	3	1	1	1	1	1	8
OG0016732	0	3	1	1	1	1	1	8
OG0016733	0	3	1	1	1	1	1	8
OG0016734	0	5	1	1	1	0	0	8
OG0016735	0	6	1	0	1	0	0	8
OG0016736	0	3	1	1	1	1	1	8
OG0016737	0	4	1	1	0	1	1	8
OG0016738	0	5	0	1	1	1	0	8
OG0016739	0	4	0	1	1	1	1	8
OG0016740	0	3	1	1	1	1	1	8
OG0016741	0	3	1	1	1	1	1	8
OG0016742	0	3	1	1	1	1	1	8
OG0016743	0	3	1	1	1	1	1	8
OG0016744	0	3	1	1	1	1	1	8
OG0016745	0	3	1	1	1	1	1	8
OG0016746	0	5	0	1	1	1	0	8
OG0016747	0	3	1	1	1	1	1	8
OG0016748	0	3	1	1	1	1	1	8
OG0016749	0	7	0	0	0	1	0	8
OG0016750	0	4	1	1	1	1	0	8
OG0016751	0	3	1	1	2	1	0	8
OG0016752	0	3	1	1	1	1	1	8
OG0016753	0	3	1	1	1	1	1	8
OG0016754	0	3	0	1	1	1	2	8
OG0016755	0	4	1	1	1	1	0	8
OG0016756	0	3	1	1	1	1	1	8
OG0016757	0	3	1	1	1	1	1	8
OG0016758	0	2	1	1	1	2	1	8
OG0016759	0	3	1	1	1	1	1	8
OG0016760	0	6	0	0	2	0	0	8
OG0016761	0	2	1	1	2	1	1	8
OG0016762	0	2	2	1	1	1	1	8
OG0016763	0	3	1	1	1	1	1	8
OG0016764	0	4	1	1	1	1	0	8
OG0016765	0	3	1	1	1	1	1	8
OG0016766	0	3	1	1	1	1	1	8
OG0016767	0	8	0	0	0	0	0	8
OG0016768	0	3	1	1	1	1	1	8
OG0016769	0	3	1	1	1	1	1	8
OG0016770	0	3	1	1	1	1	1	8
OG0016771	0	3	1	1	1	1	1	8
OG0016772	0	3	1	0	0	0	4	8
OG0016773	0	3	1	1	1	1	1	8
OG0016774	0	3	1	1	1	1	1	8
OG0016775	0	5	2	0	0	0	1	8
OG0016776	0	3	1	1	1	1	1	8
OG0016777	0	4	1	1	1	1	0	8
OG0016778	0	2	1	1	1	2	1	8
OG0016779	0	3	1	1	1	1	1	8
OG0016780	0	3	1	1	1	1	1	8
OG0016781	0	3	1	1	1	1	1	8
OG0016782	0	3	1	1	1	1	1	8
OG0016783	0	4	0	0	0	1	3	8
OG0016784	0	3	1	1	1	1	1	8
OG0016785	0	4	1	0	1	1	1	8
OG0016786	0	6	0	0	0	0	2	8
OG0016787	0	3	1	1	1	1	1	8
OG0016788	0	3	1	1	1	1	1	8
OG0016789	0	2	1	1	1	1	2	8
OG0016790	0	5	0	1	1	0	1	8
OG0016791	0	3	1	1	1	1	1	8
OG0016792	0	6	1	0	0	0	1	8
OG0016793	0	4	1	1	0	1	1	8
OG0016794	0	3	1	1	1	1	1	8
OG0016795	0	3	1	1	1	1	1	8
OG0016796	0	2	1	1	2	1	1	8
OG0016797	0	3	0	1	0	2	2	8
OG0016798	0	3	2	1	1	1	0	8
OG0016799	0	4	1	0	1	0	2	8
OG0016800	0	3	1	0	0	0	4	8
OG0016801	0	2	0	1	0	0	5	8
OG0016802	0	3	1	1	1	1	1	8
OG0016803	0	4	1	1	0	1	1	8
OG0016804	0	5	0	1	0	1	1	8
OG0016805	0	3	1	1	1	1	1	8
OG0016806	0	3	1	1	1	1	1	8
OG0016807	0	3	1	1	1	1	1	8
OG0016808	0	2	0	0	1	3	2	8
OG0016809	0	4	1	1	1	1	0	8
OG0016810	0	3	1	1	1	1	1	8
OG0016811	0	3	1	1	1	1	1	8
OG0016812	0	3	1	1	1	1	1	8
OG0016813	0	3	2	1	0	1	1	8
OG0016814	0	2	1	1	2	1	1	8
OG0016815	0	3	1	1	1	1	1	8
OG0016816	0	3	1	0	2	1	1	8
OG0016817	0	7	1	0	0	0	0	8
OG0016818	0	3	0	2	2	0	1	8
OG0016819	0	4	1	0	1	1	1	8
OG0016820	0	5	1	1	0	1	0	8
OG0016821	0	3	1	1	1	1	1	8
OG0016822	0	8	0	0	0	0	0	8
OG0016823	0	5	0	1	1	1	0	8
OG0016824	0	7	0	0	1	0	0	8
OG0016825	0	3	1	1	1	1	1	8
OG0016826	0	8	0	0	0	0	0	8
OG0016827	0	3	0	0	1	3	1	8
OG0016828	0	3	1	1	1	1	1	8
OG0016829	0	3	1	1	1	1	1	8
OG0016830	0	3	1	1	1	1	1	8
OG0016831	0	3	1	1	1	1	1	8
OG0016832	0	3	2	1	2	0	0	8
OG0016833	0	2	1	1	1	2	1	8
OG0016834	0	3	1	1	1	1	1	8
OG0016835	0	4	1	1	0	1	1	8
OG0016836	0	3	1	1	1	1	1	8
OG0016837	0	3	1	1	1	1	1	8
OG0016838	0	3	0	3	1	0	1	8
OG0016839	0	3	1	1	1	1	1	8
OG0016840	0	3	1	1	1	1	1	8
OG0016841	0	3	1	1	1	1	1	8
OG0016842	0	3	1	1	1	1	1	8
OG0016843	0	2	2	1	1	2	0	8
OG0016844	0	3	1	1	1	1	1	8
OG0016845	0	3	1	1	1	1	1	8
OG0016846	0	6	0	1	1	0	0	8
OG0016847	0	8	0	0	0	0	0	8
OG0016848	0	3	1	1	1	1	1	8
OG0016849	0	3	1	1	1	1	1	8
OG0016850	0	5	1	0	0	1	1	8
OG0016851	0	4	0	1	1	1	1	8
OG0016852	0	6	1	1	0	0	0	8
OG0016853	0	2	0	1	0	1	4	8
OG0016854	0	7	0	0	0	0	1	8
OG0016855	0	3	1	0	1	1	2	8
OG0016856	0	3	1	1	1	1	1	8
OG0016857	0	2	1	1	1	1	2	8
OG0016858	0	8	0	0	0	0	0	8
OG0016859	0	3	1	1	1	1	1	8
OG0016860	0	4	1	1	0	1	1	8
OG0016861	0	6	2	0	0	0	0	8
OG0016862	0	6	0	1	0	0	1	8
OG0016863	0	3	1	1	1	1	1	8
OG0016864	0	4	0	1	1	1	1	8
OG0016865	0	4	1	1	1	0	1	8
OG0016866	0	3	1	1	1	0	2	8
OG0016867	0	3	1	1	1	1	1	8
OG0016868	0	4	0	1	1	1	1	8
OG0016869	0	8	0	0	0	0	0	8
OG0016870	0	8	0	0	0	0	0	8
OG0016871	0	8	0	0	0	0	0	8
OG0016872	0	4	1	1	0	2	0	8
OG0016873	0	4	1	1	0	1	1	8
OG0016874	0	3	1	1	1	1	1	8
OG0016875	0	3	1	1	1	1	1	8
OG0016876	0	5	1	0	1	1	0	8
OG0016877	0	3	1	1	1	1	1	8
OG0016878	0	3	1	1	1	1	1	8
OG0016879	0	3	1	1	1	1	1	8
OG0016880	0	6	2	0	0	0	0	8
OG0016881	0	3	1	1	1	1	1	8
OG0016882	0	4	0	1	1	1	1	8
OG0016883	0	3	1	1	1	1	1	8
OG0016884	0	8	0	0	0	0	0	8
OG0016885	0	3	1	1	1	1	1	8
OG0016886	0	3	1	1	1	1	1	8
OG0016887	0	2	1	2	1	1	1	8
OG0016888	0	3	1	1	1	1	1	8
OG0016889	0	5	0	1	0	1	1	8
OG0016890	0	3	1	1	1	1	1	8
OG0016891	0	3	1	1	1	1	1	8
OG0016892	0	3	0	1	2	1	1	8
OG0016893	0	3	0	2	0	2	1	8
OG0016894	0	2	1	1	1	1	2	8
OG0016895	0	3	1	1	1	1	1	8
OG0016896	0	3	3	0	1	0	1	8
OG0016897	0	4	1	1	1	0	1	8
OG0016898	0	2	1	2	1	1	1	8
OG0016899	0	3	1	1	1	1	1	8
OG0016900	0	3	1	1	1	1	1	8
OG0016901	0	3	1	1	0	1	2	8
OG0016902	0	2	0	0	1	2	3	8
OG0016903	0	3	1	1	1	1	1	8
OG0016904	0	5	1	0	0	1	1	8
OG0016905	0	3	1	1	1	1	1	8
OG0016906	0	3	1	1	1	1	1	8
OG0016907	0	2	1	1	0	2	2	8
OG0016908	0	3	1	1	1	1	1	8
OG0016909	0	8	0	0	0	0	0	8
OG0016910	0	4	0	1	3	0	0	8
OG0016911	0	4	1	0	1	1	1	8
OG0016912	0	4	0	0	2	1	1	8
OG0016913	0	3	1	1	1	1	1	8
OG0016914	0	6	0	1	0	0	1	8
OG0016915	0	3	1	1	1	1	1	8
OG0016916	0	3	1	1	1	1	1	8
OG0016917	0	3	1	1	1	0	2	8
OG0016918	0	3	1	1	1	1	1	8
OG0016919	0	4	1	1	1	1	0	8
OG0016920	0	3	1	1	1	1	1	8
OG0016921	0	3	1	1	1	1	1	8
OG0016922	0	2	1	1	1	2	1	8
OG0016923	0	3	1	1	1	1	1	8
OG0016924	0	5	0	1	0	1	1	8
OG0016925	0	3	1	1	1	1	1	8
OG0016926	0	3	1	1	1	1	1	8
OG0016927	0	2	0	1	1	2	2	8
OG0016928	0	3	1	1	1	1	1	8
OG0016929	0	3	1	1	1	1	1	8
OG0016930	0	3	1	1	1	1	1	8
OG0016931	0	2	0	1	2	2	1	8
OG0016932	0	3	1	1	1	1	1	8
OG0016933	0	2	1	1	1	1	2	8
OG0016934	0	4	1	1	1	0	1	8
OG0016935	0	3	1	1	1	1	1	8
OG0016936	0	3	1	1	1	0	2	8
OG0016937	0	3	1	1	1	0	2	8
OG0016938	0	2	1	1	0	3	1	8
OG0016939	0	4	1	0	1	1	1	8
OG0016940	0	5	1	0	1	1	0	8
OG0016941	0	4	1	1	1	0	1	8
OG0016942	0	3	1	1	1	1	1	8
OG0016943	0	4	0	1	1	0	2	8
OG0016944	0	5	0	0	0	1	2	8
OG0016945	0	4	1	1	0	1	1	8
OG0016946	0	2	1	1	1	1	2	8
OG0016947	0	3	1	1	0	2	1	8
OG0016948	0	3	1	1	1	1	1	8
OG0016949	0	3	1	1	1	1	1	8
OG0016950	0	5	0	1	1	0	1	8
OG0016951	0	3	1	1	1	1	1	8
OG0016952	0	4	1	1	1	1	0	8
OG0016953	0	4	0	1	1	2	0	8
OG0016954	0	3	1	1	1	1	1	8
OG0016955	0	3	1	1	0	1	2	8
OG0016956	0	3	1	1	1	1	1	8
OG0016957	0	7	1	0	0	0	0	8
OG0016958	0	7	1	0	0	0	0	8
OG0016959	0	3	1	1	1	1	1	8
OG0016960	0	3	1	1	1	1	1	8
OG0016961	0	3	1	1	1	1	1	8
OG0016962	0	3	1	1	1	1	1	8
OG0016963	0	3	1	1	1	1	1	8
OG0016964	0	4	0	2	1	1	0	8
OG0016965	0	3	1	1	1	1	1	8
OG0016966	0	3	1	1	1	1	1	8
OG0016967	0	3	1	1	1	1	1	8
OG0016968	0	3	1	1	1	1	1	8
OG0016969	0	3	1	1	1	2	0	8
OG0016970	0	3	1	1	1	1	1	8
OG0016971	0	4	1	1	1	0	1	8
OG0016972	0	3	1	1	1	1	1	8
OG0016973	0	3	1	1	1	1	1	8
OG0016974	0	5	0	1	1	0	1	8
OG0016975	0	3	1	1	1	1	1	8
OG0016976	0	3	1	1	1	1	1	8
OG0016977	0	3	1	1	1	1	1	8
OG0016978	0	8	0	0	0	0	0	8
OG0016979	0	6	0	0	0	0	2	8
OG0016980	0	3	1	1	1	1	1	8
OG0016981	0	1	1	1	2	2	1	8
OG0016982	0	6	0	1	1	0	0	8
OG0016983	0	3	1	1	1	1	1	8
OG0016984	0	3	0	1	1	1	2	8
OG0016985	0	3	1	1	1	1	1	8
OG0016986	0	2	0	1	4	1	0	8
OG0016987	0	4	0	1	1	1	1	8
OG0016988	0	2	1	1	2	1	1	8
OG0016989	0	3	1	1	1	1	1	8
OG0016990	0	3	1	1	1	1	1	8
OG0016991	0	3	1	1	1	1	1	8
OG0016992	0	5	0	1	1	1	0	8
OG0016993	0	3	1	1	1	1	1	8
OG0016994	0	3	1	1	1	1	1	8
OG0016995	0	3	1	1	1	1	1	8
OG0016996	0	4	1	1	1	0	1	8
OG0016997	0	3	1	1	1	1	1	8
OG0016998	0	3	1	1	1	1	1	8
OG0016999	0	3	1	1	1	1	1	8
OG0017000	0	4	1	1	1	0	1	8
OG0017001	0	4	1	1	1	0	1	8
OG0017002	0	3	1	1	1	1	1	8
OG0017003	0	4	1	2	1	0	0	8
OG0017004	0	3	1	1	1	1	1	8
OG0017005	0	4	1	1	1	1	0	8
OG0017006	0	3	1	1	1	1	1	8
OG0017007	0	2	0	3	0	2	1	8
OG0017008	0	3	1	1	1	1	1	8
OG0017009	0	3	1	1	1	1	1	8
OG0017010	0	3	1	1	1	1	1	8
OG0017011	0	3	1	1	1	1	1	8
OG0017012	0	3	1	1	1	1	1	8
OG0017013	0	3	1	1	1	1	1	8
OG0017014	0	3	1	1	1	1	1	8
OG0017015	0	3	1	1	1	1	1	8
OG0017016	0	4	2	0	1	0	1	8
OG0017017	0	4	1	0	1	1	1	8
OG0017018	0	3	0	1	3	0	1	8
OG0017019	0	8	0	0	0	0	0	8
OG0017020	0	3	1	1	1	1	1	8
OG0017021	0	3	1	2	0	1	1	8
OG0017022	0	4	1	0	1	1	1	8
OG0017023	0	4	0	0	1	1	2	8
OG0017024	0	4	1	0	1	1	1	8
OG0017025	0	3	1	1	1	1	1	8
OG0017026	0	4	0	1	1	1	1	8
OG0017027	0	3	0	1	1	1	2	8
OG0017028	0	3	1	1	1	2	0	8
OG0017029	0	3	1	1	1	1	1	8
OG0017030	0	5	1	0	0	1	1	8
OG0017031	0	3	1	1	1	1	1	8
OG0017032	0	3	1	1	1	1	1	8
OG0017033	0	5	0	1	1	1	0	8
OG0017034	0	3	2	1	1	1	0	8
OG0017035	0	3	1	1	1	1	1	8
OG0017036	0	3	1	1	1	1	1	8
OG0017037	0	4	0	1	1	1	1	8
OG0017038	0	7	0	0	0	0	1	8
OG0017039	0	3	1	1	1	1	1	8
OG0017040	0	3	1	1	1	1	1	8
OG0017041	0	3	1	1	1	1	1	8
OG0017042	0	6	0	1	1	0	0	8
OG0017043	0	3	1	1	1	1	1	8
OG0017044	0	3	1	1	1	1	1	8
OG0017045	0	2	2	1	1	1	1	8
OG0017046	0	2	0	3	2	1	0	8
OG0017047	0	1	1	0	0	0	6	8
OG0017048	0	3	1	1	1	1	1	8
OG0017049	0	3	1	1	1	1	1	8
OG0017050	0	3	1	1	1	1	1	8
OG0017051	0	3	1	1	1	1	1	8
OG0017052	0	3	1	1	1	1	1	8
OG0017053	0	3	1	1	1	1	1	8
OG0017054	0	2	1	1	1	2	1	8
OG0017055	0	2	0	1	1	1	3	8
OG0017056	0	3	1	1	1	1	1	8
OG0017057	0	3	1	1	0	1	2	8
OG0017058	0	2	1	1	1	1	2	8
OG0017059	0	3	1	1	1	1	1	8
OG0017060	0	3	1	1	1	1	1	8
OG0017061	0	3	1	1	1	1	1	8
OG0017062	0	3	1	1	1	1	1	8
OG0017063	0	5	0	0	0	1	2	8
OG0017064	0	4	0	1	1	2	0	8
OG0017065	0	4	1	1	1	1	0	8
OG0017066	0	3	1	1	1	1	1	8
OG0017067	0	3	1	1	1	1	1	8
OG0017068	0	3	1	1	1	1	1	8
OG0017069	0	3	1	1	1	1	1	8
OG0017070	0	5	2	0	0	1	0	8
OG0017071	0	2	1	1	1	2	1	8
OG0017072	0	2	1	1	1	2	1	8
OG0017073	0	5	0	1	1	1	0	8
OG0017074	0	8	0	0	0	0	0	8
OG0017075	0	3	1	1	1	1	1	8
OG0017076	0	3	1	1	1	1	1	8
OG0017077	0	3	1	1	1	1	1	8
OG0017078	0	3	1	1	1	1	1	8
OG0017079	0	3	1	1	1	1	1	8
OG0017080	0	3	0	1	3	1	0	8
OG0017081	0	3	1	1	1	1	1	8
OG0017082	0	6	0	0	1	0	1	8
OG0017083	0	3	1	1	1	1	1	8
OG0017084	0	3	1	1	1	1	1	8
OG0017085	0	3	1	1	1	1	1	8
OG0017086	0	1	1	2	1	2	1	8
OG0017087	0	3	1	1	1	1	1	8
OG0017088	0	3	1	1	1	1	1	8
OG0017089	0	5	0	1	1	0	1	8
OG0017090	0	3	1	1	1	1	1	8
OG0017091	0	3	1	1	1	1	1	8
OG0017092	0	8	0	0	0	0	0	8
OG0017093	0	6	1	0	0	1	0	8
OG0017094	0	4	1	1	1	1	0	8
OG0017095	0	8	0	0	0	0	0	8
OG0017096	0	3	1	1	1	1	1	8
OG0017097	0	3	1	1	1	1	1	8
OG0017098	0	3	1	1	1	1	1	8
OG0017099	0	3	1	1	1	1	1	8
OG0017100	0	3	1	1	1	1	1	8
OG0017101	0	3	1	1	1	1	1	8
OG0017102	0	6	0	0	0	0	2	8
OG0017103	0	7	0	0	0	1	0	8
OG0017104	0	3	1	1	1	1	1	8
OG0017105	0	3	1	1	1	1	1	8
OG0017106	0	3	1	1	1	1	1	8
OG0017107	0	4	1	0	1	1	1	8
OG0017108	0	3	1	1	1	1	1	8
OG0017109	0	3	1	1	1	1	1	8
OG0017110	0	3	1	1	1	1	1	8
OG0017111	0	3	1	1	1	1	1	8
OG0017112	0	3	1	1	1	1	1	8
OG0017113	0	4	1	1	0	1	1	8
OG0017114	0	3	1	1	1	1	1	8
OG0017115	0	3	1	1	1	1	1	8
OG0017116	0	3	1	1	1	1	1	8
OG0017117	0	4	1	1	1	0	1	8
OG0017118	0	3	1	1	1	1	1	8
OG0017119	0	3	1	1	1	1	1	8
OG0017120	0	5	0	1	0	1	1	8
OG0017121	0	3	1	1	1	1	1	8
OG0017122	0	4	1	1	1	0	1	8
OG0017123	0	6	0	0	0	1	1	8
OG0017124	0	2	0	2	1	2	1	8
OG0017125	0	3	1	1	1	1	1	8
OG0017126	0	5	1	0	1	1	0	8
OG0017127	0	2	1	2	1	1	1	8
OG0017128	0	4	1	0	2	1	0	8
OG0017129	0	3	1	1	1	1	1	8
OG0017130	0	3	1	1	1	1	1	8
OG0017131	0	3	1	1	1	1	1	8
OG0017132	0	2	1	1	0	1	3	8
OG0017133	0	3	1	1	1	1	1	8
OG0017134	0	3	1	1	1	1	1	8
OG0017135	0	3	1	1	1	1	1	8
OG0017136	0	2	1	1	1	2	1	8
OG0017137	0	2	1	1	1	1	2	8
OG0017138	0	3	1	1	1	1	1	8
OG0017139	0	3	1	1	1	1	1	8
OG0017140	0	3	1	1	1	1	1	8
OG0017141	0	3	0	2	1	1	1	8
OG0017142	0	3	1	1	0	2	1	8
OG0017143	0	3	1	1	1	1	1	8
OG0017144	0	2	1	2	1	1	1	8
OG0017145	0	3	1	1	1	1	1	8
OG0017146	0	3	1	1	1	1	1	8
OG0017147	0	3	1	1	1	1	1	8
OG0017148	0	3	1	1	1	1	1	8
OG0017149	0	8	0	0	0	0	0	8
OG0017150	0	3	1	1	1	1	1	8
OG0017151	0	3	1	1	1	1	1	8
OG0017152	0	3	1	1	1	0	2	8
OG0017153	0	3	1	1	1	0	2	8
OG0017154	0	3	1	1	1	1	1	8
OG0017155	0	6	0	0	0	1	1	8
OG0017156	0	2	2	1	1	1	1	8
OG0017157	0	3	1	1	0	2	1	8
OG0017158	0	2	1	0	0	1	4	8
OG0017159	0	2	1	1	1	2	1	8
OG0017160	0	3	1	1	1	1	1	8
OG0017161	0	3	2	2	0	0	1	8
OG0017162	0	2	0	1	0	2	3	8
OG0017163	0	3	1	1	1	1	1	8
OG0017164	0	4	0	0	1	1	2	8
OG0017165	0	8	0	0	0	0	0	8
OG0017166	0	7	1	0	0	0	0	8
OG0017167	0	7	1	0	0	0	0	8
OG0017168	0	2	1	1	2	1	1	8
OG0017169	0	3	0	0	1	1	3	8
OG0017170	0	4	0	1	1	1	1	8
OG0017171	0	4	0	1	1	1	1	8
OG0017172	0	3	1	1	1	1	1	8
OG0017173	0	3	1	1	1	1	1	8
OG0017174	0	4	1	1	1	0	1	8
OG0017175	0	1	1	2	0	0	4	8
OG0017176	0	3	1	1	1	1	1	8
OG0017177	0	4	0	1	1	1	1	8
OG0017178	0	3	0	1	2	1	1	8
OG0017179	0	3	1	0	1	0	3	8
OG0017180	0	3	0	2	1	1	1	8
OG0017181	0	3	1	1	1	1	1	8
OG0017182	0	3	0	2	2	1	0	8
OG0017183	0	2	1	0	2	1	2	8
OG0017184	0	2	2	0	1	1	2	8
OG0017185	0	2	0	1	2	2	1	8
OG0017186	0	3	1	1	1	1	1	8
OG0017187	0	2	1	1	2	1	1	8
OG0017188	0	2	0	2	0	1	3	8
OG0017189	0	2	1	1	1	2	1	8
OG0017190	0	2	2	0	0	1	3	8
OG0017191	0	1	0	2	0	4	1	8
OG0017192	0	2	0	2	0	1	3	8
OG0017193	0	3	1	1	1	1	1	8
OG0017194	0	3	1	1	1	1	1	8
OG0017195	0	3	1	0	2	1	1	8
OG0017196	0	3	2	1	1	0	1	8
OG0017197	0	1	5	0	0	0	2	8
OG0017198	0	1	0	0	2	2	3	8
OG0017199	0	1	3	0	1	1	2	8
OG0017200	0	4	0	0	0	0	4	8
OG0017201	0	3	0	3	0	1	1	8
OG0017202	0	4	1	0	1	1	1	8
OG0017203	0	4	0	0	2	1	1	8
OG0017204	0	3	1	1	1	1	1	8
OG0017205	0	2	1	1	1	1	2	8
OG0017206	0	3	1	1	0	1	2	8
OG0017207	0	4	0	1	1	1	1	8
OG0017208	0	1	0	1	4	1	1	8
OG0017209	0	1	1	3	2	1	0	8
OG0017210	0	4	1	1	1	1	0	8
OG0017211	0	3	1	1	0	1	2	8
OG0017212	0	4	1	0	0	0	3	8
OG0017213	0	3	1	1	1	1	1	8
OG0017214	0	3	1	1	1	1	1	8
OG0017215	0	3	1	1	1	1	1	8
OG0017216	0	3	1	1	1	1	1	8
OG0017217	0	3	0	1	2	1	1	8
OG0017218	0	3	1	1	1	1	1	8
OG0017219	0	3	1	1	1	1	1	8
OG0017220	0	2	2	1	1	1	1	8
OG0017221	0	3	1	1	1	1	1	8
OG0017222	0	3	1	1	1	1	1	8
OG0017223	0	3	1	1	1	1	1	8
OG0017224	0	2	2	0	0	3	1	8
OG0017225	0	2	1	1	1	2	1	8
OG0017226	0	1	3	1	1	1	1	8
OG0017227	0	1	1	1	1	2	2	8
OG0017228	0	0	2	1	3	1	1	8
OG0017229	0	0	1	0	0	0	7	8
OG0017230	0	0	1	0	0	0	7	8
OG0017231	0	0	0	1	6	0	1	8
OG0017232	0	0	0	2	3	1	2	8
OG0017233	0	0	0	1	0	0	7	8
OG0017234	0	0	0	0	0	0	8	8
OG0017235	0	0	0	0	0	0	8	8
OG0017236	0	0	0	0	0	0	8	8
OG0017237	0	0	0	0	0	0	8	8
OG0017238	0	0	0	0	0	0	8	8
OG0017239	0	0	0	0	0	0	8	8
OG0017240	0	0	0	0	0	0	8	8
OG0017241	0	0	0	0	0	0	8	8
OG0017242	0	0	0	0	0	0	8	8
OG0017243	7	0	0	0	0	0	0	7
OG0017244	1	1	1	1	1	1	1	7
OG0017245	7	0	0	0	0	0	0	7
OG0017246	7	0	0	0	0	0	0	7
OG0017247	1	1	1	1	1	1	1	7
OG0017248	1	1	1	1	1	1	1	7
OG0017249	2	2	1	0	1	0	1	7
OG0017250	1	2	1	1	0	1	1	7
OG0017251	4	2	1	0	0	0	0	7
OG0017252	1	2	1	1	1	0	1	7
OG0017253	1	1	1	1	1	1	1	7
OG0017254	7	0	0	0	0	0	0	7
OG0017255	2	0	1	1	1	1	1	7
OG0017256	2	0	1	1	1	1	1	7
OG0017257	1	1	1	1	1	1	1	7
OG0017258	4	2	1	0	0	0	0	7
OG0017259	1	1	1	1	1	1	1	7
OG0017260	2	1	1	0	1	1	1	7
OG0017261	7	0	0	0	0	0	0	7
OG0017262	2	0	1	1	1	1	1	7
OG0017263	1	1	1	1	1	1	1	7
OG0017264	1	2	1	1	1	0	1	7
OG0017265	2	1	1	0	1	1	1	7
OG0017266	1	1	1	1	1	1	1	7
OG0017267	1	2	1	1	1	1	0	7
OG0017268	1	0	3	1	1	1	0	7
OG0017269	1	1	1	1	1	1	1	7
OG0017270	2	0	1	1	1	1	1	7
OG0017271	1	2	1	1	1	1	0	7
OG0017272	2	1	1	1	1	1	0	7
OG0017273	2	1	1	1	1	0	1	7
OG0017274	2	2	0	1	1	1	0	7
OG0017275	7	0	0	0	0	0	0	7
OG0017276	3	2	0	1	0	0	1	7
OG0017277	1	2	1	1	0	1	1	7
OG0017278	1	1	1	1	1	1	1	7
OG0017279	2	1	1	1	1	1	0	7
OG0017280	2	0	1	1	1	1	1	7
OG0017281	6	0	0	0	1	0	0	7
OG0017282	1	3	1	1	0	0	1	7
OG0017283	7	0	0	0	0	0	0	7
OG0017284	2	1	1	1	0	1	1	7
OG0017285	1	3	1	1	0	0	1	7
OG0017286	1	1	1	1	1	1	1	7
OG0017287	1	2	1	0	1	1	1	7
OG0017288	1	2	1	1	1	1	0	7
OG0017289	2	0	1	1	1	1	1	7
OG0017290	1	1	1	1	1	1	1	7
OG0017291	1	1	1	1	1	1	1	7
OG0017292	2	1	1	1	1	1	0	7
OG0017293	2	1	1	0	1	1	1	7
OG0017294	1	1	1	1	1	1	1	7
OG0017295	1	1	1	1	1	1	1	7
OG0017296	2	2	1	0	1	0	1	7
OG0017297	2	2	1	1	1	0	0	7
OG0017298	2	1	1	0	0	2	1	7
OG0017299	2	1	1	0	1	1	1	7
OG0017300	1	1	1	1	1	1	1	7
OG0017301	1	1	1	1	1	1	1	7
OG0017302	1	3	1	0	0	1	1	7
OG0017303	1	1	1	1	1	1	1	7
OG0017304	2	1	1	1	1	0	1	7
OG0017305	7	0	0	0	0	0	0	7
OG0017306	2	0	1	1	1	1	1	7
OG0017307	7	0	0	0	0	0	0	7
OG0017308	1	1	1	1	1	1	1	7
OG0017309	1	1	1	1	1	1	1	7
OG0017310	1	2	1	1	0	1	1	7
OG0017311	3	1	1	1	0	0	1	7
OG0017312	2	1	1	0	1	1	1	7
OG0017313	1	2	1	1	0	1	1	7
OG0017314	2	2	0	1	1	1	0	7
OG0017315	1	2	1	1	1	0	1	7
OG0017316	2	1	1	1	0	1	1	7
OG0017317	1	1	1	1	1	1	1	7
OG0017318	2	2	1	1	0	0	1	7
OG0017319	2	0	1	1	1	1	1	7
OG0017320	7	0	0	0	0	0	0	7
OG0017321	2	1	1	1	1	1	0	7
OG0017322	1	2	1	1	1	0	1	7
OG0017323	1	1	1	1	1	1	1	7
OG0017324	2	2	1	0	1	0	1	7
OG0017325	1	1	1	1	1	1	1	7
OG0017326	2	0	1	1	1	1	1	7
OG0017327	2	2	1	1	0	0	1	7
OG0017328	2	1	1	1	1	0	1	7
OG0017329	7	0	0	0	0	0	0	7
OG0017330	1	1	1	1	1	1	1	7
OG0017331	2	0	1	1	1	1	1	7
OG0017332	2	3	1	0	0	0	1	7
OG0017333	2	0	1	1	1	1	1	7
OG0017334	1	1	1	1	1	1	1	7
OG0017335	1	2	0	2	2	0	0	7
OG0017336	1	1	1	1	1	1	1	7
OG0017337	2	0	1	1	1	1	1	7
OG0017338	2	3	1	0	0	0	1	7
OG0017339	7	0	0	0	0	0	0	7
OG0017340	1	2	1	1	1	0	1	7
OG0017341	1	4	1	0	0	0	1	7
OG0017342	7	0	0	0	0	0	0	7
OG0017343	1	1	1	1	1	1	1	7
OG0017344	1	3	1	1	0	0	1	7
OG0017345	2	0	1	1	1	1	1	7
OG0017346	1	1	1	1	1	1	1	7
OG0017347	1	1	1	1	1	1	1	7
OG0017348	1	1	1	1	1	1	1	7
OG0017349	7	0	0	0	0	0	0	7
OG0017350	2	1	1	1	1	0	1	7
OG0017351	2	3	1	0	0	0	1	7
OG0017352	1	1	1	1	1	1	1	7
OG0017353	1	2	2	0	1	0	1	7
OG0017354	7	0	0	0	0	0	0	7
OG0017355	4	0	0	0	2	1	0	7
OG0017356	2	1	1	1	1	1	0	7
OG0017357	7	0	0	0	0	0	0	7
OG0017358	2	0	1	1	1	1	1	7
OG0017359	1	1	1	1	1	1	1	7
OG0017360	2	1	2	1	1	0	0	7
OG0017361	2	1	1	1	1	1	0	7
OG0017362	1	2	1	1	0	1	1	7
OG0017363	2	0	1	1	1	1	1	7
OG0017364	2	2	1	1	0	0	1	7
OG0017365	1	2	1	1	1	1	0	7
OG0017366	2	0	1	1	1	1	1	7
OG0017367	1	1	1	1	1	1	1	7
OG0017368	1	1	0	1	1	2	1	7
OG0017369	2	1	1	1	1	0	1	7
OG0017370	2	1	1	0	1	1	1	7
OG0017371	2	2	1	0	1	0	1	7
OG0017372	2	2	1	1	0	0	1	7
OG0017373	1	6	0	0	0	0	0	7
OG0017374	2	1	1	1	1	1	0	7
OG0017375	1	1	1	1	1	1	1	7
OG0017376	2	0	1	1	1	1	1	7
OG0017377	2	1	1	1	1	0	1	7
OG0017378	1	2	1	1	1	0	1	7
OG0017379	7	0	0	0	0	0	0	7
OG0017380	2	2	1	0	0	1	1	7
OG0017381	1	1	1	1	1	1	1	7
OG0017382	1	2	1	1	1	1	0	7
OG0017383	2	1	1	0	1	1	1	7
OG0017384	2	4	0	0	0	0	1	7
OG0017385	7	0	0	0	0	0	0	7
OG0017386	3	0	1	1	1	0	1	7
OG0017387	3	0	2	1	0	0	1	7
OG0017388	2	0	1	1	1	1	1	7
OG0017389	1	0	1	1	1	1	2	7
OG0017390	1	1	1	1	1	1	1	7
OG0017391	2	1	1	1	0	1	1	7
OG0017392	2	0	1	1	1	1	1	7
OG0017393	1	4	1	0	0	0	1	7
OG0017394	7	0	0	0	0	0	0	7
OG0017395	1	4	1	0	1	0	0	7
OG0017396	1	1	1	1	1	1	1	7
OG0017397	1	1	1	1	1	1	1	7
OG0017398	2	0	1	1	1	1	1	7
OG0017399	2	0	1	1	1	1	1	7
OG0017400	5	0	1	0	1	0	0	7
OG0017401	1	4	1	0	0	0	1	7
OG0017402	2	2	1	1	0	0	1	7
OG0017403	1	2	1	1	1	0	1	7
OG0017404	2	3	1	0	0	0	1	7
OG0017405	1	4	2	0	0	0	0	7
OG0017406	2	0	1	1	1	1	1	7
OG0017407	2	0	1	1	1	1	1	7
OG0017408	1	2	1	1	1	0	1	7
OG0017409	3	0	1	1	1	1	0	7
OG0017410	7	0	0	0	0	0	0	7
OG0017411	2	0	1	1	1	1	1	7
OG0017412	1	2	0	3	0	1	0	7
OG0017413	2	0	1	1	1	1	1	7
OG0017414	4	1	2	0	0	0	0	7
OG0017415	2	3	1	0	0	0	1	7
OG0017416	1	1	1	1	1	1	1	7
OG0017417	2	0	1	1	1	1	1	7
OG0017418	1	2	1	1	1	1	0	7
OG0017419	2	1	1	1	0	1	1	7
OG0017420	7	0	0	0	0	0	0	7
OG0017421	2	1	1	1	1	1	0	7
OG0017422	1	2	1	1	0	1	1	7
OG0017423	1	2	1	1	1	0	1	7
OG0017424	2	0	1	1	1	1	1	7
OG0017425	2	1	1	1	0	1	1	7
OG0017426	7	0	0	0	0	0	0	7
OG0017427	2	1	1	1	1	0	1	7
OG0017428	2	3	1	0	0	0	1	7
OG0017429	1	1	1	1	1	1	1	7
OG0017430	1	2	1	0	1	1	1	7
OG0017431	2	3	1	0	0	0	1	7
OG0017432	1	1	1	1	1	1	1	7
OG0017433	1	1	1	1	1	1	1	7
OG0017434	2	1	1	1	1	0	1	7
OG0017435	7	0	0	0	0	0	0	7
OG0017436	2	1	1	1	1	0	1	7
OG0017437	2	4	1	0	0	0	0	7
OG0017438	2	0	1	1	1	1	1	7
OG0017439	2	3	1	0	0	0	1	7
OG0017440	1	2	1	1	1	1	0	7
OG0017441	1	3	1	0	1	1	0	7
OG0017442	1	2	1	1	1	0	1	7
OG0017443	7	0	0	0	0	0	0	7
OG0017444	1	1	1	1	1	1	1	7
OG0017445	1	1	1	1	1	1	1	7
OG0017446	1	1	1	1	1	1	1	7
OG0017447	2	1	1	1	0	1	1	7
OG0017448	2	1	1	1	1	1	0	7
OG0017449	2	0	1	1	1	1	1	7
OG0017450	1	0	2	1	1	1	1	7
OG0017451	1	1	1	1	1	1	1	7
OG0017452	1	1	1	1	1	1	1	7
OG0017453	2	1	1	1	0	1	1	7
OG0017454	2	3	1	1	0	0	0	7
OG0017455	7	0	0	0	0	0	0	7
OG0017456	2	0	1	1	1	1	1	7
OG0017457	2	5	0	0	0	0	0	7
OG0017458	7	0	0	0	0	0	0	7
OG0017459	1	1	1	1	1	1	1	7
OG0017460	1	4	1	1	0	0	0	7
OG0017461	1	2	1	1	1	1	0	7
OG0017462	2	1	1	0	1	1	1	7
OG0017463	2	1	1	1	0	1	1	7
OG0017464	2	3	1	0	0	0	1	7
OG0017465	2	2	1	0	1	0	1	7
OG0017466	2	2	1	1	0	0	1	7
OG0017467	4	0	1	0	0	1	1	7
OG0017468	7	0	0	0	0	0	0	7
OG0017469	1	2	1	1	1	1	0	7
OG0017470	1	1	1	1	1	1	1	7
OG0017471	2	1	1	1	1	0	1	7
OG0017472	1	1	1	1	1	1	1	7
OG0017473	2	2	1	0	0	1	1	7
OG0017474	1	2	1	1	1	1	0	7
OG0017475	2	0	1	1	1	1	1	7
OG0017476	2	3	1	0	0	1	0	7
OG0017477	7	0	0	0	0	0	0	7
OG0017478	2	1	1	1	1	0	1	7
OG0017479	1	1	1	1	1	1	1	7
OG0017480	2	2	0	1	0	1	1	7
OG0017481	1	1	1	1	1	1	1	7
OG0017482	1	2	1	1	1	0	1	7
OG0017483	5	0	1	0	0	0	1	7
OG0017484	7	0	0	0	0	0	0	7
OG0017485	1	1	1	1	1	1	1	7
OG0017486	1	1	1	1	1	1	1	7
OG0017487	1	1	1	1	1	1	1	7
OG0017488	1	3	1	1	0	0	1	7
OG0017489	1	1	1	1	1	1	1	7
OG0017490	2	1	1	1	1	0	1	7
OG0017491	1	2	1	0	1	1	1	7
OG0017492	2	2	0	1	0	1	1	7
OG0017493	2	1	1	1	1	1	0	7
OG0017494	1	2	1	0	1	1	1	7
OG0017495	1	1	1	1	1	1	1	7
OG0017496	1	1	1	1	1	1	1	7
OG0017497	7	0	0	0	0	0	0	7
OG0017498	2	1	1	1	0	1	1	7
OG0017499	1	1	1	1	1	1	1	7
OG0017500	1	3	1	0	0	0	2	7
OG0017501	2	3	1	0	0	1	0	7
OG0017502	2	3	1	1	0	0	0	7
OG0017503	1	2	1	0	1	1	1	7
OG0017504	1	2	1	1	1	0	1	7
OG0017505	7	0	0	0	0	0	0	7
OG0017506	2	2	1	1	0	0	1	7
OG0017507	2	0	1	1	1	1	1	7
OG0017508	1	2	1	1	1	1	0	7
OG0017509	2	3	1	0	0	0	1	7
OG0017510	1	1	1	1	1	1	1	7
OG0017511	1	0	1	0	2	0	3	7
OG0017512	2	0	1	1	1	1	1	7
OG0017513	2	0	1	1	1	1	1	7
OG0017514	1	1	1	1	1	1	1	7
OG0017515	2	2	1	1	0	1	0	7
OG0017516	2	0	1	1	1	1	1	7
OG0017517	1	2	1	0	1	1	1	7
OG0017518	7	0	0	0	0	0	0	7
OG0017519	1	4	0	1	1	0	0	7
OG0017520	1	2	1	1	0	1	1	7
OG0017521	1	1	1	1	1	1	1	7
OG0017522	2	2	1	1	0	0	1	7
OG0017523	7	0	0	0	0	0	0	7
OG0017524	1	3	1	1	0	1	0	7
OG0017525	7	0	0	0	0	0	0	7
OG0017526	1	1	1	1	1	1	1	7
OG0017527	2	1	1	1	0	1	1	7
OG0017528	1	2	1	1	1	0	1	7
OG0017529	1	1	1	1	1	1	1	7
OG0017530	1	1	1	1	1	1	1	7
OG0017531	2	0	1	1	1	1	1	7
OG0017532	2	0	1	1	1	1	1	7
OG0017533	1	2	1	1	1	1	0	7
OG0017534	1	1	1	1	1	1	1	7
OG0017535	2	1	1	1	0	1	1	7
OG0017536	2	2	1	1	0	0	1	7
OG0017537	2	1	1	1	0	1	1	7
OG0017538	2	0	1	1	1	1	1	7
OG0017539	7	0	0	0	0	0	0	7
OG0017540	1	3	1	1	0	1	0	7
OG0017541	2	0	1	1	1	1	1	7
OG0017542	1	2	1	1	1	1	0	7
OG0017543	1	3	1	0	0	1	1	7
OG0017544	1	1	1	1	1	1	1	7
OG0017545	1	1	1	1	1	1	1	7
OG0017546	1	1	1	1	1	1	1	7
OG0017547	1	2	0	0	1	1	2	7
OG0017548	2	1	0	0	0	2	2	7
OG0017549	1	1	1	1	1	1	1	7
OG0017550	7	0	0	0	0	0	0	7
OG0017551	7	0	0	0	0	0	0	7
OG0017552	1	2	1	0	1	1	1	7
OG0017553	1	1	1	1	1	1	1	7
OG0017554	2	2	1	0	1	0	1	7
OG0017555	2	1	1	0	1	1	1	7
OG0017556	1	1	1	1	1	1	1	7
OG0017557	2	1	1	1	1	1	0	7
OG0017558	2	0	1	1	1	1	1	7
OG0017559	7	0	0	0	0	0	0	7
OG0017560	1	2	1	0	1	1	1	7
OG0017561	1	1	1	1	1	1	1	7
OG0017562	2	1	1	0	1	1	1	7
OG0017563	1	1	1	1	1	1	1	7
OG0017564	1	2	0	1	0	3	0	7
OG0017565	2	0	1	1	1	1	1	7
OG0017566	3	0	0	1	1	1	1	7
OG0017567	1	2	1	1	0	1	1	7
OG0017568	1	3	1	0	1	1	0	7
OG0017569	2	0	1	1	1	1	1	7
OG0017570	1	2	1	1	1	1	0	7
OG0017571	2	1	1	1	0	1	1	7
OG0017572	2	1	1	1	1	0	1	7
OG0017573	1	1	1	1	1	1	1	7
OG0017574	2	2	1	1	0	0	1	7
OG0017575	2	0	1	1	1	1	1	7
OG0017576	1	1	1	1	1	1	1	7
OG0017577	1	3	1	1	0	0	1	7
OG0017578	2	2	1	1	0	0	1	7
OG0017579	1	2	1	1	0	1	1	7
OG0017580	2	0	1	1	1	1	1	7
OG0017581	2	1	1	1	1	0	1	7
OG0017582	1	1	1	1	1	1	1	7
OG0017583	2	0	1	1	1	1	1	7
OG0017584	1	2	1	0	1	1	1	7
OG0017585	2	1	1	0	1	1	1	7
OG0017586	1	2	1	1	1	0	1	7
OG0017587	1	2	1	1	1	0	1	7
OG0017588	1	0	1	1	1	2	1	7
OG0017589	1	2	1	0	1	1	1	7
OG0017590	1	2	1	0	1	1	1	7
OG0017591	2	0	1	1	1	1	1	7
OG0017592	2	1	1	1	1	1	0	7
OG0017593	1	1	1	1	1	1	1	7
OG0017594	2	1	1	1	1	0	1	7
OG0017595	2	1	1	0	1	1	1	7
OG0017596	2	3	0	1	0	0	1	7
OG0017597	2	0	1	1	1	1	1	7
OG0017598	7	0	0	0	0	0	0	7
OG0017599	2	1	1	1	0	1	1	7
OG0017600	1	1	1	1	1	1	1	7
OG0017601	1	2	1	1	1	1	0	7
OG0017602	1	1	1	1	1	1	1	7
OG0017603	2	1	1	1	0	1	1	7
OG0017604	5	0	1	0	1	0	0	7
OG0017605	1	1	1	1	1	1	1	7
OG0017606	1	1	1	1	1	1	1	7
OG0017607	1	1	1	1	1	1	1	7
OG0017608	1	2	1	0	1	1	1	7
OG0017609	2	2	1	1	1	0	0	7
OG0017610	2	1	1	1	1	0	1	7
OG0017611	1	1	1	1	1	1	1	7
OG0017612	2	1	1	1	1	0	1	7
OG0017613	1	1	1	1	1	1	1	7
OG0017614	2	2	1	0	1	1	0	7
OG0017615	1	1	1	1	1	1	1	7
OG0017616	1	1	1	1	1	1	1	7
OG0017617	1	1	1	1	1	1	1	7
OG0017618	2	1	1	0	1	1	1	7
OG0017619	2	1	1	1	1	0	1	7
OG0017620	2	2	1	1	1	0	0	7
OG0017621	2	2	1	0	0	1	1	7
OG0017622	1	2	1	1	0	1	1	7
OG0017623	2	2	1	1	0	0	1	7
OG0017624	2	2	1	0	0	1	1	7
OG0017625	2	1	1	0	1	1	1	7
OG0017626	1	3	1	0	1	0	1	7
OG0017627	1	2	1	1	1	0	1	7
OG0017628	7	0	0	0	0	0	0	7
OG0017629	2	1	1	1	1	1	0	7
OG0017630	1	1	1	1	1	1	1	7
OG0017631	1	1	1	0	1	2	1	7
OG0017632	1	1	1	1	1	1	1	7
OG0017633	1	3	1	1	0	1	0	7
OG0017634	1	1	1	1	1	1	1	7
OG0017635	1	5	1	0	0	0	0	7
OG0017636	2	0	1	1	1	1	1	7
OG0017637	2	1	1	1	1	0	1	7
OG0017638	2	2	1	0	0	1	1	7
OG0017639	1	1	1	1	0	2	1	7
OG0017640	1	1	1	1	1	1	1	7
OG0017641	7	0	0	0	0	0	0	7
OG0017642	2	1	1	1	1	1	0	7
OG0017643	2	0	1	1	1	1	1	7
OG0017644	2	1	1	1	1	0	1	7
OG0017645	7	0	0	0	0	0	0	7
OG0017646	1	4	1	0	1	0	0	7
OG0017647	1	1	1	0	1	1	2	7
OG0017648	2	0	1	1	1	1	1	7
OG0017649	1	1	1	1	1	1	1	7
OG0017650	2	1	1	1	1	0	1	7
OG0017651	1	3	0	1	1	0	1	7
OG0017652	2	1	1	1	1	0	1	7
OG0017653	2	2	0	1	1	0	1	7
OG0017654	1	1	1	1	1	1	1	7
OG0017655	2	1	1	1	1	1	0	7
OG0017656	2	2	1	0	0	1	1	7
OG0017657	1	1	1	1	1	1	1	7
OG0017658	2	1	1	1	1	0	1	7
OG0017659	2	2	1	1	1	0	0	7
OG0017660	1	1	1	1	1	1	1	7
OG0017661	7	0	0	0	0	0	0	7
OG0017662	1	3	1	0	0	1	1	7
OG0017663	2	1	1	1	1	1	0	7
OG0017664	1	2	1	1	1	1	0	7
OG0017665	1	1	1	1	1	1	1	7
OG0017666	2	0	1	1	1	1	1	7
OG0017667	2	0	1	1	1	1	1	7
OG0017668	2	0	1	1	1	1	1	7
OG0017669	1	1	1	1	1	1	1	7
OG0017670	2	0	1	1	1	1	1	7
OG0017671	1	2	1	0	1	1	1	7
OG0017672	1	1	1	1	1	1	1	7
OG0017673	2	4	1	0	0	0	0	7
OG0017674	1	1	1	1	1	1	1	7
OG0017675	2	1	1	1	1	0	1	7
OG0017676	2	1	1	1	1	1	0	7
OG0017677	1	0	1	2	1	1	1	7
OG0017678	2	0	1	1	1	1	1	7
OG0017679	2	2	1	0	0	1	1	7
OG0017680	2	4	1	0	0	0	0	7
OG0017681	1	2	1	1	1	0	1	7
OG0017682	2	2	1	1	0	0	1	7
OG0017683	2	0	1	1	1	1	1	7
OG0017684	1	1	1	1	1	1	1	7
OG0017685	1	3	1	1	0	1	0	7
OG0017686	1	1	1	0	0	2	2	7
OG0017687	7	0	0	0	0	0	0	7
OG0017688	1	3	1	0	1	1	0	7
OG0017689	2	2	1	1	0	1	0	7
OG0017690	2	1	1	1	0	1	1	7
OG0017691	2	1	1	1	0	1	1	7
OG0017692	1	3	1	1	0	0	1	7
OG0017693	2	3	1	1	0	0	0	7
OG0017694	1	1	1	1	1	1	1	7
OG0017695	2	1	1	0	1	1	1	7
OG0017696	2	3	1	0	1	0	0	7
OG0017697	3	3	0	1	0	0	0	7
OG0017698	1	2	1	1	1	0	1	7
OG0017699	1	0	5	0	0	0	1	7
OG0017700	1	2	1	1	1	1	0	7
OG0017701	1	3	1	0	1	0	1	7
OG0017702	1	2	0	1	1	1	1	7
OG0017703	3	0	1	1	1	0	1	7
OG0017704	1	2	2	1	0	1	0	7
OG0017705	7	0	0	0	0	0	0	7
OG0017706	2	0	1	1	1	1	1	7
OG0017707	1	2	1	1	1	1	0	7
OG0017708	1	1	1	1	1	1	1	7
OG0017709	1	1	1	1	1	1	1	7
OG0017710	1	3	1	0	0	1	1	7
OG0017711	1	1	1	1	1	1	1	7
OG0017712	1	1	1	1	1	1	1	7
OG0017713	2	1	1	1	0	1	1	7
OG0017714	2	0	1	1	1	1	1	7
OG0017715	1	1	1	1	1	1	1	7
OG0017716	2	4	1	0	0	0	0	7
OG0017717	2	3	1	0	0	1	0	7
OG0017718	2	2	1	0	1	0	1	7
OG0017719	2	0	1	1	1	1	1	7
OG0017720	1	2	1	1	0	0	2	7
OG0017721	2	1	1	0	1	1	1	7
OG0017722	1	1	1	1	1	1	1	7
OG0017723	1	2	1	1	1	0	1	7
OG0017724	2	1	1	1	1	0	1	7
OG0017725	2	1	1	1	1	0	1	7
OG0017726	2	1	1	1	1	0	1	7
OG0017727	1	1	1	1	1	1	1	7
OG0017728	2	1	1	0	1	1	1	7
OG0017729	1	2	1	1	1	0	1	7
OG0017730	6	0	1	0	0	0	0	7
OG0017731	1	1	1	1	1	1	1	7
OG0017732	7	0	0	0	0	0	0	7
OG0017733	2	0	1	1	1	1	1	7
OG0017734	2	1	1	1	0	1	1	7
OG0017735	1	1	1	1	1	1	1	7
OG0017736	1	3	1	1	1	0	0	7
OG0017737	1	1	1	1	1	1	1	7
OG0017738	1	1	1	1	1	1	1	7
OG0017739	1	1	1	1	1	1	1	7
OG0017740	1	2	1	1	1	0	1	7
OG0017741	3	0	1	1	1	1	0	7
OG0017742	7	0	0	0	0	0	0	7
OG0017743	7	0	0	0	0	0	0	7
OG0017744	2	1	1	1	0	1	1	7
OG0017745	2	1	1	1	0	1	1	7
OG0017746	1	1	1	1	1	1	1	7
OG0017747	1	2	1	1	1	0	1	7
OG0017748	1	2	1	1	0	0	2	7
OG0017749	2	2	1	1	0	1	0	7
OG0017750	1	1	1	1	0	2	1	7
OG0017751	1	1	1	1	1	1	1	7
OG0017752	1	3	1	0	0	1	1	7
OG0017753	3	1	1	0	0	1	1	7
OG0017754	2	1	1	0	1	1	1	7
OG0017755	1	1	1	1	1	1	1	7
OG0017756	1	1	1	1	1	1	1	7
OG0017757	1	3	1	1	0	0	1	7
OG0017758	2	0	1	1	1	1	1	7
OG0017759	1	2	1	1	1	0	1	7
OG0017760	1	1	1	1	1	1	1	7
OG0017761	1	3	1	0	0	1	1	7
OG0017762	2	2	1	1	0	0	1	7
OG0017763	2	1	1	1	0	1	1	7
OG0017764	1	1	1	1	1	1	1	7
OG0017765	1	1	1	1	1	1	1	7
OG0017766	1	3	1	0	1	1	0	7
OG0017767	1	1	1	1	1	1	1	7
OG0017768	1	1	1	1	1	1	1	7
OG0017769	2	3	2	0	0	0	0	7
OG0017770	2	2	1	1	0	0	1	7
OG0017771	2	3	1	0	0	0	1	7
OG0017772	1	1	1	1	1	1	1	7
OG0017773	1	1	1	1	1	1	1	7
OG0017774	1	1	1	1	1	1	1	7
OG0017775	1	3	0	0	1	0	2	7
OG0017776	2	0	1	0	1	1	2	7
OG0017777	1	2	1	0	1	1	1	7
OG0017778	2	3	1	0	1	0	0	7
OG0017779	1	1	1	1	1	1	1	7
OG0017780	1	2	1	1	1	1	0	7
OG0017781	1	1	1	1	0	2	1	7
OG0017782	3	0	0	1	1	2	0	7
OG0017783	2	0	1	1	1	1	1	7
OG0017784	1	1	1	1	1	1	1	7
OG0017785	1	1	1	1	1	1	1	7
OG0017786	1	1	1	1	1	1	1	7
OG0017787	2	1	1	0	1	1	1	7
OG0017788	2	1	1	0	0	1	2	7
OG0017789	2	3	1	0	0	0	1	7
OG0017790	1	2	1	1	0	1	1	7
OG0017791	2	0	1	1	1	1	1	7
OG0017792	1	2	1	1	1	0	1	7
OG0017793	2	1	1	1	1	0	1	7
OG0017794	1	1	1	1	1	1	1	7
OG0017795	1	1	1	1	1	1	1	7
OG0017796	2	2	1	1	0	0	1	7
OG0017797	1	4	1	0	0	0	1	7
OG0017798	1	1	1	1	1	1	1	7
OG0017799	1	2	1	0	1	1	1	7
OG0017800	2	1	1	1	1	0	1	7
OG0017801	1	1	1	1	1	1	1	7
OG0017802	1	1	1	1	1	1	1	7
OG0017803	2	1	1	1	1	0	1	7
OG0017804	1	2	1	1	1	0	1	7
OG0017805	1	1	1	1	1	1	1	7
OG0017806	1	3	1	0	0	1	1	7
OG0017807	1	1	1	1	1	1	1	7
OG0017808	2	2	1	0	0	1	1	7
OG0017809	2	0	1	1	1	0	2	7
OG0017810	2	1	1	1	0	1	1	7
OG0017811	2	2	1	0	1	1	0	7
OG0017812	1	0	1	1	1	1	2	7
OG0017813	1	1	1	1	1	1	1	7
OG0017814	1	2	0	1	1	0	2	7
OG0017815	2	2	1	1	1	0	0	7
OG0017816	2	3	1	0	0	0	1	7
OG0017817	1	1	1	1	1	1	1	7
OG0017818	1	3	2	0	0	1	0	7
OG0017819	2	1	1	1	0	1	1	7
OG0017820	1	2	1	1	1	1	0	7
OG0017821	1	1	1	1	1	1	1	7
OG0017822	1	1	1	1	1	1	1	7
OG0017823	2	2	1	1	0	0	1	7
OG0017824	1	1	1	1	1	1	1	7
OG0017825	1	1	1	1	1	0	2	7
OG0017826	2	0	1	1	1	1	1	7
OG0017827	1	2	1	1	0	1	1	7
OG0017828	2	2	1	0	0	1	1	7
OG0017829	7	0	0	0	0	0	0	7
OG0017830	1	1	1	1	1	1	1	7
OG0017831	1	2	0	0	0	4	0	7
OG0017832	1	1	1	1	1	1	1	7
OG0017833	1	1	1	1	1	1	1	7
OG0017834	1	6	0	0	0	0	0	7
OG0017835	2	2	1	1	0	1	0	7
OG0017836	2	1	1	1	1	1	0	7
OG0017837	1	2	1	1	0	1	1	7
OG0017838	1	0	1	1	1	2	1	7
OG0017839	1	1	1	1	1	1	1	7
OG0017840	1	1	1	1	1	1	1	7
OG0017841	2	0	1	1	1	1	1	7
OG0017842	1	0	1	1	1	1	2	7
OG0017843	1	6	0	0	0	0	0	7
OG0017844	2	0	1	1	1	1	1	7
OG0017845	7	0	0	0	0	0	0	7
OG0017846	1	1	1	1	1	1	1	7
OG0017847	1	4	1	0	0	0	1	7
OG0017848	2	1	1	1	0	1	1	7
OG0017849	1	1	1	1	1	1	1	7
OG0017850	2	1	1	1	1	1	0	7
OG0017851	1	0	1	1	1	2	1	7
OG0017852	3	3	1	0	0	0	0	7
OG0017853	2	0	1	1	1	1	1	7
OG0017854	1	1	1	1	1	1	1	7
OG0017855	2	2	1	0	1	0	1	7
OG0017856	2	1	1	1	1	1	0	7
OG0017857	1	0	0	3	1	2	0	7
OG0017858	2	0	1	1	1	1	1	7
OG0017859	2	2	1	0	1	0	1	7
OG0017860	2	1	1	1	1	0	1	7
OG0017861	1	1	1	1	1	1	1	7
OG0017862	1	1	1	1	1	1	1	7
OG0017863	1	2	1	1	0	1	1	7
OG0017864	1	2	1	1	1	0	1	7
OG0017865	1	2	1	1	1	0	1	7
OG0017866	1	1	1	1	1	1	1	7
OG0017867	1	2	1	1	1	1	0	7
OG0017868	3	2	0	0	0	1	1	7
OG0017869	2	2	1	1	1	0	0	7
OG0017870	2	0	2	1	1	0	1	7
OG0017871	1	1	1	1	1	1	1	7
OG0017872	2	0	1	1	1	1	1	7
OG0017873	1	2	1	1	1	1	0	7
OG0017874	1	1	1	1	1	1	1	7
OG0017875	1	2	1	1	1	0	1	7
OG0017876	1	1	1	1	1	1	1	7
OG0017877	2	1	1	1	1	0	1	7
OG0017878	1	4	1	0	0	0	1	7
OG0017879	2	0	1	1	1	1	1	7
OG0017880	1	3	1	0	1	0	1	7
OG0017881	1	2	1	1	1	0	1	7
OG0017882	1	1	1	1	1	1	1	7
OG0017883	1	1	1	1	1	1	1	7
OG0017884	2	1	1	1	1	1	0	7
OG0017885	2	0	1	1	1	1	1	7
OG0017886	1	1	1	1	1	1	1	7
OG0017887	2	3	1	0	0	0	1	7
OG0017888	2	0	1	1	1	1	1	7
OG0017889	2	0	1	1	1	1	1	7
OG0017890	1	1	1	1	1	1	1	7
OG0017891	2	3	1	0	0	0	1	7
OG0017892	2	4	0	0	1	0	0	7
OG0017893	1	1	1	1	1	1	1	7
OG0017894	1	1	1	1	1	1	1	7
OG0017895	1	1	1	1	1	1	1	7
OG0017896	2	2	0	1	1	1	0	7
OG0017897	1	1	1	1	1	1	1	7
OG0017898	1	1	1	1	1	1	1	7
OG0017899	1	1	1	1	1	1	1	7
OG0017900	2	2	1	0	1	1	0	7
OG0017901	2	0	1	1	1	1	1	7
OG0017902	1	2	0	0	2	1	1	7
OG0017903	1	3	1	1	0	0	1	7
OG0017904	1	2	1	1	0	1	1	7
OG0017905	3	1	1	0	0	1	1	7
OG0017906	1	0	1	1	1	1	2	7
OG0017907	2	1	0	1	1	1	1	7
OG0017908	1	4	0	0	0	1	1	7
OG0017909	1	1	1	1	1	1	1	7
OG0017910	1	1	1	1	1	1	1	7
OG0017911	2	0	1	1	1	1	1	7
OG0017912	1	2	1	1	1	0	1	7
OG0017913	7	0	0	0	0	0	0	7
OG0017914	1	1	1	0	1	2	1	7
OG0017915	1	3	1	1	0	1	0	7
OG0017916	1	3	1	0	0	1	1	7
OG0017917	1	2	1	1	1	1	0	7
OG0017918	2	2	1	1	0	1	0	7
OG0017919	1	2	1	1	1	1	0	7
OG0017920	2	1	1	0	1	1	1	7
OG0017921	2	1	1	1	0	1	1	7
OG0017922	2	1	1	0	1	1	1	7
OG0017923	1	2	1	1	0	1	1	7
OG0017924	2	1	1	1	1	1	0	7
OG0017925	1	1	1	1	1	1	1	7
OG0017926	1	1	1	1	1	1	1	7
OG0017927	1	1	1	1	1	1	1	7
OG0017928	2	1	1	0	1	1	1	7
OG0017929	2	0	1	1	1	1	1	7
OG0017930	1	1	1	1	1	1	1	7
OG0017931	1	1	1	1	1	1	1	7
OG0017932	2	0	1	1	1	1	1	7
OG0017933	1	2	1	1	1	0	1	7
OG0017934	3	0	0	1	0	1	2	7
OG0017935	2	0	1	1	1	1	1	7
OG0017936	1	3	1	1	0	0	1	7
OG0017937	2	0	1	1	1	1	1	7
OG0017938	1	1	1	1	1	1	1	7
OG0017939	1	1	1	1	1	1	1	7
OG0017940	2	0	1	1	1	1	1	7
OG0017941	1	3	0	1	2	0	0	7
OG0017942	1	2	1	1	0	1	1	7
OG0017943	1	1	1	1	1	2	0	7
OG0017944	2	3	1	0	0	0	1	7
OG0017945	7	0	0	0	0	0	0	7
OG0017946	1	2	1	1	1	1	0	7
OG0017947	1	2	1	1	1	0	1	7
OG0017948	1	5	0	0	0	0	1	7
OG0017949	1	1	1	1	1	1	1	7
OG0017950	2	1	1	1	1	0	1	7
OG0017951	1	1	1	1	1	1	1	7
OG0017952	1	4	1	0	0	0	1	7
OG0017953	2	2	1	0	1	0	1	7
OG0017954	2	0	1	1	1	1	1	7
OG0017955	1	1	1	1	1	1	1	7
OG0017956	1	3	0	1	1	0	1	7
OG0017957	2	1	1	0	1	1	1	7
OG0017958	2	0	1	1	1	1	1	7
OG0017959	1	1	1	1	1	1	1	7
OG0017960	1	1	1	1	1	1	1	7
OG0017961	1	0	1	1	1	1	2	7
OG0017962	1	1	1	1	1	1	1	7
OG0017963	1	3	1	1	1	0	0	7
OG0017964	2	0	1	1	1	1	1	7
OG0017965	1	2	1	1	0	1	1	7
OG0017966	2	1	1	1	0	1	1	7
OG0017967	1	1	1	1	1	1	1	7
OG0017968	2	2	1	1	0	0	1	7
OG0017969	2	0	1	1	1	1	1	7
OG0017970	2	0	1	1	1	1	1	7
OG0017971	1	1	1	1	1	1	1	7
OG0017972	1	1	1	1	1	1	1	7
OG0017973	1	1	1	1	1	1	1	7
OG0017974	1	1	1	1	1	1	1	7
OG0017975	2	1	1	1	0	1	1	7
OG0017976	1	2	1	0	1	1	1	7
OG0017977	1	1	1	1	1	1	1	7
OG0017978	2	2	1	1	0	0	1	7
OG0017979	2	1	1	0	1	1	1	7
OG0017980	1	5	0	0	0	0	1	7
OG0017981	1	1	1	1	1	1	1	7
OG0017982	2	1	1	1	1	1	0	7
OG0017983	2	2	1	0	0	1	1	7
OG0017984	2	0	1	1	1	1	1	7
OG0017985	1	3	1	0	0	1	1	7
OG0017986	1	2	1	1	1	0	1	7
OG0017987	1	2	1	1	1	1	0	7
OG0017988	1	2	1	1	0	1	1	7
OG0017989	1	2	1	1	1	1	0	7
OG0017990	1	1	1	0	1	1	2	7
OG0017991	1	3	1	1	0	0	1	7
OG0017992	1	2	1	1	0	1	1	7
OG0017993	2	0	1	1	1	1	1	7
OG0017994	2	0	1	1	1	1	1	7
OG0017995	1	2	1	1	1	1	0	7
OG0017996	1	3	1	1	0	0	1	7
OG0017997	1	1	1	1	1	1	1	7
OG0017998	2	1	1	1	0	1	1	7
OG0017999	1	1	1	1	1	1	1	7
OG0018000	1	2	1	1	0	1	1	7
OG0018001	3	3	1	0	0	0	0	7
OG0018002	1	1	1	1	1	1	1	7
OG0018003	1	1	1	1	1	1	1	7
OG0018004	1	1	1	1	1	1	1	7
OG0018005	1	2	1	1	1	0	1	7
OG0018006	1	2	1	1	0	1	1	7
OG0018007	2	0	1	1	1	1	1	7
OG0018008	2	2	1	1	0	0	1	7
OG0018009	2	0	1	1	1	1	1	7
OG0018010	1	1	1	1	1	1	1	7
OG0018011	2	4	1	0	0	0	0	7
OG0018012	1	4	1	0	0	0	1	7
OG0018013	1	2	1	0	1	1	1	7
OG0018014	1	1	1	1	0	1	2	7
OG0018015	2	0	1	1	1	1	1	7
OG0018016	2	0	1	1	1	1	1	7
OG0018017	1	1	1	1	1	1	1	7
OG0018018	1	2	0	1	1	2	0	7
OG0018019	1	2	1	0	1	1	1	7
OG0018020	1	1	1	1	1	1	1	7
OG0018021	1	2	1	1	1	1	0	7
OG0018022	1	1	1	1	1	1	1	7
OG0018023	1	2	1	1	1	0	1	7
OG0018024	2	0	1	1	1	1	1	7
OG0018025	1	1	1	1	1	1	1	7
OG0018026	2	3	1	0	0	0	1	7
OG0018027	1	1	1	1	1	1	1	7
OG0018028	1	4	1	0	1	0	0	7
OG0018029	1	4	1	1	0	0	0	7
OG0018030	2	2	0	1	1	0	1	7
OG0018031	2	2	1	0	1	0	1	7
OG0018032	1	2	1	1	1	1	0	7
OG0018033	2	1	1	1	1	1	0	7
OG0018034	2	0	1	1	1	1	1	7
OG0018035	2	2	1	0	1	0	1	7
OG0018036	1	2	1	0	1	1	1	7
OG0018037	1	2	0	1	1	1	1	7
OG0018038	2	3	1	0	0	0	1	7
OG0018039	1	1	1	1	1	1	1	7
OG0018040	2	1	1	1	0	1	1	7
OG0018041	1	2	1	1	1	1	0	7
OG0018042	1	1	1	1	1	1	1	7
OG0018043	1	3	1	0	0	1	1	7
OG0018044	1	2	1	1	1	0	1	7
OG0018045	1	1	1	1	1	1	1	7
OG0018046	1	1	1	1	1	1	1	7
OG0018047	2	1	1	1	1	1	0	7
OG0018048	1	1	1	1	1	1	1	7
OG0018049	1	1	1	1	1	1	1	7
OG0018050	1	1	1	1	1	1	1	7
OG0018051	1	1	1	1	1	1	1	7
OG0018052	1	4	1	1	0	0	0	7
OG0018053	1	1	1	1	1	1	1	7
OG0018054	1	2	1	1	1	1	0	7
OG0018055	1	1	1	1	1	1	1	7
OG0018056	2	1	1	0	1	1	1	7
OG0018057	1	1	1	1	1	1	1	7
OG0018058	1	1	1	1	1	0	2	7
OG0018059	1	3	0	1	0	0	2	7
OG0018060	1	1	1	1	1	1	1	7
OG0018061	1	1	1	1	1	1	1	7
OG0018062	1	2	1	1	1	0	1	7
OG0018063	1	1	1	1	1	1	1	7
OG0018064	2	0	1	1	1	1	1	7
OG0018065	1	1	1	1	1	1	1	7
OG0018066	1	1	1	1	1	1	1	7
OG0018067	1	2	1	1	1	1	0	7
OG0018068	2	1	1	1	1	0	1	7
OG0018069	2	1	0	1	1	1	1	7
OG0018070	1	3	1	0	0	0	2	7
OG0018071	2	1	1	1	0	1	1	7
OG0018072	1	3	1	0	1	1	0	7
OG0018073	1	3	1	0	0	1	1	7
OG0018074	1	1	1	1	1	1	1	7
OG0018075	1	3	1	1	0	0	1	7
OG0018076	1	3	1	0	0	0	2	7
OG0018077	1	1	1	1	1	1	1	7
OG0018078	1	1	1	1	1	1	1	7
OG0018079	2	0	1	1	1	1	1	7
OG0018080	1	1	1	1	1	1	1	7
OG0018081	1	1	1	1	1	1	1	7
OG0018082	1	1	1	1	1	1	1	7
OG0018083	1	2	1	0	1	1	1	7
OG0018084	2	0	1	1	1	1	1	7
OG0018085	1	1	1	1	0	1	2	7
OG0018086	1	1	1	1	1	1	1	7
OG0018087	1	1	1	1	1	1	1	7
OG0018088	2	1	1	1	1	0	1	7
OG0018089	1	3	1	1	0	0	1	7
OG0018090	1	1	1	1	1	1	1	7
OG0018091	2	0	1	1	1	1	1	7
OG0018092	1	1	1	1	1	1	1	7
OG0018093	1	1	1	1	1	1	1	7
OG0018094	1	1	1	1	1	1	1	7
OG0018095	1	2	1	1	1	0	1	7
OG0018096	1	1	1	1	1	1	1	7
OG0018097	1	1	1	1	1	1	1	7
OG0018098	1	1	1	1	1	1	1	7
OG0018099	1	1	1	1	1	1	1	7
OG0018100	1	2	1	0	1	1	1	7
OG0018101	1	1	1	1	1	1	1	7
OG0018102	1	3	1	0	1	0	1	7
OG0018103	2	1	1	0	1	1	1	7
OG0018104	1	4	0	1	1	0	0	7
OG0018105	2	2	1	1	1	0	0	7
OG0018106	1	2	1	1	1	1	0	7
OG0018107	1	1	1	1	1	1	1	7
OG0018108	1	3	1	1	0	0	1	7
OG0018109	1	1	1	1	1	1	1	7
OG0018110	2	2	1	0	0	1	1	7
OG0018111	1	1	1	1	1	1	1	7
OG0018112	1	1	1	1	1	1	1	7
OG0018113	1	1	0	0	2	2	1	7
OG0018114	1	2	1	1	1	0	1	7
OG0018115	1	1	1	1	1	1	1	7
OG0018116	1	0	1	1	1	1	2	7
OG0018117	1	1	1	1	1	1	1	7
OG0018118	2	3	1	0	0	0	1	7
OG0018119	1	1	1	1	1	1	1	7
OG0018120	1	2	1	1	1	1	0	7
OG0018121	1	1	1	1	1	1	1	7
OG0018122	1	1	1	1	1	1	1	7
OG0018123	1	1	1	1	1	1	1	7
OG0018124	2	2	0	0	1	1	1	7
OG0018125	1	2	1	1	1	0	1	7
OG0018126	1	2	1	1	1	0	1	7
OG0018127	1	3	1	1	0	0	1	7
OG0018128	1	1	1	1	1	1	1	7
OG0018129	1	1	1	1	1	1	1	7
OG0018130	1	3	1	0	1	0	1	7
OG0018131	1	2	1	1	1	1	0	7
OG0018132	3	0	2	0	1	0	1	7
OG0018133	1	1	1	1	1	1	1	7
OG0018134	1	2	1	0	1	1	1	7
OG0018135	1	2	1	0	1	1	1	7
OG0018136	2	1	1	1	0	1	1	7
OG0018137	2	0	1	1	1	0	2	7
OG0018138	2	0	1	1	1	1	1	7
OG0018139	2	2	1	1	0	0	1	7
OG0018140	1	4	1	0	0	0	1	7
OG0018141	1	2	1	0	1	1	1	7
OG0018142	2	1	1	1	1	0	1	7
OG0018143	1	2	1	0	1	1	1	7
OG0018144	1	1	1	1	1	1	1	7
OG0018145	1	3	0	0	1	0	2	7
OG0018146	2	0	1	1	1	1	1	7
OG0018147	1	1	1	1	1	1	1	7
OG0018148	2	2	1	1	0	0	1	7
OG0018149	2	1	1	0	1	1	1	7
OG0018150	1	1	1	1	1	1	1	7
OG0018151	1	2	1	1	0	1	1	7
OG0018152	1	5	1	0	0	0	0	7
OG0018153	1	1	1	1	1	1	1	7
OG0018154	1	2	0	1	1	1	1	7
OG0018155	1	1	1	1	1	1	1	7
OG0018156	1	1	1	0	2	1	1	7
OG0018157	1	1	1	1	1	1	1	7
OG0018158	1	1	1	1	1	1	1	7
OG0018159	2	1	1	1	1	0	1	7
OG0018160	2	1	1	1	0	1	1	7
OG0018161	2	0	1	1	1	1	1	7
OG0018162	1	1	1	1	1	1	1	7
OG0018163	1	1	0	1	0	2	2	7
OG0018164	1	1	1	1	1	1	1	7
OG0018165	1	2	1	0	1	1	1	7
OG0018166	1	1	1	1	1	1	1	7
OG0018167	2	1	1	1	1	1	0	7
OG0018168	1	2	1	1	1	1	0	7
OG0018169	1	2	1	0	1	1	1	7
OG0018170	1	1	1	1	1	1	1	7
OG0018171	2	2	0	1	1	1	0	7
OG0018172	2	0	1	1	1	1	1	7
OG0018173	1	1	1	1	1	1	1	7
OG0018174	1	1	1	1	1	1	1	7
OG0018175	1	1	0	3	1	1	0	7
OG0018176	1	1	1	1	1	1	1	7
OG0018177	1	2	1	1	1	1	0	7
OG0018178	1	2	0	1	0	0	3	7
OG0018179	1	1	1	1	1	1	1	7
OG0018180	2	0	1	1	1	1	1	7
OG0018181	1	1	1	1	1	1	1	7
OG0018182	2	1	1	0	1	1	1	7
OG0018183	1	1	1	1	1	1	1	7
OG0018184	1	3	1	0	1	1	0	7
OG0018185	1	1	1	1	1	1	1	7
OG0018186	1	1	1	1	1	1	1	7
OG0018187	1	2	1	1	0	1	1	7
OG0018188	1	1	1	1	1	1	1	7
OG0018189	1	3	1	0	1	1	0	7
OG0018190	1	4	0	0	0	0	2	7
OG0018191	1	2	1	1	0	1	1	7
OG0018192	1	2	1	1	1	0	1	7
OG0018193	1	3	1	0	0	0	2	7
OG0018194	2	2	1	1	0	0	1	7
OG0018195	1	1	1	1	1	1	1	7
OG0018196	1	2	1	1	1	1	0	7
OG0018197	1	2	1	1	0	1	1	7
OG0018198	1	1	0	1	1	3	0	7
OG0018199	1	2	1	1	0	1	1	7
OG0018200	2	1	1	0	1	1	1	7
OG0018201	1	1	1	1	1	1	1	7
OG0018202	1	1	1	1	1	1	1	7
OG0018203	1	1	1	1	1	1	1	7
OG0018204	1	2	1	1	0	1	1	7
OG0018205	1	2	1	1	1	0	1	7
OG0018206	1	1	1	1	1	1	1	7
OG0018207	1	3	1	1	0	0	1	7
OG0018208	2	2	1	1	0	1	0	7
OG0018209	1	2	1	1	0	1	1	7
OG0018210	2	0	1	1	1	1	1	7
OG0018211	1	2	1	1	0	1	1	7
OG0018212	1	1	1	1	1	1	1	7
OG0018213	1	1	1	1	1	1	1	7
OG0018214	1	1	1	1	1	1	1	7
OG0018215	1	1	1	1	1	1	1	7
OG0018216	1	3	1	1	0	1	0	7
OG0018217	1	2	1	1	1	1	0	7
OG0018218	1	1	1	1	1	1	1	7
OG0018219	1	1	1	1	1	1	1	7
OG0018220	1	2	0	0	1	1	2	7
OG0018221	1	1	1	1	1	1	1	7
OG0018222	1	1	1	1	1	1	1	7
OG0018223	2	0	1	1	1	1	1	7
OG0018224	1	1	1	1	1	1	1	7
OG0018225	1	1	1	1	1	1	1	7
OG0018226	1	1	1	1	1	1	1	7
OG0018227	2	3	1	0	0	0	1	7
OG0018228	1	1	1	1	1	1	1	7
OG0018229	1	0	2	1	1	1	1	7
OG0018230	1	1	1	1	1	1	1	7
OG0018231	1	1	1	1	1	1	1	7
OG0018232	1	2	1	1	1	0	1	7
OG0018233	2	2	1	1	0	0	1	7
OG0018234	1	2	0	1	1	1	1	7
OG0018235	1	1	1	1	1	1	1	7
OG0018236	1	1	1	1	1	1	1	7
OG0018237	2	0	1	1	1	1	1	7
OG0018238	1	3	1	1	0	0	1	7
OG0018239	1	2	1	1	1	0	1	7
OG0018240	1	1	1	1	1	1	1	7
OG0018241	1	1	1	1	1	1	1	7
OG0018242	1	2	1	1	1	0	1	7
OG0018243	1	2	0	1	0	1	2	7
OG0018244	1	2	1	1	0	1	1	7
OG0018245	2	4	1	0	0	0	0	7
OG0018246	1	1	1	1	1	1	1	7
OG0018247	2	2	1	1	1	0	0	7
OG0018248	1	1	1	1	1	1	1	7
OG0018249	1	2	1	1	1	0	1	7
OG0018250	1	2	1	0	1	1	1	7
OG0018251	1	2	1	0	1	1	1	7
OG0018252	1	1	1	1	1	1	1	7
OG0018253	1	1	1	1	1	1	1	7
OG0018254	1	1	1	1	1	1	1	7
OG0018255	1	1	1	1	1	1	1	7
OG0018256	1	2	1	1	0	1	1	7
OG0018257	1	1	1	1	1	1	1	7
OG0018258	1	1	1	1	1	1	1	7
OG0018259	1	1	1	1	1	1	1	7
OG0018260	1	1	1	1	1	1	1	7
OG0018261	2	2	1	1	1	0	0	7
OG0018262	1	1	1	1	1	1	1	7
OG0018263	1	2	1	0	1	1	1	7
OG0018264	1	1	1	1	1	1	1	7
OG0018265	1	3	0	1	1	0	1	7
OG0018266	1	1	1	1	1	1	1	7
OG0018267	1	1	1	1	1	1	1	7
OG0018268	1	6	0	0	0	0	0	7
OG0018269	1	3	1	1	0	0	1	7
OG0018270	1	0	1	2	1	1	1	7
OG0018271	1	1	1	1	1	1	1	7
OG0018272	1	2	1	1	0	1	1	7
OG0018273	1	2	1	1	1	0	1	7
OG0018274	1	1	0	0	2	2	1	7
OG0018275	2	1	1	0	1	1	1	7
OG0018276	2	2	1	1	0	0	1	7
OG0018277	1	1	1	1	1	1	1	7
OG0018278	1	2	1	1	0	1	1	7
OG0018279	1	1	1	1	1	1	1	7
OG0018280	1	3	1	0	0	1	1	7
OG0018281	2	0	1	1	1	1	1	7
OG0018282	1	1	1	1	1	1	1	7
OG0018283	2	1	1	1	1	1	0	7
OG0018284	1	1	1	1	1	1	1	7
OG0018285	1	1	1	1	1	1	1	7
OG0018286	1	1	1	1	1	1	1	7
OG0018287	1	2	1	1	1	1	0	7
OG0018288	1	2	1	1	0	1	1	7
OG0018289	1	1	2	0	1	1	1	7
OG0018290	1	4	1	0	0	0	1	7
OG0018291	1	2	1	1	1	0	1	7
OG0018292	1	2	1	1	0	1	1	7
OG0018293	1	3	1	0	0	1	1	7
OG0018294	1	0	1	1	1	1	2	7
OG0018295	1	2	1	1	1	0	1	7
OG0018296	1	5	0	1	0	0	0	7
OG0018297	1	1	1	1	1	1	1	7
OG0018298	1	1	1	1	1	1	1	7
OG0018299	1	3	1	1	1	0	0	7
OG0018300	1	4	1	0	0	0	1	7
OG0018301	1	1	1	1	1	1	1	7
OG0018302	1	1	1	1	1	1	1	7
OG0018303	1	1	1	1	1	1	1	7
OG0018304	2	2	1	0	1	1	0	7
OG0018305	1	2	0	1	1	1	1	7
OG0018306	1	2	1	1	1	0	1	7
OG0018307	1	2	0	1	1	1	1	7
OG0018308	1	1	1	1	1	1	1	7
OG0018309	1	1	1	1	1	1	1	7
OG0018310	1	1	1	1	1	1	1	7
OG0018311	1	1	1	1	1	1	1	7
OG0018312	1	2	1	0	1	1	1	7
OG0018313	1	2	1	0	1	1	1	7
OG0018314	1	1	1	1	1	1	1	7
OG0018315	1	1	1	1	1	1	1	7
OG0018316	1	3	1	0	0	1	1	7
OG0018317	1	1	1	1	1	1	1	7
OG0018318	1	3	1	1	0	0	1	7
OG0018319	1	1	1	1	1	1	1	7
OG0018320	1	1	1	1	1	1	1	7
OG0018321	1	1	1	1	1	1	1	7
OG0018322	1	1	1	1	1	1	1	7
OG0018323	1	1	1	1	1	1	1	7
OG0018324	1	2	1	1	1	0	1	7
OG0018325	1	1	1	1	1	1	1	7
OG0018326	1	2	1	1	0	1	1	7
OG0018327	1	1	1	1	1	1	1	7
OG0018328	1	2	1	1	1	0	1	7
OG0018329	1	1	1	1	1	1	1	7
OG0018330	1	2	1	1	1	0	1	7
OG0018331	1	1	1	1	1	1	1	7
OG0018332	2	0	1	1	1	1	1	7
OG0018333	1	2	1	0	1	1	1	7
OG0018334	1	1	1	1	1	1	1	7
OG0018335	1	3	1	1	0	1	0	7
OG0018336	1	1	1	0	1	1	2	7
OG0018337	1	1	1	1	1	1	1	7
OG0018338	2	2	0	0	1	1	1	7
OG0018339	1	3	1	1	0	1	0	7
OG0018340	1	3	1	0	0	1	1	7
OG0018341	1	2	1	1	0	0	2	7
OG0018342	1	3	1	1	1	0	0	7
OG0018343	1	2	1	1	0	1	1	7
OG0018344	1	1	1	1	1	1	1	7
OG0018345	1	1	1	1	1	1	1	7
OG0018346	1	1	1	1	1	1	1	7
OG0018347	1	2	1	1	1	1	0	7
OG0018348	1	3	1	1	0	0	1	7
OG0018349	1	3	1	1	0	0	1	7
OG0018350	1	2	1	1	1	0	1	7
OG0018351	1	6	0	0	0	0	0	7
OG0018352	1	2	1	1	1	0	1	7
OG0018353	1	1	1	1	1	1	1	7
OG0018354	0	2	1	1	1	1	1	7
OG0018355	0	3	1	1	1	0	1	7
OG0018356	0	7	0	0	0	0	0	7
OG0018357	0	7	0	0	0	0	0	7
OG0018358	0	7	0	0	0	0	0	7
OG0018359	0	5	0	0	0	0	2	7
OG0018360	0	5	1	0	1	0	0	7
OG0018361	0	5	0	2	0	0	0	7
OG0018362	0	3	1	0	1	1	1	7
OG0018363	0	3	1	1	1	0	1	7
OG0018364	0	7	0	0	0	0	0	7
OG0018365	0	4	0	0	0	0	3	7
OG0018366	0	3	2	1	1	0	0	7
OG0018367	0	7	0	0	0	0	0	7
OG0018368	0	7	0	0	0	0	0	7
OG0018369	0	6	0	0	0	1	0	7
OG0018370	0	2	0	1	2	1	1	7
OG0018371	0	4	1	1	0	1	0	7
OG0018372	0	4	0	0	0	1	2	7
OG0018373	0	3	1	1	1	1	0	7
OG0018374	0	4	1	0	1	0	1	7
OG0018375	0	3	1	0	1	1	1	7
OG0018376	0	3	1	0	0	1	2	7
OG0018377	0	4	0	0	1	1	1	7
OG0018378	0	3	1	0	1	1	1	7
OG0018379	0	3	1	1	0	1	1	7
OG0018380	0	6	0	0	0	0	1	7
OG0018381	0	2	1	1	1	1	1	7
OG0018382	0	2	0	1	1	1	2	7
OG0018383	0	5	0	1	1	0	0	7
OG0018384	0	4	0	0	1	1	1	7
OG0018385	0	2	1	0	0	1	3	7
OG0018386	0	5	0	0	0	1	1	7
OG0018387	0	3	1	1	1	1	0	7
OG0018388	0	1	1	1	1	1	2	7
OG0018389	0	3	0	0	0	0	4	7
OG0018390	0	4	0	0	0	0	3	7
OG0018391	0	3	1	1	1	1	0	7
OG0018392	0	3	1	1	1	1	0	7
OG0018393	0	3	1	1	1	1	0	7
OG0018394	0	2	1	1	1	1	1	7
OG0018395	0	2	1	1	1	1	1	7
OG0018396	0	3	0	1	1	1	1	7
OG0018397	0	2	1	2	0	1	1	7
OG0018398	0	2	1	2	0	1	1	7
OG0018399	0	3	1	1	0	0	2	7
OG0018400	0	3	1	1	1	1	0	7
OG0018401	0	2	1	1	1	1	1	7
OG0018402	0	7	0	0	0	0	0	7
OG0018403	0	7	0	0	0	0	0	7
OG0018404	0	6	1	0	0	0	0	7
OG0018405	0	5	0	1	1	0	0	7
OG0018406	0	1	0	1	2	0	3	7
OG0018407	0	4	1	0	1	0	1	7
OG0018408	0	7	0	0	0	0	0	7
OG0018409	0	3	1	1	1	0	1	7
OG0018410	0	2	1	1	1	1	1	7
OG0018411	0	4	0	0	1	1	1	7
OG0018412	0	3	1	1	0	1	1	7
OG0018413	0	5	0	1	1	0	0	7
OG0018414	0	2	1	1	1	1	1	7
OG0018415	0	6	0	1	0	0	0	7
OG0018416	0	7	0	0	0	0	0	7
OG0018417	0	2	1	1	1	1	1	7
OG0018418	0	4	0	1	2	0	0	7
OG0018419	0	3	0	1	1	1	1	7
OG0018420	0	3	0	0	2	1	1	7
OG0018421	0	2	1	1	1	1	1	7
OG0018422	0	2	0	0	0	0	5	7
OG0018423	0	5	0	0	0	0	2	7
OG0018424	0	2	1	1	1	1	1	7
OG0018425	0	2	1	1	1	1	1	7
OG0018426	0	2	1	1	1	1	1	7
OG0018427	0	2	1	1	1	1	1	7
OG0018428	0	2	1	1	1	1	1	7
OG0018429	0	6	0	1	0	0	0	7
OG0018430	0	3	1	1	0	1	1	7
OG0018431	0	2	1	1	1	1	1	7
OG0018432	0	3	1	1	0	1	1	7
OG0018433	0	2	1	1	1	1	1	7
OG0018434	0	4	1	1	1	0	0	7
OG0018435	0	3	1	1	1	0	1	7
OG0018436	0	3	1	1	1	0	1	7
OG0018437	0	2	1	1	1	1	1	7
OG0018438	0	3	1	1	1	1	0	7
OG0018439	0	4	0	0	2	0	1	7
OG0018440	0	7	0	0	0	0	0	7
OG0018441	0	2	1	1	1	1	1	7
OG0018442	0	7	0	0	0	0	0	7
OG0018443	0	3	0	1	1	1	1	7
OG0018444	0	2	1	1	1	1	1	7
OG0018445	0	5	0	1	0	1	0	7
OG0018446	0	5	0	1	1	0	0	7
OG0018447	0	4	0	1	1	1	0	7
OG0018448	0	4	1	0	1	0	1	7
OG0018449	0	4	2	1	0	0	0	7
OG0018450	0	2	1	1	1	1	1	7
OG0018451	0	2	1	0	0	1	3	7
OG0018452	0	3	0	2	2	0	0	7
OG0018453	0	2	1	1	1	1	1	7
OG0018454	0	3	0	1	0	0	3	7
OG0018455	0	5	0	1	1	0	0	7
OG0018456	0	3	0	1	3	0	0	7
OG0018457	0	3	0	1	1	0	2	7
OG0018458	0	3	1	1	1	1	0	7
OG0018459	0	2	1	1	1	1	1	7
OG0018460	0	2	0	1	2	1	1	7
OG0018461	0	5	0	1	1	0	0	7
OG0018462	0	6	0	0	0	1	0	7
OG0018463	0	4	1	0	1	0	1	7
OG0018464	0	4	1	0	0	0	2	7
OG0018465	0	3	1	0	1	1	1	7
OG0018466	0	1	0	2	0	2	2	7
OG0018467	0	4	0	1	0	1	1	7
OG0018468	0	6	0	1	0	0	0	7
OG0018469	0	2	1	1	1	1	1	7
OG0018470	0	3	0	0	1	2	1	7
OG0018471	0	7	0	0	0	0	0	7
OG0018472	0	2	1	1	1	1	1	7
OG0018473	0	3	1	1	1	1	0	7
OG0018474	0	2	1	1	1	1	1	7
OG0018475	0	3	1	0	1	1	1	7
OG0018476	0	2	1	0	1	1	2	7
OG0018477	0	2	1	1	1	1	1	7
OG0018478	0	4	0	1	1	1	0	7
OG0018479	0	3	0	1	1	1	1	7
OG0018480	0	2	1	1	1	1	1	7
OG0018481	0	3	1	1	1	0	1	7
OG0018482	0	3	1	1	1	1	0	7
OG0018483	0	2	0	1	1	2	1	7
OG0018484	0	2	1	1	1	1	1	7
OG0018485	0	2	1	1	1	1	1	7
OG0018486	0	3	1	1	1	1	0	7
OG0018487	0	3	1	1	1	1	0	7
OG0018488	0	2	1	0	2	1	1	7
OG0018489	0	5	0	1	0	1	0	7
OG0018490	0	3	1	1	0	2	0	7
OG0018491	0	3	1	0	1	1	1	7
OG0018492	0	6	0	0	0	1	0	7
OG0018493	0	1	0	2	1	2	1	7
OG0018494	0	3	0	1	1	1	1	7
OG0018495	0	4	1	1	1	0	0	7
OG0018496	0	2	1	1	1	1	1	7
OG0018497	0	5	0	0	1	0	1	7
OG0018498	0	4	1	1	0	0	1	7
OG0018499	0	5	0	1	1	0	0	7
OG0018500	0	3	1	0	1	1	1	7
OG0018501	0	3	1	0	1	1	1	7
OG0018502	0	5	0	1	1	0	0	7
OG0018503	0	4	1	1	1	0	0	7
OG0018504	0	2	1	1	1	1	1	7
OG0018505	0	7	0	0	0	0	0	7
OG0018506	0	4	1	0	1	0	1	7
OG0018507	0	3	1	1	1	1	0	7
OG0018508	0	6	1	0	0	0	0	7
OG0018509	0	3	1	0	1	1	1	7
OG0018510	0	4	1	1	1	0	0	7
OG0018511	0	2	1	1	1	1	1	7
OG0018512	0	2	1	1	1	1	1	7
OG0018513	0	1	2	1	1	1	1	7
OG0018514	0	5	0	0	0	1	1	7
OG0018515	0	2	1	1	1	1	1	7
OG0018516	0	2	1	1	1	1	1	7
OG0018517	0	2	1	1	1	1	1	7
OG0018518	0	2	1	1	1	1	1	7
OG0018519	0	4	0	0	0	1	2	7
OG0018520	0	2	1	0	2	0	2	7
OG0018521	0	3	2	1	0	1	0	7
OG0018522	0	2	1	1	1	1	1	7
OG0018523	0	2	1	1	1	1	1	7
OG0018524	0	2	1	1	1	1	1	7
OG0018525	0	5	1	0	1	0	0	7
OG0018526	0	2	1	1	1	1	1	7
OG0018527	0	2	1	1	1	1	1	7
OG0018528	0	2	1	1	1	1	1	7
OG0018529	0	3	1	1	1	0	1	7
OG0018530	0	6	0	0	1	0	0	7
OG0018531	0	2	1	1	1	1	1	7
OG0018532	0	2	1	1	1	1	1	7
OG0018533	0	2	1	1	1	1	1	7
OG0018534	0	5	0	1	0	0	1	7
OG0018535	0	2	1	1	1	1	1	7
OG0018536	0	6	0	0	0	1	0	7
OG0018537	0	7	0	0	0	0	0	7
OG0018538	0	3	0	1	1	1	1	7
OG0018539	0	6	0	0	1	0	0	7
OG0018540	0	2	0	1	1	1	2	7
OG0018541	0	3	1	0	0	1	2	7
OG0018542	0	2	1	1	1	1	1	7
OG0018543	0	2	1	1	1	1	1	7
OG0018544	0	2	1	1	1	1	1	7
OG0018545	0	4	0	0	1	1	1	7
OG0018546	0	3	1	0	1	1	1	7
OG0018547	0	7	0	0	0	0	0	7
OG0018548	0	3	0	0	1	2	1	7
OG0018549	0	3	1	1	0	1	1	7
OG0018550	0	2	1	0	1	3	0	7
OG0018551	0	2	1	1	1	1	1	7
OG0018552	0	3	1	1	1	1	0	7
OG0018553	0	2	1	1	1	1	1	7
OG0018554	0	7	0	0	0	0	0	7
OG0018555	0	2	1	1	1	1	1	7
OG0018556	0	6	1	0	0	0	0	7
OG0018557	0	2	1	1	1	1	1	7
OG0018558	0	7	0	0	0	0	0	7
OG0018559	0	2	1	1	1	1	1	7
OG0018560	0	5	0	1	0	0	1	7
OG0018561	0	7	0	0	0	0	0	7
OG0018562	0	2	1	1	1	1	1	7
OG0018563	0	3	1	1	0	1	1	7
OG0018564	0	4	1	1	0	0	1	7
OG0018565	0	6	0	0	0	1	0	7
OG0018566	0	3	1	1	0	1	1	7
OG0018567	0	5	1	1	0	0	0	7
OG0018568	0	7	0	0	0	0	0	7
OG0018569	0	3	0	0	1	2	1	7
OG0018570	0	3	1	1	1	1	0	7
OG0018571	0	4	0	0	1	1	1	7
OG0018572	0	7	0	0	0	0	0	7
OG0018573	0	4	0	1	2	0	0	7
OG0018574	0	4	1	2	0	0	0	7
OG0018575	0	7	0	0	0	0	0	7
OG0018576	0	2	1	1	2	0	1	7
OG0018577	0	2	1	1	1	1	1	7
OG0018578	0	3	0	1	0	0	3	7
OG0018579	0	3	0	1	1	1	1	7
OG0018580	0	2	1	1	1	1	1	7
OG0018581	0	2	1	1	1	1	1	7
OG0018582	0	2	1	1	1	1	1	7
OG0018583	0	3	1	0	1	1	1	7
OG0018584	0	2	1	1	1	1	1	7
OG0018585	0	3	0	1	1	1	1	7
OG0018586	0	3	1	1	1	1	0	7
OG0018587	0	7	0	0	0	0	0	7
OG0018588	0	4	1	0	0	1	1	7
OG0018589	0	4	0	0	2	0	1	7
OG0018590	0	1	1	0	0	1	4	7
OG0018591	0	5	2	0	0	0	0	7
OG0018592	0	4	0	1	0	1	1	7
OG0018593	0	2	1	1	1	1	1	7
OG0018594	0	4	0	1	1	0	1	7
OG0018595	0	5	0	1	1	0	0	7
OG0018596	0	4	1	0	0	1	1	7
OG0018597	0	2	1	1	1	1	1	7
OG0018598	0	4	0	1	0	1	1	7
OG0018599	0	4	0	1	1	0	1	7
OG0018600	0	3	1	1	1	1	0	7
OG0018601	0	3	0	2	1	0	1	7
OG0018602	0	3	1	1	1	1	0	7
OG0018603	0	3	0	1	2	1	0	7
OG0018604	0	3	1	2	1	0	0	7
OG0018605	0	3	0	3	1	0	0	7
OG0018606	0	3	0	1	1	1	1	7
OG0018607	0	4	1	1	0	0	1	7
OG0018608	0	3	0	0	2	1	1	7
OG0018609	0	4	1	1	1	0	0	7
OG0018610	0	2	1	1	1	1	1	7
OG0018611	0	2	1	1	1	1	1	7
OG0018612	0	4	0	0	1	1	1	7
OG0018613	0	5	0	0	1	0	1	7
OG0018614	0	3	1	1	1	1	0	7
OG0018615	0	3	1	1	1	0	1	7
OG0018616	0	2	1	1	1	1	1	7
OG0018617	0	2	1	1	1	1	1	7
OG0018618	0	5	0	1	1	0	0	7
OG0018619	0	5	1	1	0	0	0	7
OG0018620	0	4	1	1	0	1	0	7
OG0018621	0	3	1	0	1	1	1	7
OG0018622	0	2	1	1	1	1	1	7
OG0018623	0	2	1	1	1	1	1	7
OG0018624	0	3	0	1	1	1	1	7
OG0018625	0	2	1	1	1	1	1	7
OG0018626	0	2	1	1	1	1	1	7
OG0018627	0	2	1	1	1	1	1	7
OG0018628	0	2	1	1	1	1	1	7
OG0018629	0	4	0	1	0	1	1	7
OG0018630	0	3	1	0	1	1	1	7
OG0018631	0	2	1	1	1	1	1	7
OG0018632	0	6	0	0	1	0	0	7
OG0018633	0	2	1	1	1	1	1	7
OG0018634	0	2	1	1	1	1	1	7
OG0018635	0	2	1	1	1	1	1	7
OG0018636	0	2	1	1	1	1	1	7
OG0018637	0	3	1	1	1	1	0	7
OG0018638	0	2	1	1	1	1	1	7
OG0018639	0	5	0	0	0	1	1	7
OG0018640	0	2	1	1	1	1	1	7
OG0018641	0	3	1	1	1	1	0	7
OG0018642	0	3	1	1	1	1	0	7
OG0018643	0	7	0	0	0	0	0	7
OG0018644	0	2	1	1	1	1	1	7
OG0018645	0	7	0	0	0	0	0	7
OG0018646	0	3	1	1	1	0	1	7
OG0018647	0	5	0	0	0	1	1	7
OG0018648	0	6	0	0	0	0	1	7
OG0018649	0	4	1	1	1	0	0	7
OG0018650	0	7	0	0	0	0	0	7
OG0018651	0	6	0	0	0	0	1	7
OG0018652	0	3	0	1	1	1	1	7
OG0018653	0	2	1	1	1	1	1	7
OG0018654	0	3	0	0	1	1	2	7
OG0018655	0	4	0	2	1	0	0	7
OG0018656	0	4	0	1	1	1	0	7
OG0018657	0	2	1	1	1	1	1	7
OG0018658	0	7	0	0	0	0	0	7
OG0018659	0	2	1	1	1	1	1	7
OG0018660	0	1	0	0	0	0	6	7
OG0018661	0	3	1	0	1	1	1	7
OG0018662	0	4	1	0	1	0	1	7
OG0018663	0	7	0	0	0	0	0	7
OG0018664	0	6	1	0	0	0	0	7
OG0018665	0	2	1	1	1	1	1	7
OG0018666	0	6	0	0	0	0	1	7
OG0018667	0	1	2	1	1	1	1	7
OG0018668	0	5	0	0	0	0	2	7
OG0018669	0	5	0	1	1	0	0	7
OG0018670	0	4	0	1	1	1	0	7
OG0018671	0	2	1	1	1	1	1	7
OG0018672	0	3	1	1	0	1	1	7
OG0018673	0	2	1	1	1	1	1	7
OG0018674	0	5	0	1	0	1	0	7
OG0018675	0	3	1	0	1	1	1	7
OG0018676	0	4	0	1	0	1	1	7
OG0018677	0	3	1	1	0	0	2	7
OG0018678	0	3	1	0	1	1	1	7
OG0018679	0	2	1	1	1	1	1	7
OG0018680	0	2	0	1	2	1	1	7
OG0018681	0	2	0	0	1	2	2	7
OG0018682	0	3	1	0	1	1	1	7
OG0018683	0	2	1	1	1	1	1	7
OG0018684	0	2	1	1	1	1	1	7
OG0018685	0	2	1	1	1	1	1	7
OG0018686	0	2	1	1	1	1	1	7
OG0018687	0	5	1	1	0	0	0	7
OG0018688	0	2	1	1	1	1	1	7
OG0018689	0	3	1	0	1	1	1	7
OG0018690	0	4	1	1	0	1	0	7
OG0018691	0	3	1	0	1	1	1	7
OG0018692	0	2	1	1	1	1	1	7
OG0018693	0	3	1	1	1	1	0	7
OG0018694	0	2	1	1	1	1	1	7
OG0018695	0	4	1	1	0	1	0	7
OG0018696	0	2	1	1	1	1	1	7
OG0018697	0	4	1	1	0	1	0	7
OG0018698	0	3	0	0	0	1	3	7
OG0018699	0	7	0	0	0	0	0	7
OG0018700	0	3	1	1	1	1	0	7
OG0018701	0	4	0	1	1	0	1	7
OG0018702	0	3	0	2	0	0	2	7
OG0018703	0	4	1	1	0	0	1	7
OG0018704	0	5	1	0	0	0	1	7
OG0018705	0	7	0	0	0	0	0	7
OG0018706	0	6	0	0	0	0	1	7
OG0018707	0	2	1	1	1	1	1	7
OG0018708	0	2	0	0	0	0	5	7
OG0018709	0	2	0	1	1	1	2	7
OG0018710	0	6	0	0	1	0	0	7
OG0018711	0	3	1	1	1	1	0	7
OG0018712	0	2	0	2	1	1	1	7
OG0018713	0	2	1	1	1	1	1	7
OG0018714	0	2	0	1	1	2	1	7
OG0018715	0	3	0	1	1	1	1	7
OG0018716	0	4	1	0	0	1	1	7
OG0018717	0	5	0	1	1	0	0	7
OG0018718	0	2	1	1	1	1	1	7
OG0018719	0	2	1	1	1	1	1	7
OG0018720	0	3	1	1	1	1	0	7
OG0018721	0	2	1	1	1	1	1	7
OG0018722	0	2	1	1	1	1	1	7
OG0018723	0	2	1	1	1	1	1	7
OG0018724	0	2	1	1	1	1	1	7
OG0018725	0	4	0	1	1	0	1	7
OG0018726	0	4	0	0	1	1	1	7
OG0018727	0	4	1	0	1	1	0	7
OG0018728	0	3	0	1	1	1	1	7
OG0018729	0	3	0	0	1	0	3	7
OG0018730	0	3	1	1	0	1	1	7
OG0018731	0	1	2	1	1	1	1	7
OG0018732	0	2	1	1	1	1	1	7
OG0018733	0	3	1	0	2	0	1	7
OG0018734	0	2	0	0	0	2	3	7
OG0018735	0	2	1	1	1	1	1	7
OG0018736	0	2	1	1	1	1	1	7
OG0018737	0	3	0	2	1	1	0	7
OG0018738	0	4	0	1	0	1	1	7
OG0018739	0	3	1	0	2	0	1	7
OG0018740	0	2	1	1	1	1	1	7
OG0018741	0	4	1	1	0	0	1	7
OG0018742	0	4	1	0	1	0	1	7
OG0018743	0	7	0	0	0	0	0	7
OG0018744	0	3	0	1	1	1	1	7
OG0018745	0	5	0	0	1	0	1	7
OG0018746	0	4	0	0	1	1	1	7
OG0018747	0	2	1	1	1	1	1	7
OG0018748	0	3	0	1	1	1	1	7
OG0018749	0	7	0	0	0	0	0	7
OG0018750	0	4	0	1	0	1	1	7
OG0018751	0	2	1	1	1	1	1	7
OG0018752	0	3	1	0	1	1	1	7
OG0018753	0	2	1	1	1	1	1	7
OG0018754	0	3	1	0	1	1	1	7
OG0018755	0	5	0	0	2	0	0	7
OG0018756	0	2	1	1	1	1	1	7
OG0018757	0	2	1	1	1	1	1	7
OG0018758	0	3	1	0	1	1	1	7
OG0018759	0	2	1	1	1	1	1	7
OG0018760	0	2	2	0	1	1	1	7
OG0018761	0	6	0	0	0	0	1	7
OG0018762	0	1	1	1	1	1	2	7
OG0018763	0	3	0	1	1	1	1	7
OG0018764	0	2	1	1	1	1	1	7
OG0018765	0	3	0	1	1	1	1	7
OG0018766	0	3	0	1	1	1	1	7
OG0018767	0	4	0	0	1	0	2	7
OG0018768	0	2	1	1	1	1	1	7
OG0018769	0	2	1	1	1	1	1	7
OG0018770	0	2	0	1	1	1	2	7
OG0018771	0	3	1	1	1	0	1	7
OG0018772	0	3	0	1	1	1	1	7
OG0018773	0	3	1	1	1	0	1	7
OG0018774	0	1	1	1	0	2	2	7
OG0018775	0	2	1	1	1	1	1	7
OG0018776	0	7	0	0	0	0	0	7
OG0018777	0	2	0	1	1	1	2	7
OG0018778	0	2	1	1	1	1	1	7
OG0018779	0	3	1	1	1	0	1	7
OG0018780	0	2	1	1	1	1	1	7
OG0018781	0	5	2	0	0	0	0	7
OG0018782	0	4	0	0	1	0	2	7
OG0018783	0	3	1	0	1	1	1	7
OG0018784	0	3	0	1	1	1	1	7
OG0018785	0	2	0	2	1	1	1	7
OG0018786	0	5	1	0	0	0	1	7
OG0018787	0	7	0	0	0	0	0	7
OG0018788	0	2	1	1	1	1	1	7
OG0018789	0	4	0	1	1	1	0	7
OG0018790	0	2	1	1	1	1	1	7
OG0018791	0	2	1	1	1	1	1	7
OG0018792	0	3	1	0	0	1	2	7
OG0018793	0	2	1	1	1	1	1	7
OG0018794	0	2	1	1	0	1	2	7
OG0018795	0	3	0	2	0	2	0	7
OG0018796	0	2	1	0	0	2	2	7
OG0018797	0	2	1	1	1	1	1	7
OG0018798	0	3	1	1	0	1	1	7
OG0018799	0	4	0	0	0	1	2	7
OG0018800	0	7	0	0	0	0	0	7
OG0018801	0	1	1	1	1	1	2	7
OG0018802	0	4	1	1	0	1	0	7
OG0018803	0	7	0	0	0	0	0	7
OG0018804	0	4	0	1	1	1	0	7
OG0018805	0	3	1	1	1	1	0	7
OG0018806	0	2	1	1	1	1	1	7
OG0018807	0	3	1	1	1	1	0	7
OG0018808	0	2	1	1	1	1	1	7
OG0018809	0	3	1	0	0	0	3	7
OG0018810	0	2	1	1	1	1	1	7
OG0018811	0	1	1	2	1	0	2	7
OG0018812	0	3	1	1	1	1	0	7
OG0018813	0	4	0	1	1	0	1	7
OG0018814	0	3	1	1	1	0	1	7
OG0018815	0	2	1	1	2	0	1	7
OG0018816	0	4	1	1	0	0	1	7
OG0018817	0	2	1	1	1	1	1	7
OG0018818	0	7	0	0	0	0	0	7
OG0018819	0	3	0	1	1	1	1	7
OG0018820	0	2	1	1	1	1	1	7
OG0018821	0	4	0	0	1	0	2	7
OG0018822	0	2	1	1	1	1	1	7
OG0018823	0	5	0	0	0	1	1	7
OG0018824	0	2	1	1	1	1	1	7
OG0018825	0	2	1	1	1	1	1	7
OG0018826	0	2	1	1	1	1	1	7
OG0018827	0	2	1	1	1	1	1	7
OG0018828	0	4	0	0	0	1	2	7
OG0018829	0	3	1	1	0	1	1	7
OG0018830	0	2	1	1	1	1	1	7
OG0018831	0	2	1	1	1	1	1	7
OG0018832	0	2	1	1	1	1	1	7
OG0018833	0	2	1	1	1	1	1	7
OG0018834	0	3	1	1	1	0	1	7
OG0018835	0	2	1	1	1	1	1	7
OG0018836	0	1	1	1	1	2	1	7
OG0018837	0	2	1	1	1	1	1	7
OG0018838	0	7	0	0	0	0	0	7
OG0018839	0	2	1	1	1	1	1	7
OG0018840	0	2	1	1	1	1	1	7
OG0018841	0	2	1	1	1	1	1	7
OG0018842	0	2	1	1	1	1	1	7
OG0018843	0	2	1	1	1	1	1	7
OG0018844	0	3	1	1	0	1	1	7
OG0018845	0	4	1	1	1	0	0	7
OG0018846	0	3	1	0	1	1	1	7
OG0018847	0	4	1	1	0	0	1	7
OG0018848	0	4	0	0	1	1	1	7
OG0018849	0	2	1	1	1	1	1	7
OG0018850	0	4	1	0	1	0	1	7
OG0018851	0	2	1	1	1	1	1	7
OG0018852	0	2	1	1	1	1	1	7
OG0018853	0	2	1	1	1	1	1	7
OG0018854	0	3	1	1	1	1	0	7
OG0018855	0	3	0	1	1	1	1	7
OG0018856	0	2	1	1	1	1	1	7
OG0018857	0	2	1	1	1	1	1	7
OG0018858	0	3	1	1	1	1	0	7
OG0018859	0	1	1	0	0	0	5	7
OG0018860	0	2	1	1	1	1	1	7
OG0018861	0	3	1	1	0	1	1	7
OG0018862	0	7	0	0	0	0	0	7
OG0018863	0	2	1	1	1	1	1	7
OG0018864	0	2	1	1	1	1	1	7
OG0018865	0	4	0	0	0	0	3	7
OG0018866	0	2	1	1	1	1	1	7
OG0018867	0	6	0	0	0	0	1	7
OG0018868	0	2	1	1	1	1	1	7
OG0018869	0	2	0	1	1	0	3	7
OG0018870	0	3	1	1	0	1	1	7
OG0018871	0	6	0	0	1	0	0	7
OG0018872	0	2	0	1	1	1	2	7
OG0018873	0	6	0	0	0	0	1	7
OG0018874	0	2	1	1	1	1	1	7
OG0018875	0	2	1	1	1	1	1	7
OG0018876	0	3	1	1	1	0	1	7
OG0018877	0	7	0	0	0	0	0	7
OG0018878	0	2	1	1	1	1	1	7
OG0018879	0	1	1	2	1	1	1	7
OG0018880	0	1	0	3	2	1	0	7
OG0018881	0	2	0	1	1	1	2	7
OG0018882	0	2	1	1	1	1	1	7
OG0018883	0	3	1	0	0	0	3	7
OG0018884	0	4	1	0	1	1	0	7
OG0018885	0	2	1	1	1	1	1	7
OG0018886	0	2	1	1	1	1	1	7
OG0018887	0	3	1	1	1	0	1	7
OG0018888	0	2	1	1	1	1	1	7
OG0018889	0	2	0	1	1	1	2	7
OG0018890	0	2	1	1	1	1	1	7
OG0018891	0	4	0	1	0	1	1	7
OG0018892	0	3	1	0	1	1	1	7
OG0018893	0	4	1	1	0	1	0	7
OG0018894	0	3	1	1	0	1	1	7
OG0018895	0	6	0	1	0	0	0	7
OG0018896	0	3	1	1	1	0	1	7
OG0018897	0	6	0	0	0	0	1	7
OG0018898	0	2	0	2	2	1	0	7
OG0018899	0	3	0	1	1	1	1	7
OG0018900	0	1	0	0	2	4	0	7
OG0018901	0	2	1	1	1	1	1	7
OG0018902	0	2	1	1	1	1	1	7
OG0018903	0	3	1	1	0	1	1	7
OG0018904	0	2	1	1	1	1	1	7
OG0018905	0	2	1	1	1	1	1	7
OG0018906	0	3	1	0	1	1	1	7
OG0018907	0	2	1	1	1	1	1	7
OG0018908	0	2	0	1	1	2	1	7
OG0018909	0	2	1	1	1	1	1	7
OG0018910	0	3	0	1	1	1	1	7
OG0018911	0	3	1	0	1	1	1	7
OG0018912	0	2	1	1	1	1	1	7
OG0018913	0	2	1	1	1	1	1	7
OG0018914	0	2	0	0	0	0	5	7
OG0018915	0	3	0	0	1	2	1	7
OG0018916	0	2	1	1	1	1	1	7
OG0018917	0	2	1	1	1	1	1	7
OG0018918	0	2	1	1	1	1	1	7
OG0018919	0	3	1	0	1	1	1	7
OG0018920	0	2	1	1	1	1	1	7
OG0018921	0	2	1	1	1	1	1	7
OG0018922	0	2	1	1	1	1	1	7
OG0018923	0	2	1	1	1	1	1	7
OG0018924	0	2	1	1	1	1	1	7
OG0018925	0	3	1	1	1	1	0	7
OG0018926	0	2	1	1	1	1	1	7
OG0018927	0	1	1	1	1	1	2	7
OG0018928	0	3	1	0	1	1	1	7
OG0018929	0	3	1	1	1	0	1	7
OG0018930	0	2	1	1	1	1	1	7
OG0018931	0	2	1	1	1	1	1	7
OG0018932	0	3	1	1	1	1	0	7
OG0018933	0	2	1	1	1	1	1	7
OG0018934	0	3	1	1	1	1	0	7
OG0018935	0	2	1	1	0	1	2	7
OG0018936	0	2	1	1	1	1	1	7
OG0018937	0	2	1	1	1	1	1	7
OG0018938	0	3	1	1	0	1	1	7
OG0018939	0	2	1	1	1	1	1	7
OG0018940	0	2	1	1	1	1	1	7
OG0018941	0	2	1	1	1	1	1	7
OG0018942	0	2	1	1	1	1	1	7
OG0018943	0	2	1	1	1	1	1	7
OG0018944	0	3	1	1	0	1	1	7
OG0018945	0	2	1	1	1	1	1	7
OG0018946	0	2	1	0	0	0	4	7
OG0018947	0	3	0	1	1	1	1	7
OG0018948	0	5	0	0	0	1	1	7
OG0018949	0	4	0	0	0	0	3	7
OG0018950	0	1	1	2	1	1	1	7
OG0018951	0	2	2	1	0	1	1	7
OG0018952	0	2	0	1	1	2	1	7
OG0018953	0	2	1	1	1	1	1	7
OG0018954	0	3	1	1	1	0	1	7
OG0018955	0	3	0	1	0	1	2	7
OG0018956	0	2	1	1	1	1	1	7
OG0018957	0	2	1	1	1	1	1	7
OG0018958	0	2	1	1	1	1	1	7
OG0018959	0	3	0	1	1	1	1	7
OG0018960	0	3	0	1	1	1	1	7
OG0018961	0	2	1	1	1	1	1	7
OG0018962	0	2	1	1	1	1	1	7
OG0018963	0	7	0	0	0	0	0	7
OG0018964	0	3	1	0	1	1	1	7
OG0018965	0	2	1	1	1	1	1	7
OG0018966	0	2	1	1	1	1	1	7
OG0018967	0	3	1	0	1	1	1	7
OG0018968	0	2	1	1	1	1	1	7
OG0018969	0	6	0	0	0	0	1	7
OG0018970	0	2	1	1	1	1	1	7
OG0018971	0	3	1	1	1	1	0	7
OG0018972	0	2	2	1	0	1	1	7
OG0018973	0	3	1	1	0	1	1	7
OG0018974	0	3	1	1	0	1	1	7
OG0018975	0	4	1	0	0	1	1	7
OG0018976	0	3	1	1	1	1	0	7
OG0018977	0	6	0	0	0	0	1	7
OG0018978	0	2	1	1	1	1	1	7
OG0018979	0	3	1	1	1	1	0	7
OG0018980	0	3	0	1	0	1	2	7
OG0018981	0	3	1	1	1	1	0	7
OG0018982	0	6	0	0	0	1	0	7
OG0018983	0	3	1	0	1	1	1	7
OG0018984	0	2	1	1	1	1	1	7
OG0018985	0	2	1	1	1	1	1	7
OG0018986	0	2	1	1	1	1	1	7
OG0018987	0	2	1	1	1	1	1	7
OG0018988	0	3	1	1	1	1	0	7
OG0018989	0	2	1	1	1	1	1	7
OG0018990	0	4	1	0	0	1	1	7
OG0018991	0	5	1	0	0	1	0	7
OG0018992	0	3	1	0	1	1	1	7
OG0018993	0	3	1	1	1	1	0	7
OG0018994	0	5	0	0	1	0	1	7
OG0018995	0	2	1	1	1	1	1	7
OG0018996	0	2	1	1	1	1	1	7
OG0018997	0	3	1	1	1	1	0	7
OG0018998	0	2	1	1	1	1	1	7
OG0018999	0	2	0	0	2	2	1	7
OG0019000	0	1	1	0	2	1	2	7
OG0019001	0	3	1	0	1	1	1	7
OG0019002	0	4	0	0	1	1	1	7
OG0019003	0	2	1	1	1	1	1	7
OG0019004	0	2	1	1	1	1	1	7
OG0019005	0	3	0	0	1	1	2	7
OG0019006	0	1	0	0	0	0	6	7
OG0019007	0	2	0	3	0	1	1	7
OG0019008	0	3	0	1	1	1	1	7
OG0019009	0	2	1	1	1	1	1	7
OG0019010	0	2	1	1	1	1	1	7
OG0019011	0	3	1	1	1	1	0	7
OG0019012	0	3	1	1	1	1	0	7
OG0019013	0	3	1	1	0	1	1	7
OG0019014	0	2	1	1	1	1	1	7
OG0019015	0	2	1	1	1	1	1	7
OG0019016	0	6	0	0	0	1	0	7
OG0019017	0	1	1	1	1	1	2	7
OG0019018	0	2	1	1	1	1	1	7
OG0019019	0	5	0	1	0	0	1	7
OG0019020	0	4	0	0	3	0	0	7
OG0019021	0	4	0	1	0	1	1	7
OG0019022	0	3	1	1	1	1	0	7
OG0019023	0	2	1	1	1	1	1	7
OG0019024	0	2	1	1	1	1	1	7
OG0019025	0	2	1	1	1	1	1	7
OG0019026	0	2	1	1	1	1	1	7
OG0019027	0	2	1	1	1	1	1	7
OG0019028	0	2	1	1	1	1	1	7
OG0019029	0	2	1	1	1	1	1	7
OG0019030	0	2	1	1	1	1	1	7
OG0019031	0	2	1	1	1	1	1	7
OG0019032	0	2	0	1	3	1	0	7
OG0019033	0	2	1	1	1	1	1	7
OG0019034	0	2	1	1	1	1	1	7
OG0019035	0	3	1	1	1	1	0	7
OG0019036	0	2	1	1	1	1	1	7
OG0019037	0	3	1	1	0	1	1	7
OG0019038	0	3	0	1	1	1	1	7
OG0019039	0	3	1	1	1	1	0	7
OG0019040	0	2	1	1	1	1	1	7
OG0019041	0	2	1	1	1	1	1	7
OG0019042	0	2	1	1	1	1	1	7
OG0019043	0	2	1	1	1	1	1	7
OG0019044	0	2	1	1	1	1	1	7
OG0019045	0	3	1	0	1	0	2	7
OG0019046	0	3	1	1	1	1	0	7
OG0019047	0	2	1	1	1	1	1	7
OG0019048	0	3	1	1	1	1	0	7
OG0019049	0	2	1	1	1	1	1	7
OG0019050	0	3	0	1	1	1	1	7
OG0019051	0	4	0	2	1	0	0	7
OG0019052	0	1	1	1	1	1	2	7
OG0019053	0	3	1	1	0	2	0	7
OG0019054	0	4	0	1	1	0	1	7
OG0019055	0	6	0	0	0	0	1	7
OG0019056	0	2	1	0	1	1	2	7
OG0019057	0	3	0	1	0	1	2	7
OG0019058	0	4	1	0	0	0	2	7
OG0019059	0	2	0	1	1	1	2	7
OG0019060	0	7	0	0	0	0	0	7
OG0019061	0	2	2	0	2	1	0	7
OG0019062	0	5	0	0	1	0	1	7
OG0019063	0	2	1	0	1	1	2	7
OG0019064	0	2	1	1	1	1	1	7
OG0019065	0	1	2	1	1	1	1	7
OG0019066	0	2	1	1	1	1	1	7
OG0019067	0	4	0	0	3	0	0	7
OG0019068	0	7	0	0	0	0	0	7
OG0019069	0	6	0	0	0	0	1	7
OG0019070	0	2	1	1	1	1	1	7
OG0019071	0	2	1	1	1	1	1	7
OG0019072	0	1	3	1	1	0	1	7
OG0019073	0	2	1	1	1	1	1	7
OG0019074	0	3	1	0	1	0	2	7
OG0019075	0	2	1	1	1	1	1	7
OG0019076	0	2	0	0	1	2	2	7
OG0019077	0	2	1	1	1	1	1	7
OG0019078	0	2	1	1	1	1	1	7
OG0019079	0	2	1	1	1	1	1	7
OG0019080	0	2	1	1	1	1	1	7
OG0019081	0	3	1	1	1	0	1	7
OG0019082	0	3	1	1	1	1	0	7
OG0019083	0	2	1	1	1	1	1	7
OG0019084	0	2	1	1	1	1	1	7
OG0019085	0	2	1	1	1	1	1	7
OG0019086	0	2	1	1	1	1	1	7
OG0019087	0	2	1	1	1	1	1	7
OG0019088	0	2	0	1	1	2	1	7
OG0019089	0	2	1	1	1	1	1	7
OG0019090	0	4	1	1	0	0	1	7
OG0019091	0	1	0	1	0	1	4	7
OG0019092	0	3	1	1	1	1	0	7
OG0019093	0	2	1	1	1	1	1	7
OG0019094	0	2	1	1	1	1	1	7
OG0019095	0	2	0	1	1	2	1	7
OG0019096	0	2	0	2	0	2	1	7
OG0019097	0	1	1	0	0	1	4	7
OG0019098	0	1	1	1	1	1	2	7
OG0019099	0	3	1	1	0	1	1	7
OG0019100	0	2	1	1	1	1	1	7
OG0019101	0	3	1	1	1	1	0	7
OG0019102	0	3	1	1	1	1	0	7
OG0019103	0	2	1	1	1	1	1	7
OG0019104	0	2	1	1	1	1	1	7
OG0019105	0	2	0	1	1	1	2	7
OG0019106	0	2	2	0	1	1	1	7
OG0019107	0	1	0	2	1	3	0	7
OG0019108	0	3	1	1	0	1	1	7
OG0019109	0	2	1	1	1	1	1	7
OG0019110	0	2	1	1	1	1	1	7
OG0019111	0	2	1	1	1	1	1	7
OG0019112	0	2	1	1	1	1	1	7
OG0019113	0	2	1	1	1	1	1	7
OG0019114	0	2	1	1	1	1	1	7
OG0019115	0	2	1	1	1	1	1	7
OG0019116	0	2	0	1	2	1	1	7
OG0019117	0	1	3	1	1	1	0	7
OG0019118	0	2	1	1	1	1	1	7
OG0019119	0	2	1	1	1	1	1	7
OG0019120	0	2	1	1	1	1	1	7
OG0019121	0	1	0	1	1	1	3	7
OG0019122	0	3	1	1	1	1	0	7
OG0019123	0	3	1	1	1	0	1	7
OG0019124	0	2	2	1	1	1	0	7
OG0019125	0	2	1	1	1	1	1	7
OG0019126	0	2	1	1	1	1	1	7
OG0019127	0	5	0	0	2	0	0	7
OG0019128	0	2	1	1	1	1	1	7
OG0019129	0	1	1	1	1	2	1	7
OG0019130	0	3	0	1	2	1	0	7
OG0019131	0	2	1	1	1	1	1	7
OG0019132	0	3	0	1	1	1	1	7
OG0019133	0	2	1	1	1	1	1	7
OG0019134	0	2	1	1	1	1	1	7
OG0019135	0	1	0	2	1	1	2	7
OG0019136	0	2	1	1	1	1	1	7
OG0019137	0	2	1	1	1	1	1	7
OG0019138	0	2	1	1	0	2	1	7
OG0019139	0	1	1	1	0	3	1	7
OG0019140	0	1	2	1	1	1	1	7
OG0019141	0	0	5	0	0	0	2	7
OG0019142	0	0	7	0	0	0	0	7
OG0019143	0	0	2	2	1	1	1	7
OG0019144	0	0	1	0	0	0	6	7
OG0019145	0	0	1	0	0	0	6	7
OG0019146	0	0	1	2	0	1	3	7
OG0019147	0	0	1	2	2	1	1	7
OG0019148	0	0	2	0	0	0	5	7
OG0019149	0	0	1	1	0	1	4	7
OG0019150	0	0	1	0	0	0	6	7
OG0019151	0	0	1	0	0	0	6	7
OG0019152	0	0	3	0	0	0	4	7
OG0019153	0	0	1	2	0	2	2	7
OG0019154	0	0	1	0	0	0	6	7
OG0019155	0	0	0	2	5	0	0	7
OG0019156	0	0	0	4	3	0	0	7
OG0019157	0	0	0	5	2	0	0	7
OG0019158	0	0	0	1	0	0	6	7
OG0019159	0	0	0	0	4	3	0	7
OG0019160	0	0	0	0	1	0	6	7
OG0019161	0	0	0	0	2	3	2	7
OG0019162	0	0	0	0	1	0	6	7
OG0019163	0	0	0	0	0	1	6	7
OG0019164	0	0	0	0	0	0	7	7
OG0019165	0	0	0	0	0	0	7	7
OG0019166	0	0	0	0	0	0	7	7
OG0019167	0	0	0	0	0	0	7	7
OG0019168	0	0	0	0	0	0	7	7
OG0019169	0	0	0	0	0	0	7	7
OG0019170	0	0	0	0	0	0	7	7
OG0019171	0	0	0	0	0	0	7	7
OG0019172	0	0	0	0	0	0	7	7
OG0019173	0	0	0	0	0	0	7	7
OG0019174	0	0	0	0	0	0	7	7
OG0019175	0	0	0	0	0	0	7	7
OG0019176	1	1	1	0	1	1	1	6
OG0019177	5	0	0	0	0	0	1	6
OG0019178	6	0	0	0	0	0	0	6
OG0019179	1	1	1	1	1	0	1	6
OG0019180	1	1	1	1	1	0	1	6
OG0019181	6	0	0	0	0	0	0	6
OG0019182	6	0	0	0	0	0	0	6
OG0019183	4	0	0	0	1	0	1	6
OG0019184	1	2	0	1	1	0	1	6
OG0019185	2	2	1	0	0	0	1	6
OG0019186	4	0	0	1	1	0	0	6
OG0019187	6	0	0	0	0	0	0	6
OG0019188	6	0	0	0	0	0	0	6
OG0019189	2	2	1	0	0	0	1	6
OG0019190	6	0	0	0	0	0	0	6
OG0019191	6	0	0	0	0	0	0	6
OG0019192	1	5	0	0	0	0	0	6
OG0019193	1	0	1	1	1	1	1	6
OG0019194	1	1	1	1	1	1	0	6
OG0019195	6	0	0	0	0	0	0	6
OG0019196	1	1	1	1	1	0	1	6
OG0019197	1	0	1	1	1	0	2	6
OG0019198	1	1	1	1	0	1	1	6
OG0019199	6	0	0	0	0	0	0	6
OG0019200	5	0	0	0	0	1	0	6
OG0019201	1	2	1	1	0	0	1	6
OG0019202	6	0	0	0	0	0	0	6
OG0019203	6	0	0	0	0	0	0	6
OG0019204	3	2	1	0	0	0	0	6
OG0019205	1	0	1	1	1	1	1	6
OG0019206	1	0	1	1	1	1	1	6
OG0019207	2	4	0	0	0	0	0	6
OG0019208	6	0	0	0	0	0	0	6
OG0019209	6	0	0	0	0	0	0	6
OG0019210	2	0	1	1	1	1	0	6
OG0019211	6	0	0	0	0	0	0	6
OG0019212	2	0	2	0	0	0	2	6
OG0019213	1	0	1	1	1	1	1	6
OG0019214	1	2	2	0	0	0	1	6
OG0019215	1	0	1	1	1	1	1	6
OG0019216	6	0	0	0	0	0	0	6
OG0019217	3	0	2	0	0	0	1	6
OG0019218	6	0	0	0	0	0	0	6
OG0019219	2	2	1	0	0	0	1	6
OG0019220	1	0	1	1	1	1	1	6
OG0019221	3	0	3	0	0	0	0	6
OG0019222	6	0	0	0	0	0	0	6
OG0019223	1	0	1	1	1	1	1	6
OG0019224	1	1	1	1	0	1	1	6
OG0019225	1	1	1	1	1	0	1	6
OG0019226	6	0	0	0	0	0	0	6
OG0019227	2	2	1	0	0	0	1	6
OG0019228	5	1	0	0	0	0	0	6
OG0019229	1	1	1	1	0	1	1	6
OG0019230	1	0	1	1	1	1	1	6
OG0019231	2	0	1	1	0	1	1	6
OG0019232	2	4	0	0	0	0	0	6
OG0019233	4	2	0	0	0	0	0	6
OG0019234	6	0	0	0	0	0	0	6
OG0019235	2	0	1	1	1	1	0	6
OG0019236	1	2	1	1	0	0	1	6
OG0019237	3	2	1	0	0	0	0	6
OG0019238	2	2	1	0	0	0	1	6
OG0019239	6	0	0	0	0	0	0	6
OG0019240	1	1	1	1	1	0	1	6
OG0019241	6	0	0	0	0	0	0	6
OG0019242	1	1	1	0	1	1	1	6
OG0019243	4	0	0	1	1	0	0	6
OG0019244	1	3	1	0	0	0	1	6
OG0019245	6	0	0	0	0	0	0	6
OG0019246	2	0	1	1	0	1	1	6
OG0019247	2	2	0	0	2	0	0	6
OG0019248	2	2	1	0	0	0	1	6
OG0019249	1	2	1	1	0	0	1	6
OG0019250	6	0	0	0	0	0	0	6
OG0019251	1	0	1	1	1	1	1	6
OG0019252	5	0	0	0	1	0	0	6
OG0019253	6	0	0	0	0	0	0	6
OG0019254	1	2	1	0	1	1	0	6
OG0019255	1	0	1	1	1	1	1	6
OG0019256	2	0	1	1	1	0	1	6
OG0019257	6	0	0	0	0	0	0	6
OG0019258	1	2	1	0	1	1	0	6
OG0019259	1	0	1	2	1	0	1	6
OG0019260	1	2	1	1	1	0	0	6
OG0019261	5	0	0	0	0	0	1	6
OG0019262	2	0	1	0	1	1	1	6
OG0019263	1	1	1	1	1	0	1	6
OG0019264	6	0	0	0	0	0	0	6
OG0019265	2	2	2	0	0	0	0	6
OG0019266	3	2	0	1	0	0	0	6
OG0019267	1	2	1	1	0	0	1	6
OG0019268	6	0	0	0	0	0	0	6
OG0019269	5	0	0	0	0	1	0	6
OG0019270	3	2	0	0	0	0	1	6
OG0019271	6	0	0	0	0	0	0	6
OG0019272	1	2	2	0	0	0	1	6
OG0019273	1	1	0	1	1	1	1	6
OG0019274	2	0	0	1	1	1	1	6
OG0019275	1	0	1	1	1	1	1	6
OG0019276	1	3	1	1	0	0	0	6
OG0019277	6	0	0	0	0	0	0	6
OG0019278	2	2	1	0	0	0	1	6
OG0019279	6	0	0	0	0	0	0	6
OG0019280	1	1	1	1	0	1	1	6
OG0019281	6	0	0	0	0	0	0	6
OG0019282	1	1	1	0	1	1	1	6
OG0019283	2	2	1	0	0	0	1	6
OG0019284	2	0	2	0	0	1	1	6
OG0019285	1	2	1	1	0	1	0	6
OG0019286	6	0	0	0	0	0	0	6
OG0019287	3	2	1	0	0	0	0	6
OG0019288	2	1	1	1	0	0	1	6
OG0019289	1	1	1	1	0	1	1	6
OG0019290	1	1	1	1	0	1	1	6
OG0019291	1	0	1	1	1	1	1	6
OG0019292	6	0	0	0	0	0	0	6
OG0019293	6	0	0	0	0	0	0	6
OG0019294	6	0	0	0	0	0	0	6
OG0019295	2	3	1	0	0	0	0	6
OG0019296	1	1	1	0	1	1	1	6
OG0019297	4	0	1	0	0	0	1	6
OG0019298	6	0	0	0	0	0	0	6
OG0019299	1	2	1	1	0	0	1	6
OG0019300	1	2	0	1	0	1	1	6
OG0019301	2	3	1	0	0	0	0	6
OG0019302	1	3	1	0	0	0	1	6
OG0019303	1	1	1	0	1	1	1	6
OG0019304	6	0	0	0	0	0	0	6
OG0019305	1	1	1	1	0	1	1	6
OG0019306	2	1	1	0	0	1	1	6
OG0019307	1	3	1	0	0	1	0	6
OG0019308	6	0	0	0	0	0	0	6
OG0019309	2	3	0	0	1	0	0	6
OG0019310	2	0	1	1	0	1	1	6
OG0019311	1	0	1	1	1	1	1	6
OG0019312	1	0	1	1	1	1	1	6
OG0019313	1	1	1	1	1	1	0	6
OG0019314	1	2	0	0	0	0	3	6
OG0019315	1	1	1	1	1	0	1	6
OG0019316	1	2	1	1	1	0	0	6
OG0019317	1	1	1	1	1	0	1	6
OG0019318	2	1	1	1	0	0	1	6
OG0019319	3	0	1	0	1	0	1	6
OG0019320	2	2	1	0	0	0	1	6
OG0019321	1	1	1	0	1	1	1	6
OG0019322	1	4	0	1	0	0	0	6
OG0019323	1	1	1	1	1	0	1	6
OG0019324	1	4	0	1	0	0	0	6
OG0019325	2	1	1	1	0	0	1	6
OG0019326	1	0	1	1	1	1	1	6
OG0019327	1	0	1	1	1	1	1	6
OG0019328	2	0	1	1	1	1	0	6
OG0019329	3	0	1	1	0	0	1	6
OG0019330	2	1	1	1	0	0	1	6
OG0019331	6	0	0	0	0	0	0	6
OG0019332	1	0	1	1	1	1	1	6
OG0019333	1	0	1	1	1	1	1	6
OG0019334	6	0	0	0	0	0	0	6
OG0019335	6	0	0	0	0	0	0	6
OG0019336	6	0	0	0	0	0	0	6
OG0019337	2	2	1	0	0	0	1	6
OG0019338	1	0	1	1	1	1	1	6
OG0019339	2	1	1	0	0	1	1	6
OG0019340	1	1	0	2	0	1	1	6
OG0019341	1	0	1	1	1	1	1	6
OG0019342	6	0	0	0	0	0	0	6
OG0019343	1	1	0	0	0	1	3	6
OG0019344	2	0	1	1	1	1	0	6
OG0019345	1	0	1	1	1	1	1	6
OG0019346	2	0	1	1	0	1	1	6
OG0019347	1	0	1	1	1	1	1	6
OG0019348	6	0	0	0	0	0	0	6
OG0019349	5	0	1	0	0	0	0	6
OG0019350	1	0	1	1	1	1	1	6
OG0019351	1	0	1	1	1	1	1	6
OG0019352	1	0	1	1	1	1	1	6
OG0019353	2	0	1	1	1	0	1	6
OG0019354	1	3	2	0	0	0	0	6
OG0019355	1	0	1	1	1	1	1	6
OG0019356	2	2	1	0	0	0	1	6
OG0019357	2	1	1	1	0	1	0	6
OG0019358	2	1	1	1	1	0	0	6
OG0019359	6	0	0	0	0	0	0	6
OG0019360	1	4	1	0	0	0	0	6
OG0019361	2	1	0	0	1	1	1	6
OG0019362	1	1	1	0	1	1	1	6
OG0019363	1	0	2	0	1	1	1	6
OG0019364	1	1	1	1	2	0	0	6
OG0019365	3	1	1	1	0	0	0	6
OG0019366	2	2	0	2	0	0	0	6
OG0019367	1	3	1	0	0	0	1	6
OG0019368	1	0	1	1	1	1	1	6
OG0019369	2	0	1	1	1	0	1	6
OG0019370	1	0	4	0	0	0	1	6
OG0019371	1	1	1	1	1	1	0	6
OG0019372	4	0	0	1	1	0	0	6
OG0019373	1	3	1	0	0	0	1	6
OG0019374	4	0	1	0	0	1	0	6
OG0019375	2	1	1	0	0	1	1	6
OG0019376	1	1	0	0	4	0	0	6
OG0019377	6	0	0	0	0	0	0	6
OG0019378	1	1	1	0	1	1	1	6
OG0019379	1	0	1	1	1	1	1	6
OG0019380	2	0	1	0	1	1	1	6
OG0019381	1	2	1	0	1	0	1	6
OG0019382	1	3	1	0	0	1	0	6
OG0019383	1	1	1	1	0	1	1	6
OG0019384	2	1	1	1	0	0	1	6
OG0019385	2	0	1	1	0	1	1	6
OG0019386	2	2	1	0	0	0	1	6
OG0019387	2	0	1	1	1	1	0	6
OG0019388	2	3	1	0	0	0	0	6
OG0019389	6	0	0	0	0	0	0	6
OG0019390	6	0	0	0	0	0	0	6
OG0019391	1	4	0	0	0	0	1	6
OG0019392	1	2	0	0	1	1	1	6
OG0019393	2	1	1	0	1	1	0	6
OG0019394	1	1	1	1	1	1	0	6
OG0019395	3	2	1	0	0	0	0	6
OG0019396	2	1	1	0	0	1	1	6
OG0019397	1	2	1	1	0	0	1	6
OG0019398	2	0	1	2	0	0	1	6
OG0019399	1	1	1	1	0	1	1	6
OG0019400	6	0	0	0	0	0	0	6
OG0019401	6	0	0	0	0	0	0	6
OG0019402	1	1	0	1	0	1	2	6
OG0019403	4	0	1	0	0	0	1	6
OG0019404	1	2	0	1	1	0	1	6
OG0019405	1	0	1	1	2	0	1	6
OG0019406	4	1	0	0	1	0	0	6
OG0019407	2	0	1	1	0	1	1	6
OG0019408	1	0	1	1	1	1	1	6
OG0019409	5	1	0	0	0	0	0	6
OG0019410	1	1	1	1	1	0	1	6
OG0019411	1	2	1	1	0	0	1	6
OG0019412	1	0	1	1	1	1	1	6
OG0019413	6	0	0	0	0	0	0	6
OG0019414	2	0	1	1	1	0	1	6
OG0019415	2	0	1	1	0	1	1	6
OG0019416	1	2	1	0	1	0	1	6
OG0019417	1	2	1	1	0	1	0	6
OG0019418	2	0	1	0	1	1	1	6
OG0019419	1	3	1	1	0	0	0	6
OG0019420	1	0	1	1	1	1	1	6
OG0019421	2	1	1	1	0	0	1	6
OG0019422	2	0	0	0	2	2	0	6
OG0019423	1	0	1	1	1	1	1	6
OG0019424	1	1	1	1	1	1	0	6
OG0019425	2	2	1	0	0	0	1	6
OG0019426	2	1	3	0	0	0	0	6
OG0019427	6	0	0	0	0	0	0	6
OG0019428	1	2	1	0	0	1	1	6
OG0019429	1	1	1	0	1	1	1	6
OG0019430	6	0	0	0	0	0	0	6
OG0019431	1	1	1	1	1	0	1	6
OG0019432	2	2	2	0	0	0	0	6
OG0019433	1	2	1	1	0	0	1	6
OG0019434	1	0	1	1	1	1	1	6
OG0019435	1	1	1	0	1	1	1	6
OG0019436	6	0	0	0	0	0	0	6
OG0019437	2	3	0	0	0	0	1	6
OG0019438	1	0	1	1	1	1	1	6
OG0019439	1	1	1	1	1	0	1	6
OG0019440	1	2	1	0	1	1	0	6
OG0019441	2	1	1	1	0	0	1	6
OG0019442	1	3	2	0	0	0	0	6
OG0019443	6	0	0	0	0	0	0	6
OG0019444	1	1	1	0	1	1	1	6
OG0019445	2	0	1	1	1	1	0	6
OG0019446	2	1	2	0	0	1	0	6
OG0019447	1	2	1	1	0	0	1	6
OG0019448	1	0	1	1	1	1	1	6
OG0019449	2	1	1	0	0	1	1	6
OG0019450	1	1	1	1	1	1	0	6
OG0019451	1	0	1	1	1	1	1	6
OG0019452	1	0	1	1	1	1	1	6
OG0019453	2	3	1	0	0	0	0	6
OG0019454	3	2	0	1	0	0	0	6
OG0019455	4	0	0	0	0	0	2	6
OG0019456	1	2	0	1	0	1	1	6
OG0019457	1	2	1	1	0	0	1	6
OG0019458	2	1	1	1	0	0	1	6
OG0019459	2	0	1	1	0	1	1	6
OG0019460	1	3	0	0	1	1	0	6
OG0019461	1	3	0	1	0	0	1	6
OG0019462	1	1	1	1	1	1	0	6
OG0019463	1	1	1	1	1	1	0	6
OG0019464	6	0	0	0	0	0	0	6
OG0019465	2	1	1	1	0	0	1	6
OG0019466	5	1	0	0	0	0	0	6
OG0019467	1	0	1	1	1	1	1	6
OG0019468	3	0	2	0	0	0	1	6
OG0019469	1	0	1	1	1	1	1	6
OG0019470	1	1	1	1	0	1	1	6
OG0019471	1	1	1	1	1	0	1	6
OG0019472	6	0	0	0	0	0	0	6
OG0019473	1	3	0	0	1	0	1	6
OG0019474	1	1	1	1	1	1	0	6
OG0019475	6	0	0	0	0	0	0	6
OG0019476	1	2	1	0	0	1	1	6
OG0019477	1	2	0	1	0	1	1	6
OG0019478	2	0	1	1	0	1	1	6
OG0019479	2	0	2	1	0	0	1	6
OG0019480	1	1	1	1	1	1	0	6
OG0019481	1	2	1	1	1	0	0	6
OG0019482	2	0	1	1	0	1	1	6
OG0019483	1	0	1	1	1	1	1	6
OG0019484	2	2	1	0	0	0	1	6
OG0019485	1	2	1	1	0	0	1	6
OG0019486	2	3	0	0	1	0	0	6
OG0019487	1	1	1	1	1	0	1	6
OG0019488	2	1	1	1	0	0	1	6
OG0019489	2	0	1	1	1	0	1	6
OG0019490	1	1	1	1	0	1	1	6
OG0019491	1	0	1	1	1	1	1	6
OG0019492	1	0	1	1	1	1	1	6
OG0019493	1	0	0	0	0	1	4	6
OG0019494	3	2	0	0	0	0	1	6
OG0019495	1	0	1	1	1	1	1	6
OG0019496	1	2	1	1	1	0	0	6
OG0019497	1	3	1	0	0	0	1	6
OG0019498	1	1	1	1	1	1	0	6
OG0019499	1	0	1	1	1	1	1	6
OG0019500	1	1	1	0	1	1	1	6
OG0019501	1	0	1	1	1	0	2	6
OG0019502	1	1	1	1	1	0	1	6
OG0019503	1	1	1	1	1	0	1	6
OG0019504	6	0	0	0	0	0	0	6
OG0019505	3	1	0	0	0	0	2	6
OG0019506	2	0	1	1	1	1	0	6
OG0019507	2	1	1	0	1	1	0	6
OG0019508	4	0	0	0	0	1	1	6
OG0019509	1	1	1	1	1	1	0	6
OG0019510	1	2	1	1	1	0	0	6
OG0019511	6	0	0	0	0	0	0	6
OG0019512	1	1	1	1	0	1	1	6
OG0019513	1	0	1	1	1	1	1	6
OG0019514	3	0	1	1	1	0	0	6
OG0019515	1	2	1	0	1	1	0	6
OG0019516	2	3	1	0	0	0	0	6
OG0019517	1	1	1	0	1	1	1	6
OG0019518	6	0	0	0	0	0	0	6
OG0019519	1	0	1	1	1	1	1	6
OG0019520	2	0	1	0	1	1	1	6
OG0019521	1	0	2	1	1	0	1	6
OG0019522	1	0	1	1	1	1	1	6
OG0019523	1	0	1	1	1	1	1	6
OG0019524	1	2	1	1	0	0	1	6
OG0019525	1	0	1	1	0	1	2	6
OG0019526	1	3	1	0	0	0	1	6
OG0019527	1	1	1	1	1	0	1	6
OG0019528	6	0	0	0	0	0	0	6
OG0019529	1	0	1	1	1	1	1	6
OG0019530	1	0	1	1	1	1	1	6
OG0019531	1	0	1	1	0	1	2	6
OG0019532	2	1	1	0	1	0	1	6
OG0019533	2	0	1	1	1	1	0	6
OG0019534	1	3	1	0	0	1	0	6
OG0019535	1	2	1	0	0	0	2	6
OG0019536	2	0	1	1	0	1	1	6
OG0019537	1	4	0	0	1	0	0	6
OG0019538	1	1	1	1	0	1	1	6
OG0019539	1	1	1	0	1	1	1	6
OG0019540	4	1	0	0	1	0	0	6
OG0019541	1	2	1	0	1	0	1	6
OG0019542	1	3	0	1	0	0	1	6
OG0019543	2	3	1	0	0	0	0	6
OG0019544	6	0	0	0	0	0	0	6
OG0019545	4	2	0	0	0	0	0	6
OG0019546	1	1	1	1	1	1	0	6
OG0019547	1	3	0	0	0	0	2	6
OG0019548	1	5	0	0	0	0	0	6
OG0019549	1	1	0	0	1	1	2	6
OG0019550	2	0	1	1	1	0	1	6
OG0019551	1	1	1	1	1	1	0	6
OG0019552	1	0	1	1	1	1	1	6
OG0019553	1	3	2	0	0	0	0	6
OG0019554	2	1	1	1	1	0	0	6
OG0019555	1	2	1	1	0	0	1	6
OG0019556	2	1	1	1	0	0	1	6
OG0019557	1	1	1	1	1	1	0	6
OG0019558	1	3	0	0	1	1	0	6
OG0019559	1	2	2	1	0	0	0	6
OG0019560	2	1	1	1	0	0	1	6
OG0019561	1	1	1	1	1	1	0	6
OG0019562	2	1	1	1	1	0	0	6
OG0019563	3	0	1	0	0	1	1	6
OG0019564	1	1	1	1	0	1	1	6
OG0019565	6	0	0	0	0	0	0	6
OG0019566	2	1	1	1	0	0	1	6
OG0019567	1	2	1	0	0	1	1	6
OG0019568	4	0	1	1	0	0	0	6
OG0019569	1	0	1	1	1	1	1	6
OG0019570	1	1	1	0	1	1	1	6
OG0019571	1	2	1	0	1	0	1	6
OG0019572	2	0	1	1	1	0	1	6
OG0019573	1	1	1	1	0	1	1	6
OG0019574	2	1	1	0	0	1	1	6
OG0019575	2	1	1	0	1	1	0	6
OG0019576	1	0	1	1	1	1	1	6
OG0019577	1	0	1	1	1	1	1	6
OG0019578	1	0	1	1	1	1	1	6
OG0019579	1	1	1	1	1	1	0	6
OG0019580	3	2	1	0	0	0	0	6
OG0019581	1	0	1	1	1	1	1	6
OG0019582	1	1	1	1	1	0	1	6
OG0019583	2	2	1	0	0	0	1	6
OG0019584	3	1	0	1	1	0	0	6
OG0019585	1	0	3	0	0	0	2	6
OG0019586	1	0	1	1	1	1	1	6
OG0019587	2	1	1	0	0	1	1	6
OG0019588	2	0	1	1	0	1	1	6
OG0019589	2	0	1	1	0	1	1	6
OG0019590	1	1	1	1	1	0	1	6
OG0019591	1	2	1	1	0	0	1	6
OG0019592	1	2	1	0	0	0	2	6
OG0019593	1	0	1	1	1	1	1	6
OG0019594	1	5	0	0	0	0	0	6
OG0019595	2	1	1	1	0	0	1	6
OG0019596	1	1	1	1	0	1	1	6
OG0019597	1	1	1	1	1	1	0	6
OG0019598	1	1	1	1	0	1	1	6
OG0019599	1	1	1	1	1	0	1	6
OG0019600	1	1	1	1	0	1	1	6
OG0019601	1	0	1	1	1	1	1	6
OG0019602	1	1	0	1	1	1	1	6
OG0019603	1	0	1	1	1	1	1	6
OG0019604	2	2	1	1	0	0	0	6
OG0019605	1	0	1	1	1	1	1	6
OG0019606	1	3	0	0	1	0	1	6
OG0019607	1	4	0	0	0	1	0	6
OG0019608	1	2	0	0	0	1	2	6
OG0019609	1	1	1	1	1	0	1	6
OG0019610	1	1	1	0	1	1	1	6
OG0019611	1	2	1	1	1	0	0	6
OG0019612	1	0	1	1	1	1	1	6
OG0019613	1	0	4	0	0	0	1	6
OG0019614	2	1	1	1	1	0	0	6
OG0019615	1	0	1	1	1	1	1	6
OG0019616	1	1	1	1	1	0	1	6
OG0019617	1	0	1	1	1	1	1	6
OG0019618	2	2	1	0	0	0	1	6
OG0019619	1	0	1	1	1	1	1	6
OG0019620	1	2	1	1	1	0	0	6
OG0019621	2	1	1	1	0	0	1	6
OG0019622	1	0	1	1	1	1	1	6
OG0019623	1	0	1	1	1	1	1	6
OG0019624	1	4	0	0	1	0	0	6
OG0019625	1	0	1	1	1	1	1	6
OG0019626	1	4	1	0	0	0	0	6
OG0019627	1	5	0	0	0	0	0	6
OG0019628	1	0	1	1	1	1	1	6
OG0019629	2	2	1	0	0	0	1	6
OG0019630	1	0	1	1	1	1	1	6
OG0019631	1	4	1	0	0	0	0	6
OG0019632	1	1	1	1	0	1	1	6
OG0019633	2	1	1	0	0	1	1	6
OG0019634	2	3	1	0	0	0	0	6
OG0019635	1	0	1	1	1	1	1	6
OG0019636	1	2	1	0	1	0	1	6
OG0019637	1	1	1	1	0	1	1	6
OG0019638	1	0	1	1	1	1	1	6
OG0019639	1	1	1	1	1	0	1	6
OG0019640	2	0	1	1	1	0	1	6
OG0019641	1	0	1	1	1	1	1	6
OG0019642	1	1	1	1	1	0	1	6
OG0019643	1	0	1	1	1	1	1	6
OG0019644	1	4	1	0	0	0	0	6
OG0019645	1	2	1	0	0	1	1	6
OG0019646	2	3	1	0	0	0	0	6
OG0019647	1	0	1	1	1	1	1	6
OG0019648	1	4	1	0	0	0	0	6
OG0019649	1	0	1	1	1	1	1	6
OG0019650	1	2	1	0	1	0	1	6
OG0019651	1	1	1	0	1	1	1	6
OG0019652	1	1	1	1	0	1	1	6
OG0019653	1	0	1	1	1	1	1	6
OG0019654	1	1	1	1	1	0	1	6
OG0019655	1	1	1	1	1	1	0	6
OG0019656	1	1	1	1	1	0	1	6
OG0019657	1	1	1	1	1	1	0	6
OG0019658	2	1	1	0	1	0	1	6
OG0019659	1	0	2	0	1	1	1	6
OG0019660	1	3	1	0	1	0	0	6
OG0019661	1	2	1	1	0	0	1	6
OG0019662	1	0	1	1	1	1	1	6
OG0019663	2	0	1	1	1	0	1	6
OG0019664	1	0	1	1	1	1	1	6
OG0019665	1	2	0	1	1	0	1	6
OG0019666	1	2	0	0	1	1	1	6
OG0019667	1	2	1	1	0	0	1	6
OG0019668	1	2	1	1	0	0	1	6
OG0019669	1	4	0	0	1	0	0	6
OG0019670	1	1	1	1	1	0	1	6
OG0019671	1	2	2	0	0	0	1	6
OG0019672	1	1	1	1	0	1	1	6
OG0019673	1	2	1	1	1	0	0	6
OG0019674	1	1	1	1	1	1	0	6
OG0019675	1	1	1	0	1	1	1	6
OG0019676	1	0	1	1	1	1	1	6
OG0019677	1	0	1	1	1	1	1	6
OG0019678	1	1	1	1	0	1	1	6
OG0019679	1	2	1	1	1	0	0	6
OG0019680	1	0	1	1	1	1	1	6
OG0019681	2	1	1	1	0	0	1	6
OG0019682	1	1	1	1	1	0	1	6
OG0019683	1	2	1	1	0	1	0	6
OG0019684	1	2	1	1	0	0	1	6
OG0019685	1	0	1	1	2	0	1	6
OG0019686	1	2	1	1	0	0	1	6
OG0019687	1	1	1	1	0	1	1	6
OG0019688	1	4	0	0	1	0	0	6
OG0019689	1	4	1	0	0	0	0	6
OG0019690	2	0	1	1	0	1	1	6
OG0019691	1	2	1	1	0	0	1	6
OG0019692	1	2	1	1	0	0	1	6
OG0019693	1	1	1	1	1	1	0	6
OG0019694	1	3	1	0	0	1	0	6
OG0019695	1	0	1	1	1	1	1	6
OG0019696	1	2	1	0	0	1	1	6
OG0019697	2	2	1	0	0	0	1	6
OG0019698	1	0	1	1	1	1	1	6
OG0019699	1	1	1	1	1	0	1	6
OG0019700	1	3	1	0	0	0	1	6
OG0019701	1	3	1	0	0	0	1	6
OG0019702	1	0	1	1	1	1	1	6
OG0019703	1	0	0	0	3	2	0	6
OG0019704	1	1	0	1	0	2	1	6
OG0019705	1	2	1	1	0	0	1	6
OG0019706	2	0	0	1	1	1	1	6
OG0019707	1	1	1	1	0	1	1	6
OG0019708	1	2	1	1	0	0	1	6
OG0019709	1	3	2	0	0	0	0	6
OG0019710	1	4	1	0	0	0	0	6
OG0019711	1	3	1	0	0	0	1	6
OG0019712	1	0	1	0	0	0	4	6
OG0019713	1	1	1	0	1	1	1	6
OG0019714	1	1	1	1	0	1	1	6
OG0019715	1	1	1	0	1	1	1	6
OG0019716	1	2	1	0	0	1	1	6
OG0019717	1	3	0	0	1	1	0	6
OG0019718	1	1	1	1	0	1	1	6
OG0019719	1	1	1	1	0	1	1	6
OG0019720	1	1	1	1	0	1	1	6
OG0019721	1	1	1	1	1	0	1	6
OG0019722	1	2	1	1	0	1	0	6
OG0019723	1	0	1	1	1	1	1	6
OG0019724	1	1	1	1	1	1	0	6
OG0019725	1	4	0	0	1	0	0	6
OG0019726	1	4	1	0	0	0	0	6
OG0019727	2	0	1	1	1	0	1	6
OG0019728	1	3	1	0	0	0	1	6
OG0019729	1	0	1	1	1	1	1	6
OG0019730	2	3	0	0	0	1	0	6
OG0019731	1	0	1	1	1	1	1	6
OG0019732	1	1	1	0	1	1	1	6
OG0019733	1	1	2	0	1	0	1	6
OG0019734	1	0	1	1	1	1	1	6
OG0019735	1	0	1	1	0	1	2	6
OG0019736	1	2	1	0	1	1	0	6
OG0019737	1	0	1	0	1	2	1	6
OG0019738	1	3	1	1	0	0	0	6
OG0019739	1	1	1	1	1	0	1	6
OG0019740	1	0	1	1	1	1	1	6
OG0019741	1	0	1	1	1	1	1	6
OG0019742	1	0	1	1	1	1	1	6
OG0019743	1	1	0	0	0	0	4	6
OG0019744	1	1	1	0	1	1	1	6
OG0019745	1	0	1	1	1	1	1	6
OG0019746	1	2	1	1	0	0	1	6
OG0019747	1	2	1	0	1	0	1	6
OG0019748	1	1	1	1	1	1	0	6
OG0019749	1	0	1	1	1	1	1	6
OG0019750	1	0	1	1	1	1	1	6
OG0019751	1	3	1	0	0	0	1	6
OG0019752	1	3	1	0	1	0	0	6
OG0019753	1	2	0	0	1	1	1	6
OG0019754	1	3	1	1	0	0	0	6
OG0019755	1	0	1	1	1	1	1	6
OG0019756	1	1	0	1	0	3	0	6
OG0019757	1	0	1	1	1	1	1	6
OG0019758	1	1	1	1	0	1	1	6
OG0019759	1	0	1	1	1	1	1	6
OG0019760	1	1	1	1	1	0	1	6
OG0019761	1	2	1	1	0	0	1	6
OG0019762	1	3	0	2	0	0	0	6
OG0019763	0	3	1	0	0	1	1	6
OG0019764	0	6	0	0	0	0	0	6
OG0019765	0	3	1	1	0	0	1	6
OG0019766	0	2	1	0	1	2	0	6
OG0019767	0	4	1	0	0	0	1	6
OG0019768	0	6	0	0	0	0	0	6
OG0019769	0	4	0	0	1	0	1	6
OG0019770	0	5	0	0	0	0	1	6
OG0019771	0	1	1	1	1	1	1	6
OG0019772	0	6	0	0	0	0	0	6
OG0019773	0	3	0	0	1	1	1	6
OG0019774	0	6	0	0	0	0	0	6
OG0019775	0	6	0	0	0	0	0	6
OG0019776	0	2	0	0	0	2	2	6
OG0019777	0	6	0	0	0	0	0	6
OG0019778	0	1	1	0	1	1	2	6
OG0019779	0	6	0	0	0	0	0	6
OG0019780	0	2	1	0	0	1	2	6
OG0019781	0	3	1	0	0	1	1	6
OG0019782	0	2	1	0	2	1	0	6
OG0019783	0	6	0	0	0	0	0	6
OG0019784	0	4	0	1	1	0	0	6
OG0019785	0	2	1	1	0	1	1	6
OG0019786	0	3	1	1	0	1	0	6
OG0019787	0	4	1	0	0	0	1	6
OG0019788	0	4	0	0	0	1	1	6
OG0019789	0	4	1	1	0	0	0	6
OG0019790	0	3	0	1	0	1	1	6
OG0019791	0	1	1	1	0	2	1	6
OG0019792	0	5	0	1	0	0	0	6
OG0019793	0	6	0	0	0	0	0	6
OG0019794	0	1	1	1	1	1	1	6
OG0019795	0	2	1	0	1	1	1	6
OG0019796	0	4	0	1	1	0	0	6
OG0019797	0	5	0	1	0	0	0	6
OG0019798	0	6	0	0	0	0	0	6
OG0019799	0	2	0	2	0	1	1	6
OG0019800	0	6	0	0	0	0	0	6
OG0019801	0	4	0	0	0	1	1	6
OG0019802	0	5	0	0	0	1	0	6
OG0019803	0	1	1	1	2	0	1	6
OG0019804	0	2	0	2	1	1	0	6
OG0019805	0	4	1	0	1	0	0	6
OG0019806	0	2	1	1	0	0	2	6
OG0019807	0	5	0	0	0	1	0	6
OG0019808	0	3	1	1	0	0	1	6
OG0019809	0	6	0	0	0	0	0	6
OG0019810	0	2	1	1	0	1	1	6
OG0019811	0	6	0	0	0	0	0	6
OG0019812	0	6	0	0	0	0	0	6
OG0019813	0	6	0	0	0	0	0	6
OG0019814	0	6	0	0	0	0	0	6
OG0019815	0	4	0	1	1	0	0	6
OG0019816	0	5	0	0	0	1	0	6
OG0019817	0	3	1	1	0	0	1	6
OG0019818	0	2	1	1	1	0	1	6
OG0019819	0	2	0	1	1	1	1	6
OG0019820	0	4	0	1	1	0	0	6
OG0019821	0	4	0	1	1	0	0	6
OG0019822	0	4	0	1	1	0	0	6
OG0019823	0	3	0	0	1	0	2	6
OG0019824	0	2	0	2	1	1	0	6
OG0019825	0	3	0	0	0	0	3	6
OG0019826	0	1	1	0	1	1	2	6
OG0019827	0	1	1	1	1	1	1	6
OG0019828	0	1	1	1	1	1	1	6
OG0019829	0	4	0	1	1	0	0	6
OG0019830	0	1	1	1	1	1	1	6
OG0019831	0	2	1	1	0	1	1	6
OG0019832	0	2	1	1	0	1	1	6
OG0019833	0	3	1	1	0	0	1	6
OG0019834	0	2	1	0	1	1	1	6
OG0019835	0	2	1	1	1	0	1	6
OG0019836	0	4	0	0	1	0	1	6
OG0019837	0	3	1	0	0	1	1	6
OG0019838	0	6	0	0	0	0	0	6
OG0019839	0	6	0	0	0	0	0	6
OG0019840	0	6	0	0	0	0	0	6
OG0019841	0	2	0	0	1	1	2	6
OG0019842	0	3	0	0	1	1	1	6
OG0019843	0	2	1	1	1	0	1	6
OG0019844	0	6	0	0	0	0	0	6
OG0019845	0	6	0	0	0	0	0	6
OG0019846	0	4	1	1	0	0	0	6
OG0019847	0	5	1	0	0	0	0	6
OG0019848	0	3	1	1	1	0	0	6
OG0019849	0	6	0	0	0	0	0	6
OG0019850	0	3	0	0	0	0	3	6
OG0019851	0	1	1	1	1	1	1	6
OG0019852	0	3	1	0	0	1	1	6
OG0019853	0	3	1	0	0	1	1	6
OG0019854	0	6	0	0	0	0	0	6
OG0019855	0	5	0	0	0	0	1	6
OG0019856	0	5	0	0	1	0	0	6
OG0019857	0	1	1	0	0	0	4	6
OG0019858	0	1	0	0	0	1	4	6
OG0019859	0	6	0	0	0	0	0	6
OG0019860	0	5	0	0	0	0	1	6
OG0019861	0	3	0	1	1	1	0	6
OG0019862	0	3	0	1	1	1	0	6
OG0019863	0	2	1	0	1	1	1	6
OG0019864	0	3	0	1	1	0	1	6
OG0019865	0	2	1	0	1	1	1	6
OG0019866	0	3	1	0	0	1	1	6
OG0019867	0	2	0	0	2	2	0	6
OG0019868	0	2	0	0	0	4	0	6
OG0019869	0	2	1	1	0	0	2	6
OG0019870	0	3	1	1	0	1	0	6
OG0019871	0	1	1	1	1	1	1	6
OG0019872	0	2	1	1	1	0	1	6
OG0019873	0	1	0	0	0	3	2	6
OG0019874	0	2	0	0	1	1	2	6
OG0019875	0	1	1	1	1	1	1	6
OG0019876	0	3	0	1	0	1	1	6
OG0019877	0	2	1	1	0	1	1	6
OG0019878	0	4	0	0	1	0	1	6
OG0019879	0	6	0	0	0	0	0	6
OG0019880	0	2	1	1	1	1	0	6
OG0019881	0	4	1	1	0	0	0	6
OG0019882	0	3	1	0	1	0	1	6
OG0019883	0	3	0	0	1	0	2	6
OG0019884	0	2	0	0	2	1	1	6
OG0019885	0	1	0	0	2	2	1	6
OG0019886	0	1	2	0	1	1	1	6
OG0019887	0	3	0	1	1	1	0	6
OG0019888	0	4	0	0	0	1	1	6
OG0019889	0	4	1	0	0	0	1	6
OG0019890	0	4	0	0	0	0	2	6
OG0019891	0	2	0	1	1	1	1	6
OG0019892	0	2	1	1	1	0	1	6
OG0019893	0	2	1	1	1	1	0	6
OG0019894	0	6	0	0	0	0	0	6
OG0019895	0	4	0	1	1	0	0	6
OG0019896	0	2	0	0	0	2	2	6
OG0019897	0	6	0	0	0	0	0	6
OG0019898	0	3	0	1	0	1	1	6
OG0019899	0	2	2	0	2	0	0	6
OG0019900	0	6	0	0	0	0	0	6
OG0019901	0	2	0	1	1	1	1	6
OG0019902	0	2	0	1	1	0	2	6
OG0019903	0	3	2	0	0	0	1	6
OG0019904	0	3	1	0	1	0	1	6
OG0019905	0	2	0	1	1	1	1	6
OG0019906	0	4	1	0	1	0	0	6
OG0019907	0	1	1	1	1	1	1	6
OG0019908	0	1	0	0	1	3	1	6
OG0019909	0	6	0	0	0	0	0	6
OG0019910	0	1	1	1	1	1	1	6
OG0019911	0	1	1	1	1	1	1	6
OG0019912	0	5	0	0	0	0	1	6
OG0019913	0	3	0	2	1	0	0	6
OG0019914	0	2	1	0	1	2	0	6
OG0019915	0	2	0	0	1	2	1	6
OG0019916	0	4	0	1	1	0	0	6
OG0019917	0	5	0	1	0	0	0	6
OG0019918	0	5	0	0	1	0	0	6
OG0019919	0	2	1	1	0	1	1	6
OG0019920	0	6	0	0	0	0	0	6
OG0019921	0	6	0	0	0	0	0	6
OG0019922	0	2	0	1	2	1	0	6
OG0019923	0	4	0	1	0	0	1	6
OG0019924	0	4	0	1	1	0	0	6
OG0019925	0	3	1	1	0	0	1	6
OG0019926	0	4	1	0	0	0	1	6
OG0019927	0	5	0	0	0	0	1	6
OG0019928	0	4	0	0	0	1	1	6
OG0019929	0	6	0	0	0	0	0	6
OG0019930	0	6	0	0	0	0	0	6
OG0019931	0	4	1	0	0	0	1	6
OG0019932	0	3	1	1	1	0	0	6
OG0019933	0	4	2	0	0	0	0	6
OG0019934	0	3	0	1	1	1	0	6
OG0019935	0	4	0	0	0	1	1	6
OG0019936	0	3	0	1	0	1	1	6
OG0019937	0	4	0	1	0	0	1	6
OG0019938	0	4	1	0	0	0	1	6
OG0019939	0	1	2	0	1	1	1	6
OG0019940	0	3	1	0	1	0	1	6
OG0019941	0	5	0	0	0	0	1	6
OG0019942	0	3	1	1	0	1	0	6
OG0019943	0	5	0	0	0	0	1	6
OG0019944	0	4	0	0	0	1	1	6
OG0019945	0	6	0	0	0	0	0	6
OG0019946	0	5	0	1	0	0	0	6
OG0019947	0	3	0	0	2	0	1	6
OG0019948	0	2	1	0	1	1	1	6
OG0019949	0	4	0	0	1	0	1	6
OG0019950	0	3	1	1	0	0	1	6
OG0019951	0	6	0	0	0	0	0	6
OG0019952	0	5	0	1	0	0	0	6
OG0019953	0	5	0	1	0	0	0	6
OG0019954	0	6	0	0	0	0	0	6
OG0019955	0	3	1	0	1	0	1	6
OG0019956	0	1	1	1	1	1	1	6
OG0019957	0	3	0	1	1	1	0	6
OG0019958	0	3	0	1	2	0	0	6
OG0019959	0	4	1	1	0	0	0	6
OG0019960	0	1	0	0	1	2	2	6
OG0019961	0	3	0	0	1	1	1	6
OG0019962	0	1	1	1	1	1	1	6
OG0019963	0	3	1	1	1	0	0	6
OG0019964	0	4	1	1	0	0	0	6
OG0019965	0	3	1	1	1	0	0	6
OG0019966	0	2	2	0	1	0	1	6
OG0019967	0	3	1	1	1	0	0	6
OG0019968	0	2	1	1	1	0	1	6
OG0019969	0	2	1	1	0	1	1	6
OG0019970	0	3	1	1	0	0	1	6
OG0019971	0	5	0	0	0	0	1	6
OG0019972	0	4	2	0	0	0	0	6
OG0019973	0	2	0	0	1	2	1	6
OG0019974	0	1	1	1	1	1	1	6
OG0019975	0	2	1	1	1	1	0	6
OG0019976	0	2	1	1	0	1	1	6
OG0019977	0	2	1	0	0	0	3	6
OG0019978	0	5	0	1	0	0	0	6
OG0019979	0	5	1	0	0	0	0	6
OG0019980	0	3	0	1	0	0	2	6
OG0019981	0	2	1	1	1	1	0	6
OG0019982	0	6	0	0	0	0	0	6
OG0019983	0	1	1	1	1	1	1	6
OG0019984	0	6	0	0	0	0	0	6
OG0019985	0	2	1	1	0	1	1	6
OG0019986	0	5	0	0	1	0	0	6
OG0019987	0	4	0	0	0	1	1	6
OG0019988	0	1	1	1	0	1	2	6
OG0019989	0	1	1	1	1	1	1	6
OG0019990	0	2	0	0	1	2	1	6
OG0019991	0	2	0	1	2	0	1	6
OG0019992	0	6	0	0	0	0	0	6
OG0019993	0	6	0	0	0	0	0	6
OG0019994	0	4	0	0	0	0	2	6
OG0019995	0	6	0	0	0	0	0	6
OG0019996	0	3	1	0	0	0	2	6
OG0019997	0	2	1	1	1	0	1	6
OG0019998	0	3	0	0	1	1	1	6
OG0019999	0	5	0	0	1	0	0	6
OG0020000	0	3	0	0	1	1	1	6
OG0020001	0	4	1	1	0	0	0	6
OG0020002	0	2	0	1	0	1	2	6
OG0020003	0	5	0	0	0	1	0	6
OG0020004	0	1	1	1	1	1	1	6
OG0020005	0	6	0	0	0	0	0	6
OG0020006	0	5	0	1	0	0	0	6
OG0020007	0	6	0	0	0	0	0	6
OG0020008	0	2	0	1	1	1	1	6
OG0020009	0	2	2	0	0	0	2	6
OG0020010	0	4	0	1	0	0	1	6
OG0020011	0	3	1	1	0	0	1	6
OG0020012	0	3	0	1	1	0	1	6
OG0020013	0	2	2	0	0	1	1	6
OG0020014	0	5	0	0	0	1	0	6
OG0020015	0	2	1	0	1	1	1	6
OG0020016	0	1	1	1	1	1	1	6
OG0020017	0	1	1	1	1	1	1	6
OG0020018	0	3	0	1	1	1	0	6
OG0020019	0	4	1	0	1	0	0	6
OG0020020	0	1	1	1	1	1	1	6
OG0020021	0	1	1	1	1	1	1	6
OG0020022	0	3	1	0	0	1	1	6
OG0020023	0	3	1	1	1	0	0	6
OG0020024	0	6	0	0	0	0	0	6
OG0020025	0	6	0	0	0	0	0	6
OG0020026	0	6	0	0	0	0	0	6
OG0020027	0	5	0	0	0	0	1	6
OG0020028	0	3	0	1	1	1	0	6
OG0020029	0	3	0	1	1	0	1	6
OG0020030	0	3	0	1	0	0	2	6
OG0020031	0	5	0	0	0	1	0	6
OG0020032	0	2	0	1	1	1	1	6
OG0020033	0	2	1	1	1	0	1	6
OG0020034	0	1	1	1	1	1	1	6
OG0020035	0	2	0	1	1	1	1	6
OG0020036	0	5	0	0	0	0	1	6
OG0020037	0	2	1	0	1	1	1	6
OG0020038	0	2	1	0	1	1	1	6
OG0020039	0	2	1	1	1	1	0	6
OG0020040	0	2	1	1	1	0	1	6
OG0020041	0	4	0	0	0	0	2	6
OG0020042	0	3	0	0	1	1	1	6
OG0020043	0	2	1	1	1	1	0	6
OG0020044	0	1	0	1	3	1	0	6
OG0020045	0	2	0	1	1	1	1	6
OG0020046	0	1	1	1	0	3	0	6
OG0020047	0	4	0	0	1	1	0	6
OG0020048	0	3	0	0	0	0	3	6
OG0020049	0	4	0	0	0	0	2	6
OG0020050	0	2	0	0	1	1	2	6
OG0020051	0	4	0	1	0	1	0	6
OG0020052	0	6	0	0	0	0	0	6
OG0020053	0	2	1	1	0	1	1	6
OG0020054	0	2	0	1	0	1	2	6
OG0020055	0	4	0	0	2	0	0	6
OG0020056	0	2	3	0	0	0	1	6
OG0020057	0	2	0	1	1	1	1	6
OG0020058	0	4	1	0	1	0	0	6
OG0020059	0	6	0	0	0	0	0	6
OG0020060	0	2	0	1	1	1	1	6
OG0020061	0	5	0	1	0	0	0	6
OG0020062	0	2	1	1	0	1	1	6
OG0020063	0	5	0	0	0	1	0	6
OG0020064	0	2	1	1	1	1	0	6
OG0020065	0	6	0	0	0	0	0	6
OG0020066	0	3	0	0	1	1	1	6
OG0020067	0	4	0	1	1	0	0	6
OG0020068	0	3	0	0	1	1	1	6
OG0020069	0	4	0	0	1	0	1	6
OG0020070	0	2	1	1	1	0	1	6
OG0020071	0	6	0	0	0	0	0	6
OG0020072	0	3	0	0	1	1	1	6
OG0020073	0	1	1	1	1	1	1	6
OG0020074	0	2	1	1	1	0	1	6
OG0020075	0	4	0	1	0	1	0	6
OG0020076	0	4	0	0	1	1	0	6
OG0020077	0	2	1	1	1	0	1	6
OG0020078	0	3	1	1	0	0	1	6
OG0020079	0	4	0	1	0	0	1	6
OG0020080	0	6	0	0	0	0	0	6
OG0020081	0	3	0	1	2	0	0	6
OG0020082	0	2	0	0	1	1	2	6
OG0020083	0	1	1	1	1	1	1	6
OG0020084	0	5	1	0	0	0	0	6
OG0020085	0	3	1	1	0	0	1	6
OG0020086	0	3	1	1	0	0	1	6
OG0020087	0	6	0	0	0	0	0	6
OG0020088	0	3	0	1	0	1	1	6
OG0020089	0	2	2	0	0	1	1	6
OG0020090	0	4	0	1	0	1	0	6
OG0020091	0	4	1	0	0	1	0	6
OG0020092	0	6	0	0	0	0	0	6
OG0020093	0	3	0	1	1	1	0	6
OG0020094	0	2	1	0	1	1	1	6
OG0020095	0	1	1	1	1	1	1	6
OG0020096	0	2	1	1	0	1	1	6
OG0020097	0	6	0	0	0	0	0	6
OG0020098	0	6	0	0	0	0	0	6
OG0020099	0	6	0	0	0	0	0	6
OG0020100	0	2	1	0	1	1	1	6
OG0020101	0	3	1	0	0	0	2	6
OG0020102	0	6	0	0	0	0	0	6
OG0020103	0	6	0	0	0	0	0	6
OG0020104	0	6	0	0	0	0	0	6
OG0020105	0	3	1	1	1	0	0	6
OG0020106	0	3	1	1	1	0	0	6
OG0020107	0	3	0	0	1	1	1	6
OG0020108	0	3	0	1	1	1	0	6
OG0020109	0	4	0	0	1	1	0	6
OG0020110	0	3	1	0	0	1	1	6
OG0020111	0	6	0	0	0	0	0	6
OG0020112	0	1	1	1	1	1	1	6
OG0020113	0	2	1	1	1	1	0	6
OG0020114	0	6	0	0	0	0	0	6
OG0020115	0	3	0	1	0	1	1	6
OG0020116	0	1	2	1	0	1	1	6
OG0020117	0	6	0	0	0	0	0	6
OG0020118	0	3	1	0	0	1	1	6
OG0020119	0	2	0	1	1	1	1	6
OG0020120	0	3	0	0	1	0	2	6
OG0020121	0	6	0	0	0	0	0	6
OG0020122	0	1	1	1	1	1	1	6
OG0020123	0	6	0	0	0	0	0	6
OG0020124	0	1	1	1	1	1	1	6
OG0020125	0	3	1	0	1	0	1	6
OG0020126	0	5	0	0	0	1	0	6
OG0020127	0	2	1	0	1	1	1	6
OG0020128	0	3	0	1	1	0	1	6
OG0020129	0	3	0	1	0	1	1	6
OG0020130	0	6	0	0	0	0	0	6
OG0020131	0	5	0	0	0	1	0	6
OG0020132	0	2	2	1	0	0	1	6
OG0020133	0	3	0	1	1	0	1	6
OG0020134	0	5	0	0	0	0	1	6
OG0020135	0	2	1	1	1	1	0	6
OG0020136	0	1	0	1	0	3	1	6
OG0020137	0	3	0	1	0	1	1	6
OG0020138	0	4	1	1	0	0	0	6
OG0020139	0	5	0	1	0	0	0	6
OG0020140	0	3	1	0	0	0	2	6
OG0020141	0	4	0	0	0	0	2	6
OG0020142	0	3	1	1	0	0	1	6
OG0020143	0	3	1	0	1	0	1	6
OG0020144	0	4	1	0	0	0	1	6
OG0020145	0	2	1	0	1	1	1	6
OG0020146	0	2	1	1	1	1	0	6
OG0020147	0	1	1	1	1	0	2	6
OG0020148	0	3	1	1	1	0	0	6
OG0020149	0	1	1	0	1	2	1	6
OG0020150	0	5	0	1	0	0	0	6
OG0020151	0	4	0	1	1	0	0	6
OG0020152	0	4	1	0	1	0	0	6
OG0020153	0	1	1	1	1	1	1	6
OG0020154	0	2	1	1	1	0	1	6
OG0020155	0	3	1	1	0	0	1	6
OG0020156	0	6	0	0	0	0	0	6
OG0020157	0	6	0	0	0	0	0	6
OG0020158	0	4	0	0	1	0	1	6
OG0020159	0	3	0	0	0	1	2	6
OG0020160	0	5	0	1	0	0	0	6
OG0020161	0	2	1	1	1	0	1	6
OG0020162	0	3	1	1	0	0	1	6
OG0020163	0	3	0	1	1	0	1	6
OG0020164	0	3	1	0	1	1	0	6
OG0020165	0	5	0	0	1	0	0	6
OG0020166	0	3	1	1	0	1	0	6
OG0020167	0	6	0	0	0	0	0	6
OG0020168	0	3	1	1	0	0	1	6
OG0020169	0	3	1	1	1	0	0	6
OG0020170	0	4	0	1	0	0	1	6
OG0020171	0	4	0	0	1	0	1	6
OG0020172	0	3	0	1	1	0	1	6
OG0020173	0	1	0	1	1	2	1	6
OG0020174	0	2	0	1	1	1	1	6
OG0020175	0	2	1	1	0	1	1	6
OG0020176	0	3	0	2	0	1	0	6
OG0020177	0	1	1	0	1	1	2	6
OG0020178	0	3	1	1	1	0	0	6
OG0020179	0	1	1	1	1	1	1	6
OG0020180	0	2	1	1	0	1	1	6
OG0020181	0	2	1	1	1	1	0	6
OG0020182	0	3	0	0	0	0	3	6
OG0020183	0	2	0	1	0	1	2	6
OG0020184	0	1	1	1	0	2	1	6
OG0020185	0	2	2	1	0	0	1	6
OG0020186	0	3	0	2	1	0	0	6
OG0020187	0	1	4	1	0	0	0	6
OG0020188	0	2	1	1	0	1	1	6
OG0020189	0	3	0	2	0	0	1	6
OG0020190	0	1	1	1	1	1	1	6
OG0020191	0	2	0	1	1	1	1	6
OG0020192	0	3	0	1	0	2	0	6
OG0020193	0	4	0	0	0	0	2	6
OG0020194	0	6	0	0	0	0	0	6
OG0020195	0	2	0	2	0	1	1	6
OG0020196	0	4	1	1	0	0	0	6
OG0020197	0	3	0	2	1	0	0	6
OG0020198	0	6	0	0	0	0	0	6
OG0020199	0	3	0	1	2	0	0	6
OG0020200	0	2	1	1	1	1	0	6
OG0020201	0	2	0	1	1	0	2	6
OG0020202	0	6	0	0	0	0	0	6
OG0020203	0	5	0	0	0	0	1	6
OG0020204	0	4	0	1	0	0	1	6
OG0020205	0	5	0	1	0	0	0	6
OG0020206	0	6	0	0	0	0	0	6
OG0020207	0	4	0	1	1	0	0	6
OG0020208	0	3	0	0	1	1	1	6
OG0020209	0	1	1	1	1	1	1	6
OG0020210	0	2	0	1	1	1	1	6
OG0020211	0	2	1	1	1	1	0	6
OG0020212	0	2	1	0	1	1	1	6
OG0020213	0	2	0	2	1	0	1	6
OG0020214	0	1	1	1	1	1	1	6
OG0020215	0	1	1	1	1	1	1	6
OG0020216	0	6	0	0	0	0	0	6
OG0020217	0	4	0	0	1	0	1	6
OG0020218	0	5	0	0	0	0	1	6
OG0020219	0	2	0	1	1	0	2	6
OG0020220	0	6	0	0	0	0	0	6
OG0020221	0	1	0	0	1	1	3	6
OG0020222	0	3	1	0	1	0	1	6
OG0020223	0	3	1	0	0	1	1	6
OG0020224	0	1	1	1	1	1	1	6
OG0020225	0	3	1	1	1	0	0	6
OG0020226	0	3	0	1	1	0	1	6
OG0020227	0	3	0	1	0	1	1	6
OG0020228	0	2	0	2	1	1	0	6
OG0020229	0	6	0	0	0	0	0	6
OG0020230	0	3	0	1	1	0	1	6
OG0020231	0	1	1	1	1	1	1	6
OG0020232	0	3	1	1	0	1	0	6
OG0020233	0	3	0	1	0	1	1	6
OG0020234	0	3	1	0	0	1	1	6
OG0020235	0	6	0	0	0	0	0	6
OG0020236	0	6	0	0	0	0	0	6
OG0020237	0	2	0	1	0	1	2	6
OG0020238	0	2	1	1	0	1	1	6
OG0020239	0	2	1	1	1	1	0	6
OG0020240	0	5	0	0	0	0	1	6
OG0020241	0	1	1	1	1	1	1	6
OG0020242	0	1	1	1	1	1	1	6
OG0020243	0	2	0	1	2	1	0	6
OG0020244	0	3	0	0	1	1	1	6
OG0020245	0	3	0	1	0	1	1	6
OG0020246	0	3	1	1	0	0	1	6
OG0020247	0	1	1	1	1	1	1	6
OG0020248	0	3	1	1	1	0	0	6
OG0020249	0	2	0	1	0	3	0	6
OG0020250	0	3	0	1	1	1	0	6
OG0020251	0	4	1	0	0	0	1	6
OG0020252	0	6	0	0	0	0	0	6
OG0020253	0	5	0	0	0	0	1	6
OG0020254	0	2	0	0	0	0	4	6
OG0020255	0	2	1	1	1	1	0	6
OG0020256	0	2	1	1	1	1	0	6
OG0020257	0	3	0	1	1	0	1	6
OG0020258	0	3	0	0	1	1	1	6
OG0020259	0	4	0	0	0	1	1	6
OG0020260	0	4	0	1	0	0	1	6
OG0020261	0	2	1	0	1	1	1	6
OG0020262	0	4	1	0	0	0	1	6
OG0020263	0	3	1	1	1	0	0	6
OG0020264	0	2	1	1	0	1	1	6
OG0020265	0	1	1	1	1	1	1	6
OG0020266	0	1	1	1	1	1	1	6
OG0020267	0	1	1	1	1	1	1	6
OG0020268	0	3	0	1	1	1	0	6
OG0020269	0	1	1	1	1	1	1	6
OG0020270	0	2	2	0	0	0	2	6
OG0020271	0	1	2	1	0	0	2	6
OG0020272	0	2	0	1	1	1	1	6
OG0020273	0	1	1	1	1	1	1	6
OG0020274	0	2	0	1	1	1	1	6
OG0020275	0	3	0	0	0	2	1	6
OG0020276	0	2	0	1	0	1	2	6
OG0020277	0	1	1	1	1	1	1	6
OG0020278	0	2	1	1	1	0	1	6
OG0020279	0	3	1	1	1	0	0	6
OG0020280	0	1	1	1	1	1	1	6
OG0020281	0	4	1	0	1	0	0	6
OG0020282	0	6	0	0	0	0	0	6
OG0020283	0	3	0	0	0	1	2	6
OG0020284	0	1	1	1	1	1	1	6
OG0020285	0	5	0	0	0	1	0	6
OG0020286	0	4	1	0	0	1	0	6
OG0020287	0	2	3	0	0	0	1	6
OG0020288	0	5	1	0	0	0	0	6
OG0020289	0	6	0	0	0	0	0	6
OG0020290	0	2	1	1	1	1	0	6
OG0020291	0	2	1	1	0	1	1	6
OG0020292	0	2	0	1	1	1	1	6
OG0020293	0	2	0	1	1	1	1	6
OG0020294	0	3	0	1	0	1	1	6
OG0020295	0	4	0	0	0	1	1	6
OG0020296	0	3	1	0	1	1	0	6
OG0020297	0	1	1	1	1	1	1	6
OG0020298	0	1	1	1	1	1	1	6
OG0020299	0	4	1	0	0	1	0	6
OG0020300	0	2	0	0	1	2	1	6
OG0020301	0	2	1	1	0	1	1	6
OG0020302	0	2	0	0	1	2	1	6
OG0020303	0	2	0	1	1	0	2	6
OG0020304	0	2	0	1	1	1	1	6
OG0020305	0	3	1	1	0	0	1	6
OG0020306	0	2	1	1	0	1	1	6
OG0020307	0	6	0	0	0	0	0	6
OG0020308	0	3	0	1	1	1	0	6
OG0020309	0	3	1	0	0	1	1	6
OG0020310	0	1	1	0	1	2	1	6
OG0020311	0	5	0	0	0	0	1	6
OG0020312	0	2	0	0	1	2	1	6
OG0020313	0	1	1	1	1	1	1	6
OG0020314	0	2	1	1	0	1	1	6
OG0020315	0	1	4	0	0	1	0	6
OG0020316	0	1	1	1	1	1	1	6
OG0020317	0	3	1	1	1	0	0	6
OG0020318	0	4	0	1	1	0	0	6
OG0020319	0	2	1	1	1	0	1	6
OG0020320	0	2	0	1	1	1	1	6
OG0020321	0	2	0	0	1	1	2	6
OG0020322	0	2	1	0	1	1	1	6
OG0020323	0	2	1	0	1	1	1	6
OG0020324	0	3	0	0	1	1	1	6
OG0020325	0	2	4	0	0	0	0	6
OG0020326	0	1	0	0	0	0	5	6
OG0020327	0	1	0	0	0	0	5	6
OG0020328	0	2	0	0	0	1	3	6
OG0020329	0	1	1	1	1	1	1	6
OG0020330	0	1	1	1	1	1	1	6
OG0020331	0	4	1	0	0	0	1	6
OG0020332	0	1	0	1	1	2	1	6
OG0020333	0	6	0	0	0	0	0	6
OG0020334	0	1	1	1	1	1	1	6
OG0020335	0	2	0	0	1	1	2	6
OG0020336	0	1	1	0	2	1	1	6
OG0020337	0	2	1	1	1	1	0	6
OG0020338	0	3	0	0	1	1	1	6
OG0020339	0	2	1	0	1	1	1	6
OG0020340	0	2	0	0	1	1	2	6
OG0020341	0	1	1	1	1	1	1	6
OG0020342	0	3	1	1	0	1	0	6
OG0020343	0	3	0	3	0	0	0	6
OG0020344	0	1	0	1	0	3	1	6
OG0020345	0	1	0	1	4	0	0	6
OG0020346	0	6	0	0	0	0	0	6
OG0020347	0	4	0	0	0	0	2	6
OG0020348	0	1	1	1	1	1	1	6
OG0020349	0	3	0	0	3	0	0	6
OG0020350	0	1	1	1	1	1	1	6
OG0020351	0	4	0	0	1	1	0	6
OG0020352	0	2	1	1	1	1	0	6
OG0020353	0	6	0	0	0	0	0	6
OG0020354	0	2	1	0	0	1	2	6
OG0020355	0	2	1	1	0	1	1	6
OG0020356	0	1	1	1	1	1	1	6
OG0020357	0	1	1	1	1	1	1	6
OG0020358	0	1	1	1	1	1	1	6
OG0020359	0	1	1	1	1	1	1	6
OG0020360	0	6	0	0	0	0	0	6
OG0020361	0	2	1	1	0	1	1	6
OG0020362	0	6	0	0	0	0	0	6
OG0020363	0	2	1	1	1	0	1	6
OG0020364	0	2	1	1	1	0	1	6
OG0020365	0	3	1	1	0	1	0	6
OG0020366	0	2	2	0	0	0	2	6
OG0020367	0	1	1	1	1	1	1	6
OG0020368	0	2	0	1	1	0	2	6
OG0020369	0	1	2	0	0	2	1	6
OG0020370	0	3	1	0	0	1	1	6
OG0020371	0	3	1	0	1	0	1	6
OG0020372	0	2	1	1	0	1	1	6
OG0020373	0	3	1	1	0	1	0	6
OG0020374	0	3	0	0	1	1	1	6
OG0020375	0	4	0	1	0	1	0	6
OG0020376	0	1	0	0	0	0	5	6
OG0020377	0	2	1	1	1	1	0	6
OG0020378	0	4	0	1	0	1	0	6
OG0020379	0	4	0	1	0	0	1	6
OG0020380	0	3	0	1	0	0	2	6
OG0020381	0	3	0	2	1	0	0	6
OG0020382	0	2	0	1	1	1	1	6
OG0020383	0	1	1	1	1	1	1	6
OG0020384	0	1	1	1	1	1	1	6
OG0020385	0	1	1	1	1	1	1	6
OG0020386	0	1	1	1	1	1	1	6
OG0020387	0	1	1	1	1	1	1	6
OG0020388	0	4	0	0	1	1	0	6
OG0020389	0	6	0	0	0	0	0	6
OG0020390	0	1	0	0	0	0	5	6
OG0020391	0	6	0	0	0	0	0	6
OG0020392	0	3	1	0	2	0	0	6
OG0020393	0	4	0	0	1	0	1	6
OG0020394	0	2	0	0	2	1	1	6
OG0020395	0	2	0	1	3	0	0	6
OG0020396	0	3	1	0	0	1	1	6
OG0020397	0	3	0	1	1	1	0	6
OG0020398	0	2	1	0	0	0	3	6
OG0020399	0	2	1	0	1	1	1	6
OG0020400	0	3	1	0	0	1	1	6
OG0020401	0	1	1	1	2	0	1	6
OG0020402	0	2	0	1	1	1	1	6
OG0020403	0	2	1	1	1	0	1	6
OG0020404	0	1	1	1	1	1	1	6
OG0020405	0	1	1	1	1	1	1	6
OG0020406	0	1	0	1	2	1	1	6
OG0020407	0	1	0	1	0	1	3	6
OG0020408	0	2	1	0	1	0	2	6
OG0020409	0	3	0	0	0	3	0	6
OG0020410	0	3	0	1	1	1	0	6
OG0020411	0	1	1	1	1	1	1	6
OG0020412	0	1	1	1	1	1	1	6
OG0020413	0	2	1	1	1	0	1	6
OG0020414	0	3	0	1	1	0	1	6
OG0020415	0	2	1	1	1	1	0	6
OG0020416	0	1	1	1	1	1	1	6
OG0020417	0	1	1	1	2	1	0	6
OG0020418	0	1	1	1	1	1	1	6
OG0020419	0	1	1	1	1	1	1	6
OG0020420	0	1	1	1	1	1	1	6
OG0020421	0	2	1	1	0	1	1	6
OG0020422	0	3	0	1	1	0	1	6
OG0020423	0	2	0	1	1	1	1	6
OG0020424	0	2	1	0	1	1	1	6
OG0020425	0	1	2	0	1	0	2	6
OG0020426	0	1	1	1	1	1	1	6
OG0020427	0	1	0	1	1	1	2	6
OG0020428	0	1	1	1	0	3	0	6
OG0020429	0	2	3	0	1	0	0	6
OG0020430	0	1	1	1	1	1	1	6
OG0020431	0	2	0	1	1	1	1	6
OG0020432	0	1	2	1	1	0	1	6
OG0020433	0	1	1	1	1	1	1	6
OG0020434	0	1	1	0	0	1	3	6
OG0020435	0	1	1	1	1	1	1	6
OG0020436	0	2	1	1	1	1	0	6
OG0020437	0	2	1	0	1	1	1	6
OG0020438	0	1	1	1	1	1	1	6
OG0020439	0	1	1	1	1	1	1	6
OG0020440	0	2	0	1	1	1	1	6
OG0020441	0	1	0	2	1	2	0	6
OG0020442	0	2	1	0	2	0	1	6
OG0020443	0	1	1	1	1	1	1	6
OG0020444	0	3	1	1	1	0	0	6
OG0020445	0	1	0	0	0	0	5	6
OG0020446	0	2	0	1	0	2	1	6
OG0020447	0	1	0	0	3	1	1	6
OG0020448	0	2	0	0	0	2	2	6
OG0020449	0	1	1	1	1	1	1	6
OG0020450	0	1	0	1	1	2	1	6
OG0020451	0	1	0	1	0	1	3	6
OG0020452	0	2	1	1	1	1	0	6
OG0020453	0	1	0	0	1	1	3	6
OG0020454	0	1	1	1	1	1	1	6
OG0020455	0	1	1	1	1	1	1	6
OG0020456	0	3	0	1	0	0	2	6
OG0020457	0	2	1	1	1	1	0	6
OG0020458	0	1	0	1	0	1	3	6
OG0020459	0	2	1	1	1	1	0	6
OG0020460	0	1	1	1	1	1	1	6
OG0020461	0	1	1	0	1	0	3	6
OG0020462	0	1	0	2	0	3	0	6
OG0020463	0	1	1	1	1	1	1	6
OG0020464	0	1	1	1	1	1	1	6
OG0020465	0	1	1	1	1	1	1	6
OG0020466	0	1	2	0	1	1	1	6
OG0020467	0	1	1	1	1	1	1	6
OG0020468	0	1	1	1	1	1	1	6
OG0020469	0	1	1	1	1	1	1	6
OG0020470	0	1	1	1	1	1	1	6
OG0020471	0	1	2	0	1	1	1	6
OG0020472	0	1	1	1	1	1	1	6
OG0020473	0	3	0	1	0	1	1	6
OG0020474	0	1	1	1	1	1	1	6
OG0020475	0	2	0	0	0	2	2	6
OG0020476	0	1	1	1	1	1	1	6
OG0020477	0	1	1	0	1	2	1	6
OG0020478	0	1	1	1	1	1	1	6
OG0020479	0	1	1	1	0	1	2	6
OG0020480	0	1	1	1	1	1	1	6
OG0020481	0	1	1	1	1	1	1	6
OG0020482	0	1	1	1	1	1	1	6
OG0020483	0	1	1	1	1	1	1	6
OG0020484	0	1	2	1	0	1	1	6
OG0020485	0	1	1	1	1	1	1	6
OG0020486	0	1	1	1	1	1	1	6
OG0020487	0	1	1	1	1	1	1	6
OG0020488	0	1	1	1	1	1	1	6
OG0020489	0	1	1	1	1	1	1	6
OG0020490	0	1	1	1	1	1	1	6
OG0020491	0	1	0	1	1	1	2	6
OG0020492	0	1	1	1	1	1	1	6
OG0020493	0	1	1	1	1	1	1	6
OG0020494	0	1	2	1	1	1	0	6
OG0020495	0	1	1	1	1	1	1	6
OG0020496	0	1	0	1	1	1	2	6
OG0020497	0	1	1	1	1	1	1	6
OG0020498	0	1	1	1	1	1	1	6
OG0020499	0	1	1	1	1	1	1	6
OG0020500	0	0	1	0	0	0	5	6
OG0020501	0	0	2	0	0	1	3	6
OG0020502	0	0	1	1	2	1	1	6
OG0020503	0	0	4	0	0	0	2	6
OG0020504	0	0	1	1	1	1	2	6
OG0020505	0	0	6	0	0	0	0	6
OG0020506	0	0	4	0	0	0	2	6
OG0020507	0	0	1	0	0	0	5	6
OG0020508	0	0	1	2	1	1	1	6
OG0020509	0	0	1	0	0	1	4	6
OG0020510	0	0	6	0	0	0	0	6
OG0020511	0	0	2	1	1	1	1	6
OG0020512	0	0	2	0	0	0	4	6
OG0020513	0	0	1	3	1	1	0	6
OG0020514	0	0	1	1	1	1	2	6
OG0020515	0	0	2	0	0	0	4	6
OG0020516	0	0	1	1	1	0	3	6
OG0020517	0	0	0	2	1	1	2	6
OG0020518	0	0	0	1	1	3	1	6
OG0020519	0	0	0	1	1	0	4	6
OG0020520	0	0	0	1	2	3	0	6
OG0020521	0	0	0	2	4	0	0	6
OG0020522	0	0	0	1	1	1	3	6
OG0020523	0	0	0	1	0	3	2	6
OG0020524	0	0	0	1	0	1	4	6
OG0020525	0	0	0	1	4	1	0	6
OG0020526	0	0	0	0	2	4	0	6
OG0020527	0	0	0	0	5	0	1	6
OG0020528	0	0	0	0	1	0	5	6
OG0020529	0	0	0	0	0	6	0	6
OG0020530	0	0	0	0	0	1	5	6
OG0020531	0	0	0	0	0	3	3	6
OG0020532	0	0	0	0	0	1	5	6
OG0020533	0	0	0	0	0	1	5	6
OG0020534	0	0	0	0	0	0	6	6
OG0020535	0	0	0	0	0	0	6	6
OG0020536	0	0	0	0	0	0	6	6
OG0020537	0	0	0	0	0	0	6	6
OG0020538	0	0	0	0	0	0	6	6
OG0020539	0	0	0	0	0	0	6	6
OG0020540	5	0	0	0	0	0	0	5
OG0020541	5	0	0	0	0	0	0	5
OG0020542	1	3	0	1	0	0	0	5
OG0020543	1	4	0	0	0	0	0	5
OG0020544	5	0	0	0	0	0	0	5
OG0020545	5	0	0	0	0	0	0	5
OG0020546	1	1	1	1	0	0	1	5
OG0020547	2	2	1	0	0	0	0	5
OG0020548	5	0	0	0	0	0	0	5
OG0020549	5	0	0	0	0	0	0	5
OG0020550	5	0	0	0	0	0	0	5
OG0020551	5	0	0	0	0	0	0	5
OG0020552	4	0	1	0	0	0	0	5
OG0020553	5	0	0	0	0	0	0	5
OG0020554	5	0	0	0	0	0	0	5
OG0020555	4	0	0	0	0	0	1	5
OG0020556	5	0	0	0	0	0	0	5
OG0020557	2	0	1	1	1	0	0	5
OG0020558	5	0	0	0	0	0	0	5
OG0020559	5	0	0	0	0	0	0	5
OG0020560	3	2	0	0	0	0	0	5
OG0020561	1	0	1	0	1	1	1	5
OG0020562	1	1	1	1	0	0	1	5
OG0020563	2	0	1	1	0	0	1	5
OG0020564	5	0	0	0	0	0	0	5
OG0020565	2	2	0	0	1	0	0	5
OG0020566	5	0	0	0	0	0	0	5
OG0020567	1	2	0	2	0	0	0	5
OG0020568	1	1	0	1	1	0	1	5
OG0020569	3	0	1	0	0	0	1	5
OG0020570	5	0	0	0	0	0	0	5
OG0020571	5	0	0	0	0	0	0	5
OG0020572	5	0	0	0	0	0	0	5
OG0020573	2	3	0	0	0	0	0	5
OG0020574	4	1	0	0	0	0	0	5
OG0020575	5	0	0	0	0	0	0	5
OG0020576	4	0	1	0	0	0	0	5
OG0020577	3	1	0	0	1	0	0	5
OG0020578	5	0	0	0	0	0	0	5
OG0020579	2	3	0	0	0	0	0	5
OG0020580	5	0	0	0	0	0	0	5
OG0020581	2	2	0	0	0	1	0	5
OG0020582	5	0	0	0	0	0	0	5
OG0020583	3	2	0	0	0	0	0	5
OG0020584	3	0	2	0	0	0	0	5
OG0020585	5	0	0	0	0	0	0	5
OG0020586	5	0	0	0	0	0	0	5
OG0020587	1	0	0	0	1	1	2	5
OG0020588	5	0	0	0	0	0	0	5
OG0020589	5	0	0	0	0	0	0	5
OG0020590	5	0	0	0	0	0	0	5
OG0020591	1	2	0	0	0	0	2	5
OG0020592	2	0	1	1	1	0	0	5
OG0020593	2	1	1	0	0	1	0	5
OG0020594	1	1	0	0	1	1	1	5
OG0020595	5	0	0	0	0	0	0	5
OG0020596	5	0	0	0	0	0	0	5
OG0020597	1	0	1	1	1	1	0	5
OG0020598	5	0	0	0	0	0	0	5
OG0020599	4	0	0	0	1	0	0	5
OG0020600	1	3	0	0	1	0	0	5
OG0020601	5	0	0	0	0	0	0	5
OG0020602	5	0	0	0	0	0	0	5
OG0020603	1	1	2	0	0	0	1	5
OG0020604	2	2	1	0	0	0	0	5
OG0020605	5	0	0	0	0	0	0	5
OG0020606	1	0	1	0	1	1	1	5
OG0020607	3	0	2	0	0	0	0	5
OG0020608	5	0	0	0	0	0	0	5
OG0020609	5	0	0	0	0	0	0	5
OG0020610	5	0	0	0	0	0	0	5
OG0020611	5	0	0	0	0	0	0	5
OG0020612	5	0	0	0	0	0	0	5
OG0020613	5	0	0	0	0	0	0	5
OG0020614	5	0	0	0	0	0	0	5
OG0020615	5	0	0	0	0	0	0	5
OG0020616	3	0	1	0	0	0	1	5
OG0020617	5	0	0	0	0	0	0	5
OG0020618	1	2	0	1	0	0	1	5
OG0020619	4	1	0	0	0	0	0	5
OG0020620	4	0	0	1	0	0	0	5
OG0020621	2	1	1	0	0	0	1	5
OG0020622	5	0	0	0	0	0	0	5
OG0020623	4	1	0	0	0	0	0	5
OG0020624	2	3	0	0	0	0	0	5
OG0020625	5	0	0	0	0	0	0	5
OG0020626	5	0	0	0	0	0	0	5
OG0020627	1	1	0	1	1	1	0	5
OG0020628	5	0	0	0	0	0	0	5
OG0020629	4	0	0	0	1	0	0	5
OG0020630	5	0	0	0	0	0	0	5
OG0020631	2	1	1	0	0	1	0	5
OG0020632	5	0	0	0	0	0	0	5
OG0020633	5	0	0	0	0	0	0	5
OG0020634	5	0	0	0	0	0	0	5
OG0020635	3	0	0	0	0	1	1	5
OG0020636	1	2	1	1	0	0	0	5
OG0020637	5	0	0	0	0	0	0	5
OG0020638	2	1	1	0	0	0	1	5
OG0020639	1	0	0	0	0	1	3	5
OG0020640	1	2	0	0	1	0	1	5
OG0020641	1	1	0	1	0	1	1	5
OG0020642	2	1	1	0	0	0	1	5
OG0020643	1	2	0	0	1	0	1	5
OG0020644	5	0	0	0	0	0	0	5
OG0020645	2	1	1	0	0	0	1	5
OG0020646	2	3	0	0	0	0	0	5
OG0020647	2	0	0	1	0	0	2	5
OG0020648	1	0	1	1	1	0	1	5
OG0020649	1	2	1	0	0	0	1	5
OG0020650	4	0	0	0	0	0	1	5
OG0020651	5	0	0	0	0	0	0	5
OG0020652	3	1	1	0	0	0	0	5
OG0020653	1	0	0	1	1	1	1	5
OG0020654	1	0	1	1	1	1	0	5
OG0020655	3	1	1	0	0	0	0	5
OG0020656	5	0	0	0	0	0	0	5
OG0020657	5	0	0	0	0	0	0	5
OG0020658	2	2	1	0	0	0	0	5
OG0020659	5	0	0	0	0	0	0	5
OG0020660	5	0	0	0	0	0	0	5
OG0020661	1	3	1	0	0	0	0	5
OG0020662	5	0	0	0	0	0	0	5
OG0020663	1	1	1	1	0	0	1	5
OG0020664	5	0	0	0	0	0	0	5
OG0020665	3	2	0	0	0	0	0	5
OG0020666	1	0	1	1	1	1	0	5
OG0020667	1	0	1	0	1	1	1	5
OG0020668	1	1	1	0	0	1	1	5
OG0020669	5	0	0	0	0	0	0	5
OG0020670	1	2	1	0	0	0	1	5
OG0020671	1	1	1	0	1	1	0	5
OG0020672	2	3	0	0	0	0	0	5
OG0020673	5	0	0	0	0	0	0	5
OG0020674	3	1	0	0	1	0	0	5
OG0020675	1	1	1	1	0	0	1	5
OG0020676	1	1	1	0	0	1	1	5
OG0020677	2	1	2	0	0	0	0	5
OG0020678	5	0	0	0	0	0	0	5
OG0020679	1	0	2	0	0	1	1	5
OG0020680	2	1	1	0	0	0	1	5
OG0020681	5	0	0	0	0	0	0	5
OG0020682	1	1	0	0	0	1	2	5
OG0020683	5	0	0	0	0	0	0	5
OG0020684	5	0	0	0	0	0	0	5
OG0020685	2	2	1	0	0	0	0	5
OG0020686	4	1	0	0	0	0	0	5
OG0020687	2	0	1	0	0	0	2	5
OG0020688	5	0	0	0	0	0	0	5
OG0020689	5	0	0	0	0	0	0	5
OG0020690	1	1	1	0	1	0	1	5
OG0020691	5	0	0	0	0	0	0	5
OG0020692	2	1	1	0	0	0	1	5
OG0020693	5	0	0	0	0	0	0	5
OG0020694	2	2	1	0	0	0	0	5
OG0020695	1	1	0	0	1	1	1	5
OG0020696	2	1	1	0	0	0	1	5
OG0020697	5	0	0	0	0	0	0	5
OG0020698	1	2	0	1	0	1	0	5
OG0020699	2	1	1	0	0	0	1	5
OG0020700	5	0	0	0	0	0	0	5
OG0020701	5	0	0	0	0	0	0	5
OG0020702	1	3	0	0	1	0	0	5
OG0020703	5	0	0	0	0	0	0	5
OG0020704	1	4	0	0	0	0	0	5
OG0020705	2	2	1	0	0	0	0	5
OG0020706	5	0	0	0	0	0	0	5
OG0020707	5	0	0	0	0	0	0	5
OG0020708	5	0	0	0	0	0	0	5
OG0020709	5	0	0	0	0	0	0	5
OG0020710	1	1	1	1	0	1	0	5
OG0020711	1	3	0	0	0	1	0	5
OG0020712	3	2	0	0	0	0	0	5
OG0020713	1	2	1	1	0	0	0	5
OG0020714	5	0	0	0	0	0	0	5
OG0020715	5	0	0	0	0	0	0	5
OG0020716	5	0	0	0	0	0	0	5
OG0020717	5	0	0	0	0	0	0	5
OG0020718	2	1	0	1	0	1	0	5
OG0020719	5	0	0	0	0	0	0	5
OG0020720	2	2	1	0	0	0	0	5
OG0020721	3	0	1	1	0	0	0	5
OG0020722	5	0	0	0	0	0	0	5
OG0020723	1	4	0	0	0	0	0	5
OG0020724	2	0	1	1	0	1	0	5
OG0020725	5	0	0	0	0	0	0	5
OG0020726	1	3	0	1	0	0	0	5
OG0020727	5	0	0	0	0	0	0	5
OG0020728	1	2	1	0	0	0	1	5
OG0020729	2	0	1	0	0	1	1	5
OG0020730	5	0	0	0	0	0	0	5
OG0020731	3	0	0	1	1	0	0	5
OG0020732	5	0	0	0	0	0	0	5
OG0020733	1	1	1	0	1	0	1	5
OG0020734	5	0	0	0	0	0	0	5
OG0020735	5	0	0	0	0	0	0	5
OG0020736	1	3	0	0	0	0	1	5
OG0020737	1	1	1	1	1	0	0	5
OG0020738	5	0	0	0	0	0	0	5
OG0020739	1	4	0	0	0	0	0	5
OG0020740	5	0	0	0	0	0	0	5
OG0020741	2	1	1	0	0	0	1	5
OG0020742	2	0	1	0	0	1	1	5
OG0020743	1	4	0	0	0	0	0	5
OG0020744	4	0	0	0	0	0	1	5
OG0020745	1	1	0	0	1	1	1	5
OG0020746	4	0	1	0	0	0	0	5
OG0020747	5	0	0	0	0	0	0	5
OG0020748	2	1	0	1	0	0	1	5
OG0020749	2	0	1	0	0	0	2	5
OG0020750	1	0	1	0	1	1	1	5
OG0020751	5	0	0	0	0	0	0	5
OG0020752	5	0	0	0	0	0	0	5
OG0020753	2	0	1	0	0	1	1	5
OG0020754	2	2	1	0	0	0	0	5
OG0020755	1	1	0	0	3	0	0	5
OG0020756	5	0	0	0	0	0	0	5
OG0020757	1	0	1	1	1	1	0	5
OG0020758	1	0	1	1	0	1	1	5
OG0020759	5	0	0	0	0	0	0	5
OG0020760	5	0	0	0	0	0	0	5
OG0020761	2	1	1	0	0	1	0	5
OG0020762	1	0	1	1	1	1	0	5
OG0020763	2	0	1	1	0	0	1	5
OG0020764	5	0	0	0	0	0	0	5
OG0020765	5	0	0	0	0	0	0	5
OG0020766	2	2	0	1	0	0	0	5
OG0020767	2	1	0	0	0	1	1	5
OG0020768	1	2	1	0	0	0	1	5
OG0020769	1	2	1	0	0	0	1	5
OG0020770	5	0	0	0	0	0	0	5
OG0020771	5	0	0	0	0	0	0	5
OG0020772	1	0	1	1	1	0	1	5
OG0020773	2	1	0	2	0	0	0	5
OG0020774	5	0	0	0	0	0	0	5
OG0020775	2	1	1	0	0	0	1	5
OG0020776	2	0	1	0	0	1	1	5
OG0020777	1	3	1	0	0	0	0	5
OG0020778	1	0	1	1	1	1	0	5
OG0020779	1	2	0	0	2	0	0	5
OG0020780	1	3	0	1	0	0	0	5
OG0020781	5	0	0	0	0	0	0	5
OG0020782	1	1	1	1	0	0	1	5
OG0020783	1	0	1	1	0	1	1	5
OG0020784	5	0	0	0	0	0	0	5
OG0020785	1	3	0	0	0	0	1	5
OG0020786	2	0	1	0	0	1	1	5
OG0020787	1	4	0	0	0	0	0	5
OG0020788	1	4	0	0	0	0	0	5
OG0020789	3	1	0	0	1	0	0	5
OG0020790	1	1	1	1	0	0	1	5
OG0020791	1	2	1	0	1	0	0	5
OG0020792	2	2	1	0	0	0	0	5
OG0020793	2	1	0	0	0	0	2	5
OG0020794	2	0	1	0	0	1	1	5
OG0020795	2	3	0	0	0	0	0	5
OG0020796	1	3	0	0	1	0	0	5
OG0020797	2	1	0	0	0	0	2	5
OG0020798	1	1	1	1	0	0	1	5
OG0020799	3	1	1	0	0	0	0	5
OG0020800	2	1	1	0	0	0	1	5
OG0020801	1	0	1	1	0	0	2	5
OG0020802	2	1	1	0	0	0	1	5
OG0020803	1	2	1	0	0	1	0	5
OG0020804	2	3	0	0	0	0	0	5
OG0020805	3	2	0	0	0	0	0	5
OG0020806	1	1	0	0	0	1	2	5
OG0020807	1	2	1	0	0	0	1	5
OG0020808	2	2	0	1	0	0	0	5
OG0020809	2	1	1	0	0	0	1	5
OG0020810	1	2	0	1	1	0	0	5
OG0020811	1	2	0	1	0	1	0	5
OG0020812	2	0	0	0	1	1	1	5
OG0020813	1	3	1	0	0	0	0	5
OG0020814	2	1	1	0	0	0	1	5
OG0020815	1	0	1	1	1	0	1	5
OG0020816	2	1	1	0	0	0	1	5
OG0020817	2	0	1	0	1	0	1	5
OG0020818	1	1	0	0	3	0	0	5
OG0020819	1	2	2	0	0	0	0	5
OG0020820	1	2	1	0	0	1	0	5
OG0020821	1	2	0	0	1	0	1	5
OG0020822	1	1	1	1	0	0	1	5
OG0020823	1	3	0	0	0	0	1	5
OG0020824	1	0	1	1	0	1	1	5
OG0020825	5	0	0	0	0	0	0	5
OG0020826	1	1	1	1	1	0	0	5
OG0020827	2	1	1	0	0	0	1	5
OG0020828	2	0	3	0	0	0	0	5
OG0020829	1	3	1	0	0	0	0	5
OG0020830	1	1	1	1	0	0	1	5
OG0020831	5	0	0	0	0	0	0	5
OG0020832	3	1	1	0	0	0	0	5
OG0020833	1	3	0	0	0	0	1	5
OG0020834	1	3	0	0	0	0	1	5
OG0020835	2	1	0	0	0	1	1	5
OG0020836	5	0	0	0	0	0	0	5
OG0020837	1	3	0	0	0	0	1	5
OG0020838	1	0	1	1	1	1	0	5
OG0020839	2	2	1	0	0	0	0	5
OG0020840	2	2	1	0	0	0	0	5
OG0020841	2	0	1	1	0	0	1	5
OG0020842	1	0	2	0	0	0	2	5
OG0020843	1	1	1	1	0	0	1	5
OG0020844	1	2	0	0	1	1	0	5
OG0020845	4	1	0	0	0	0	0	5
OG0020846	1	3	1	0	0	0	0	5
OG0020847	2	1	1	0	1	0	0	5
OG0020848	1	1	1	1	0	0	1	5
OG0020849	1	0	1	1	1	0	1	5
OG0020850	2	0	1	0	1	0	1	5
OG0020851	1	0	1	2	0	0	1	5
OG0020852	2	1	1	0	0	0	1	5
OG0020853	1	0	1	1	1	1	0	5
OG0020854	1	2	1	0	0	0	1	5
OG0020855	1	1	0	1	1	1	0	5
OG0020856	2	2	0	0	0	0	1	5
OG0020857	2	1	1	0	0	0	1	5
OG0020858	1	2	0	0	1	1	0	5
OG0020859	2	0	0	1	0	1	1	5
OG0020860	2	2	1	0	0	0	0	5
OG0020861	2	2	0	0	1	0	0	5
OG0020862	1	0	1	1	1	0	1	5
OG0020863	1	0	0	1	1	1	1	5
OG0020864	1	2	0	1	1	0	0	5
OG0020865	1	4	0	0	0	0	0	5
OG0020866	2	0	1	0	0	1	1	5
OG0020867	1	0	1	1	1	0	1	5
OG0020868	1	0	1	1	1	1	0	5
OG0020869	1	2	1	0	0	0	1	5
OG0020870	1	0	1	1	0	1	1	5
OG0020871	1	1	1	0	1	0	1	5
OG0020872	1	0	1	0	1	1	1	5
OG0020873	2	1	2	0	0	0	0	5
OG0020874	1	3	0	1	0	0	0	5
OG0020875	2	1	0	2	0	0	0	5
OG0020876	2	0	1	0	1	1	0	5
OG0020877	1	2	1	0	1	0	0	5
OG0020878	1	3	1	0	0	0	0	5
OG0020879	2	2	1	0	0	0	0	5
OG0020880	2	2	0	0	0	1	0	5
OG0020881	2	1	1	1	0	0	0	5
OG0020882	2	0	0	1	1	1	0	5
OG0020883	1	3	1	0	0	0	0	5
OG0020884	1	0	0	1	1	1	1	5
OG0020885	1	3	0	0	1	0	0	5
OG0020886	1	0	1	0	0	0	3	5
OG0020887	2	1	0	0	0	1	1	5
OG0020888	1	3	0	0	0	1	0	5
OG0020889	2	2	0	0	0	1	0	5
OG0020890	1	3	0	0	0	0	1	5
OG0020891	1	1	1	1	0	0	1	5
OG0020892	2	2	0	0	1	0	0	5
OG0020893	1	1	1	1	0	0	1	5
OG0020894	2	1	1	0	0	0	1	5
OG0020895	2	2	1	0	0	0	0	5
OG0020896	1	2	1	0	0	1	0	5
OG0020897	1	1	1	0	0	1	1	5
OG0020898	1	0	1	1	0	1	1	5
OG0020899	2	2	1	0	0	0	0	5
OG0020900	1	0	1	0	0	1	2	5
OG0020901	1	1	1	0	0	1	1	5
OG0020902	3	1	0	1	0	0	0	5
OG0020903	1	0	2	0	0	1	1	5
OG0020904	2	1	1	0	1	0	0	5
OG0020905	1	0	1	0	1	1	1	5
OG0020906	2	0	1	0	0	0	2	5
OG0020907	1	0	1	0	1	1	1	5
OG0020908	1	1	1	0	0	1	1	5
OG0020909	1	2	1	0	0	0	1	5
OG0020910	1	0	1	1	1	1	0	5
OG0020911	2	0	1	0	0	1	1	5
OG0020912	2	1	1	0	0	0	1	5
OG0020913	1	2	0	1	0	1	0	5
OG0020914	1	1	1	1	0	1	0	5
OG0020915	3	0	1	0	0	0	1	5
OG0020916	1	1	1	1	0	0	1	5
OG0020917	1	1	1	1	0	1	0	5
OG0020918	2	0	1	0	1	0	1	5
OG0020919	2	1	1	0	0	0	1	5
OG0020920	1	1	0	0	0	0	3	5
OG0020921	2	2	1	0	0	0	0	5
OG0020922	1	4	0	0	0	0	0	5
OG0020923	1	1	1	0	0	1	1	5
OG0020924	1	0	1	0	1	1	1	5
OG0020925	1	2	0	0	1	1	0	5
OG0020926	1	1	1	0	1	0	1	5
OG0020927	1	2	1	0	0	0	1	5
OG0020928	1	1	0	1	0	1	1	5
OG0020929	1	0	1	1	0	1	1	5
OG0020930	1	1	1	1	0	1	0	5
OG0020931	1	0	1	1	0	1	1	5
OG0020932	2	1	0	0	0	0	2	5
OG0020933	1	1	1	1	0	0	1	5
OG0020934	1	4	0	0	0	0	0	5
OG0020935	1	1	1	1	0	0	1	5
OG0020936	1	0	1	0	1	2	0	5
OG0020937	1	0	0	1	1	1	1	5
OG0020938	1	1	1	0	0	1	1	5
OG0020939	1	0	1	1	0	1	1	5
OG0020940	1	2	1	0	0	0	1	5
OG0020941	1	2	1	0	0	0	1	5
OG0020942	1	2	1	0	0	1	0	5
OG0020943	1	2	0	0	0	1	1	5
OG0020944	1	2	0	1	1	0	0	5
OG0020945	1	2	1	0	1	0	0	5
OG0020946	1	4	0	0	0	0	0	5
OG0020947	1	2	2	0	0	0	0	5
OG0020948	1	1	1	0	1	0	1	5
OG0020949	1	0	0	2	2	0	0	5
OG0020950	2	0	1	0	0	1	1	5
OG0020951	1	1	1	0	1	0	1	5
OG0020952	1	0	1	1	1	0	1	5
OG0020953	1	0	1	1	1	1	0	5
OG0020954	1	0	0	1	1	1	1	5
OG0020955	1	3	1	0	0	0	0	5
OG0020956	1	1	0	0	1	0	2	5
OG0020957	1	1	1	0	0	1	1	5
OG0020958	1	1	1	1	0	1	0	5
OG0020959	0	5	0	0	0	0	0	5
OG0020960	0	5	0	0	0	0	0	5
OG0020961	0	5	0	0	0	0	0	5
OG0020962	0	5	0	0	0	0	0	5
OG0020963	0	5	0	0	0	0	0	5
OG0020964	0	1	0	0	0	0	4	5
OG0020965	0	4	0	0	0	0	1	5
OG0020966	0	5	0	0	0	0	0	5
OG0020967	0	5	0	0	0	0	0	5
OG0020968	0	5	0	0	0	0	0	5
OG0020969	0	3	0	1	0	1	0	5
OG0020970	0	3	0	1	0	1	0	5
OG0020971	0	5	0	0	0	0	0	5
OG0020972	0	3	1	0	1	0	0	5
OG0020973	0	2	1	0	1	1	0	5
OG0020974	0	5	0	0	0	0	0	5
OG0020975	0	3	0	0	1	1	0	5
OG0020976	0	5	0	0	0	0	0	5
OG0020977	0	4	1	0	0	0	0	5
OG0020978	0	3	0	1	0	0	1	5
OG0020979	0	5	0	0	0	0	0	5
OG0020980	0	3	1	1	0	0	0	5
OG0020981	0	3	1	1	0	0	0	5
OG0020982	0	2	1	1	0	0	1	5
OG0020983	0	5	0	0	0	0	0	5
OG0020984	0	3	0	0	1	1	0	5
OG0020985	0	5	0	0	0	0	0	5
OG0020986	0	4	0	0	0	0	1	5
OG0020987	0	3	1	0	0	1	0	5
OG0020988	0	3	0	2	0	0	0	5
OG0020989	0	5	0	0	0	0	0	5
OG0020990	0	5	0	0	0	0	0	5
OG0020991	0	2	1	1	0	1	0	5
OG0020992	0	3	0	0	1	0	1	5
OG0020993	0	5	0	0	0	0	0	5
OG0020994	0	2	1	1	0	0	1	5
OG0020995	0	3	1	0	0	0	1	5
OG0020996	0	5	0	0	0	0	0	5
OG0020997	0	5	0	0	0	0	0	5
OG0020998	0	5	0	0	0	0	0	5
OG0020999	0	4	0	0	0	1	0	5
OG0021000	0	3	1	1	0	0	0	5
OG0021001	0	5	0	0	0	0	0	5
OG0021002	0	2	0	0	1	1	1	5
OG0021003	0	3	0	1	0	0	1	5
OG0021004	0	3	0	0	1	0	1	5
OG0021005	0	3	0	1	0	1	0	5
OG0021006	0	3	0	0	1	1	0	5
OG0021007	0	2	1	1	1	0	0	5
OG0021008	0	3	0	1	0	0	1	5
OG0021009	0	3	0	1	0	1	0	5
OG0021010	0	4	0	0	1	0	0	5
OG0021011	0	5	0	0	0	0	0	5
OG0021012	0	3	0	0	2	0	0	5
OG0021013	0	5	0	0	0	0	0	5
OG0021014	0	5	0	0	0	0	0	5
OG0021015	0	1	1	1	0	1	1	5
OG0021016	0	5	0	0	0	0	0	5
OG0021017	0	5	0	0	0	0	0	5
OG0021018	0	5	0	0	0	0	0	5
OG0021019	0	5	0	0	0	0	0	5
OG0021020	0	5	0	0	0	0	0	5
OG0021021	0	4	0	0	0	0	1	5
OG0021022	0	2	0	0	3	0	0	5
OG0021023	0	5	0	0	0	0	0	5
OG0021024	0	5	0	0	0	0	0	5
OG0021025	0	5	0	0	0	0	0	5
OG0021026	0	3	1	0	0	0	1	5
OG0021027	0	3	0	1	0	0	1	5
OG0021028	0	5	0	0	0	0	0	5
OG0021029	0	5	0	0	0	0	0	5
OG0021030	0	2	0	1	1	1	0	5
OG0021031	0	1	0	0	1	2	1	5
OG0021032	0	1	1	1	0	1	1	5
OG0021033	0	2	1	0	1	0	1	5
OG0021034	0	2	1	1	1	0	0	5
OG0021035	0	2	0	1	1	0	1	5
OG0021036	0	5	0	0	0	0	0	5
OG0021037	0	3	0	0	0	1	1	5
OG0021038	0	2	1	0	1	1	0	5
OG0021039	0	5	0	0	0	0	0	5
OG0021040	0	1	1	1	1	1	0	5
OG0021041	0	3	0	1	0	1	0	5
OG0021042	0	5	0	0	0	0	0	5
OG0021043	0	5	0	0	0	0	0	5
OG0021044	0	2	0	1	0	1	1	5
OG0021045	0	2	0	1	0	1	1	5
OG0021046	0	2	0	1	1	1	0	5
OG0021047	0	3	0	1	1	0	0	5
OG0021048	0	1	0	1	0	1	2	5
OG0021049	0	5	0	0	0	0	0	5
OG0021050	0	4	0	0	0	1	0	5
OG0021051	0	2	0	0	1	0	2	5
OG0021052	0	1	0	2	0	0	2	5
OG0021053	0	1	0	0	2	1	1	5
OG0021054	0	4	0	0	1	0	0	5
OG0021055	0	5	0	0	0	0	0	5
OG0021056	0	3	0	1	0	0	1	5
OG0021057	0	3	0	0	1	0	1	5
OG0021058	0	4	0	0	0	0	1	5
OG0021059	0	4	0	0	0	0	1	5
OG0021060	0	3	1	0	0	0	1	5
OG0021061	0	5	0	0	0	0	0	5
OG0021062	0	3	1	0	1	0	0	5
OG0021063	0	5	0	0	0	0	0	5
OG0021064	0	5	0	0	0	0	0	5
OG0021065	0	4	0	1	0	0	0	5
OG0021066	0	5	0	0	0	0	0	5
OG0021067	0	4	0	0	0	0	1	5
OG0021068	0	3	0	0	0	1	1	5
OG0021069	0	5	0	0	0	0	0	5
OG0021070	0	5	0	0	0	0	0	5
OG0021071	0	2	1	0	1	0	1	5
OG0021072	0	3	0	1	0	0	1	5
OG0021073	0	1	1	0	1	1	1	5
OG0021074	0	2	0	1	1	1	0	5
OG0021075	0	5	0	0	0	0	0	5
OG0021076	0	5	0	0	0	0	0	5
OG0021077	0	1	1	0	1	1	1	5
OG0021078	0	3	0	0	1	0	1	5
OG0021079	0	5	0	0	0	0	0	5
OG0021080	0	4	1	0	0	0	0	5
OG0021081	0	3	0	0	0	0	2	5
OG0021082	0	4	0	0	1	0	0	5
OG0021083	0	5	0	0	0	0	0	5
OG0021084	0	4	1	0	0	0	0	5
OG0021085	0	2	1	0	1	0	1	5
OG0021086	0	5	0	0	0	0	0	5
OG0021087	0	3	1	0	0	0	1	5
OG0021088	0	4	0	0	0	0	1	5
OG0021089	0	5	0	0	0	0	0	5
OG0021090	0	4	0	0	0	0	1	5
OG0021091	0	1	1	0	0	0	3	5
OG0021092	0	5	0	0	0	0	0	5
OG0021093	0	3	1	1	0	0	0	5
OG0021094	0	1	1	0	1	1	1	5
OG0021095	0	2	0	0	1	1	1	5
OG0021096	0	3	1	1	0	0	0	5
OG0021097	0	2	0	1	1	1	0	5
OG0021098	0	2	0	0	0	0	3	5
OG0021099	0	4	0	1	0	0	0	5
OG0021100	0	2	0	0	1	0	2	5
OG0021101	0	2	0	0	1	1	1	5
OG0021102	0	2	0	0	1	1	1	5
OG0021103	0	3	0	0	0	0	2	5
OG0021104	0	3	1	0	0	0	1	5
OG0021105	0	1	0	0	0	1	3	5
OG0021106	0	1	1	0	1	1	1	5
OG0021107	0	2	1	0	1	1	0	5
OG0021108	0	4	0	1	0	0	0	5
OG0021109	0	3	1	0	1	0	0	5
OG0021110	0	5	0	0	0	0	0	5
OG0021111	0	4	0	1	0	0	0	5
OG0021112	0	1	0	1	1	1	1	5
OG0021113	0	5	0	0	0	0	0	5
OG0021114	0	4	1	0	0	0	0	5
OG0021115	0	2	0	1	1	0	1	5
OG0021116	0	4	1	0	0	0	0	5
OG0021117	0	2	1	1	0	1	0	5
OG0021118	0	2	0	0	2	0	1	5
OG0021119	0	5	0	0	0	0	0	5
OG0021120	0	2	1	1	0	1	0	5
OG0021121	0	2	0	1	0	1	1	5
OG0021122	0	4	0	0	0	0	1	5
OG0021123	0	5	0	0	0	0	0	5
OG0021124	0	5	0	0	0	0	0	5
OG0021125	0	2	0	0	0	0	3	5
OG0021126	0	5	0	0	0	0	0	5
OG0021127	0	5	0	0	0	0	0	5
OG0021128	0	5	0	0	0	0	0	5
OG0021129	0	4	0	0	0	0	1	5
OG0021130	0	2	0	1	1	1	0	5
OG0021131	0	5	0	0	0	0	0	5
OG0021132	0	4	1	0	0	0	0	5
OG0021133	0	2	0	2	0	1	0	5
OG0021134	0	4	0	0	0	0	1	5
OG0021135	0	5	0	0	0	0	0	5
OG0021136	0	4	0	0	1	0	0	5
OG0021137	0	5	0	0	0	0	0	5
OG0021138	0	5	0	0	0	0	0	5
OG0021139	0	3	0	0	1	0	1	5
OG0021140	0	5	0	0	0	0	0	5
OG0021141	0	4	1	0	0	0	0	5
OG0021142	0	5	0	0	0	0	0	5
OG0021143	0	5	0	0	0	0	0	5
OG0021144	0	2	0	1	0	1	1	5
OG0021145	0	2	0	1	1	0	1	5
OG0021146	0	2	0	1	1	0	1	5
OG0021147	0	5	0	0	0	0	0	5
OG0021148	0	5	0	0	0	0	0	5
OG0021149	0	2	3	0	0	0	0	5
OG0021150	0	2	0	1	1	1	0	5
OG0021151	0	5	0	0	0	0	0	5
OG0021152	0	5	0	0	0	0	0	5
OG0021153	0	2	1	1	1	0	0	5
OG0021154	0	5	0	0	0	0	0	5
OG0021155	0	3	0	0	1	0	1	5
OG0021156	0	2	1	1	0	0	1	5
OG0021157	0	2	0	1	1	0	1	5
OG0021158	0	1	0	0	0	0	4	5
OG0021159	0	4	0	1	0	0	0	5
OG0021160	0	2	0	0	1	0	2	5
OG0021161	0	1	1	0	0	1	2	5
OG0021162	0	2	1	0	0	1	1	5
OG0021163	0	4	0	0	0	0	1	5
OG0021164	0	3	0	0	0	0	2	5
OG0021165	0	5	0	0	0	0	0	5
OG0021166	0	3	0	0	1	0	1	5
OG0021167	0	5	0	0	0	0	0	5
OG0021168	0	5	0	0	0	0	0	5
OG0021169	0	4	1	0	0	0	0	5
OG0021170	0	2	0	0	0	1	2	5
OG0021171	0	2	1	0	1	0	1	5
OG0021172	0	4	0	0	1	0	0	5
OG0021173	0	5	0	0	0	0	0	5
OG0021174	0	3	0	0	1	0	1	5
OG0021175	0	2	0	1	0	1	1	5
OG0021176	0	4	0	0	1	0	0	5
OG0021177	0	2	0	0	2	1	0	5
OG0021178	0	5	0	0	0	0	0	5
OG0021179	0	3	0	1	1	0	0	5
OG0021180	0	2	0	0	1	1	1	5
OG0021181	0	3	1	0	1	0	0	5
OG0021182	0	5	0	0	0	0	0	5
OG0021183	0	3	1	1	0	0	0	5
OG0021184	0	3	1	0	1	0	0	5
OG0021185	0	2	2	0	1	0	0	5
OG0021186	0	5	0	0	0	0	0	5
OG0021187	0	5	0	0	0	0	0	5
OG0021188	0	4	1	0	0	0	0	5
OG0021189	0	4	0	0	1	0	0	5
OG0021190	0	4	0	1	0	0	0	5
OG0021191	0	1	1	0	1	1	1	5
OG0021192	0	2	1	1	1	0	0	5
OG0021193	0	3	1	1	0	0	0	5
OG0021194	0	5	0	0	0	0	0	5
OG0021195	0	2	0	0	1	1	1	5
OG0021196	0	2	0	0	1	1	1	5
OG0021197	0	4	0	0	1	0	0	5
OG0021198	0	3	0	0	0	1	1	5
OG0021199	0	4	0	0	0	0	1	5
OG0021200	0	2	1	1	0	1	0	5
OG0021201	0	2	0	1	0	1	1	5
OG0021202	0	3	1	0	1	0	0	5
OG0021203	0	2	1	0	1	1	0	5
OG0021204	0	3	0	0	0	1	1	5
OG0021205	0	5	0	0	0	0	0	5
OG0021206	0	3	0	2	0	0	0	5
OG0021207	0	5	0	0	0	0	0	5
OG0021208	0	1	1	1	1	1	0	5
OG0021209	0	4	0	0	0	0	1	5
OG0021210	0	5	0	0	0	0	0	5
OG0021211	0	5	0	0	0	0	0	5
OG0021212	0	4	0	0	0	1	0	5
OG0021213	0	3	0	0	0	1	1	5
OG0021214	0	5	0	0	0	0	0	5
OG0021215	0	3	0	1	1	0	0	5
OG0021216	0	5	0	0	0	0	0	5
OG0021217	0	4	0	1	0	0	0	5
OG0021218	0	2	1	0	0	0	2	5
OG0021219	0	5	0	0	0	0	0	5
OG0021220	0	3	0	2	0	0	0	5
OG0021221	0	4	0	0	0	0	1	5
OG0021222	0	5	0	0	0	0	0	5
OG0021223	0	4	0	0	0	1	0	5
OG0021224	0	5	0	0	0	0	0	5
OG0021225	0	2	0	0	1	0	2	5
OG0021226	0	5	0	0	0	0	0	5
OG0021227	0	2	0	0	1	1	1	5
OG0021228	0	4	1	0	0	0	0	5
OG0021229	0	5	0	0	0	0	0	5
OG0021230	0	5	0	0	0	0	0	5
OG0021231	0	5	0	0	0	0	0	5
OG0021232	0	1	0	3	0	0	1	5
OG0021233	0	2	1	1	1	0	0	5
OG0021234	0	3	1	1	0	0	0	5
OG0021235	0	2	1	0	1	1	0	5
OG0021236	0	1	0	1	3	0	0	5
OG0021237	0	1	1	1	0	1	1	5
OG0021238	0	5	0	0	0	0	0	5
OG0021239	0	3	0	1	0	0	1	5
OG0021240	0	1	1	0	1	1	1	5
OG0021241	0	3	1	0	0	0	1	5
OG0021242	0	2	0	0	1	1	1	5
OG0021243	0	5	0	0	0	0	0	5
OG0021244	0	3	0	0	2	0	0	5
OG0021245	0	3	1	0	0	0	1	5
OG0021246	0	2	1	0	0	1	1	5
OG0021247	0	5	0	0	0	0	0	5
OG0021248	0	1	1	1	0	1	1	5
OG0021249	0	3	1	0	0	0	1	5
OG0021250	0	2	0	1	1	1	0	5
OG0021251	0	5	0	0	0	0	0	5
OG0021252	0	1	1	1	1	0	1	5
OG0021253	0	2	0	0	1	0	2	5
OG0021254	0	3	0	0	1	0	1	5
OG0021255	0	3	0	0	2	0	0	5
OG0021256	0	5	0	0	0	0	0	5
OG0021257	0	2	0	1	0	1	1	5
OG0021258	0	5	0	0	0	0	0	5
OG0021259	0	3	0	1	1	0	0	5
OG0021260	0	3	0	0	1	0	1	5
OG0021261	0	3	0	0	0	0	2	5
OG0021262	0	1	1	0	1	1	1	5
OG0021263	0	1	1	0	1	1	1	5
OG0021264	0	2	1	1	1	0	0	5
OG0021265	0	5	0	0	0	0	0	5
OG0021266	0	3	1	0	0	0	1	5
OG0021267	0	3	0	0	1	0	1	5
OG0021268	0	3	0	1	0	0	1	5
OG0021269	0	5	0	0	0	0	0	5
OG0021270	0	2	0	0	1	1	1	5
OG0021271	0	4	0	0	0	0	1	5
OG0021272	0	5	0	0	0	0	0	5
OG0021273	0	1	3	0	0	0	1	5
OG0021274	0	4	0	0	0	0	1	5
OG0021275	0	2	1	0	1	0	1	5
OG0021276	0	5	0	0	0	0	0	5
OG0021277	0	2	0	1	2	0	0	5
OG0021278	0	3	0	1	1	0	0	5
OG0021279	0	5	0	0	0	0	0	5
OG0021280	0	1	0	0	0	0	4	5
OG0021281	0	2	0	1	0	1	1	5
OG0021282	0	1	0	2	0	1	1	5
OG0021283	0	3	0	1	0	0	1	5
OG0021284	0	5	0	0	0	0	0	5
OG0021285	0	2	0	2	0	0	1	5
OG0021286	0	5	0	0	0	0	0	5
OG0021287	0	4	0	0	0	0	1	5
OG0021288	0	3	0	0	0	1	1	5
OG0021289	0	5	0	0	0	0	0	5
OG0021290	0	5	0	0	0	0	0	5
OG0021291	0	5	0	0	0	0	0	5
OG0021292	0	5	0	0	0	0	0	5
OG0021293	0	3	1	0	0	0	1	5
OG0021294	0	3	0	0	1	1	0	5
OG0021295	0	3	0	1	1	0	0	5
OG0021296	0	2	1	0	0	1	1	5
OG0021297	0	1	1	1	1	0	1	5
OG0021298	0	3	0	0	0	1	1	5
OG0021299	0	5	0	0	0	0	0	5
OG0021300	0	3	2	0	0	0	0	5
OG0021301	0	1	0	1	0	2	1	5
OG0021302	0	4	0	1	0	0	0	5
OG0021303	0	1	1	1	0	1	1	5
OG0021304	0	2	2	0	0	0	1	5
OG0021305	0	4	1	0	0	0	0	5
OG0021306	0	1	1	0	1	1	1	5
OG0021307	0	2	0	0	1	1	1	5
OG0021308	0	4	0	0	1	0	0	5
OG0021309	0	1	1	0	1	1	1	5
OG0021310	0	5	0	0	0	0	0	5
OG0021311	0	3	1	0	1	0	0	5
OG0021312	0	2	0	1	0	1	1	5
OG0021313	0	5	0	0	0	0	0	5
OG0021314	0	5	0	0	0	0	0	5
OG0021315	0	1	1	1	0	1	1	5
OG0021316	0	1	0	0	0	3	1	5
OG0021317	0	5	0	0	0	0	0	5
OG0021318	0	2	0	0	1	1	1	5
OG0021319	0	4	0	1	0	0	0	5
OG0021320	0	5	0	0	0	0	0	5
OG0021321	0	2	1	0	1	0	1	5
OG0021322	0	5	0	0	0	0	0	5
OG0021323	0	2	1	0	0	0	2	5
OG0021324	0	5	0	0	0	0	0	5
OG0021325	0	2	0	0	1	1	1	5
OG0021326	0	1	0	1	1	2	0	5
OG0021327	0	3	1	1	0	0	0	5
OG0021328	0	4	0	0	0	1	0	5
OG0021329	0	5	0	0	0	0	0	5
OG0021330	0	2	0	0	1	1	1	5
OG0021331	0	5	0	0	0	0	0	5
OG0021332	0	5	0	0	0	0	0	5
OG0021333	0	5	0	0	0	0	0	5
OG0021334	0	2	0	0	0	1	2	5
OG0021335	0	5	0	0	0	0	0	5
OG0021336	0	1	0	1	1	1	1	5
OG0021337	0	4	1	0	0	0	0	5
OG0021338	0	2	1	0	0	1	1	5
OG0021339	0	4	0	1	0	0	0	5
OG0021340	0	5	0	0	0	0	0	5
OG0021341	0	3	0	1	0	1	0	5
OG0021342	0	3	0	0	1	1	0	5
OG0021343	0	2	0	1	1	0	1	5
OG0021344	0	2	0	1	0	1	1	5
OG0021345	0	5	0	0	0	0	0	5
OG0021346	0	1	1	1	0	1	1	5
OG0021347	0	1	1	0	0	1	2	5
OG0021348	0	3	0	0	0	0	2	5
OG0021349	0	4	0	1	0	0	0	5
OG0021350	0	3	0	1	0	0	1	5
OG0021351	0	5	0	0	0	0	0	5
OG0021352	0	4	0	1	0	0	0	5
OG0021353	0	2	0	0	1	1	1	5
OG0021354	0	2	0	0	1	1	1	5
OG0021355	0	5	0	0	0	0	0	5
OG0021356	0	3	0	1	1	0	0	5
OG0021357	0	4	0	0	0	0	1	5
OG0021358	0	2	0	0	0	1	2	5
OG0021359	0	2	1	1	1	0	0	5
OG0021360	0	1	0	1	0	2	1	5
OG0021361	0	5	0	0	0	0	0	5
OG0021362	0	2	1	0	1	0	1	5
OG0021363	0	2	0	0	1	1	1	5
OG0021364	0	2	1	1	1	0	0	5
OG0021365	0	5	0	0	0	0	0	5
OG0021366	0	2	0	0	0	1	2	5
OG0021367	0	4	1	0	0	0	0	5
OG0021368	0	3	1	0	0	1	0	5
OG0021369	0	1	1	0	0	1	2	5
OG0021370	0	3	0	0	1	1	0	5
OG0021371	0	4	1	0	0	0	0	5
OG0021372	0	2	0	1	1	1	0	5
OG0021373	0	4	0	1	0	0	0	5
OG0021374	0	3	0	1	1	0	0	5
OG0021375	0	3	1	0	0	1	0	5
OG0021376	0	2	0	0	0	2	1	5
OG0021377	0	5	0	0	0	0	0	5
OG0021378	0	1	1	1	0	1	1	5
OG0021379	0	5	0	0	0	0	0	5
OG0021380	0	2	1	0	0	0	2	5
OG0021381	0	5	0	0	0	0	0	5
OG0021382	0	1	0	0	0	0	4	5
OG0021383	0	1	0	1	1	0	2	5
OG0021384	0	5	0	0	0	0	0	5
OG0021385	0	2	0	1	1	1	0	5
OG0021386	0	4	0	0	0	0	1	5
OG0021387	0	2	0	1	1	0	1	5
OG0021388	0	3	1	0	0	1	0	5
OG0021389	0	2	1	1	0	0	1	5
OG0021390	0	3	1	0	0	0	1	5
OG0021391	0	5	0	0	0	0	0	5
OG0021392	0	5	0	0	0	0	0	5
OG0021393	0	3	0	1	0	1	0	5
OG0021394	0	3	0	1	0	0	1	5
OG0021395	0	1	1	2	0	1	0	5
OG0021396	0	1	2	1	0	0	1	5
OG0021397	0	4	1	0	0	0	0	5
OG0021398	0	4	0	0	0	0	1	5
OG0021399	0	5	0	0	0	0	0	5
OG0021400	0	5	0	0	0	0	0	5
OG0021401	0	3	0	0	0	1	1	5
OG0021402	0	2	1	0	1	0	1	5
OG0021403	0	5	0	0	0	0	0	5
OG0021404	0	5	0	0	0	0	0	5
OG0021405	0	2	0	0	2	0	1	5
OG0021406	0	2	1	0	1	0	1	5
OG0021407	0	2	0	1	2	0	0	5
OG0021408	0	5	0	0	0	0	0	5
OG0021409	0	1	1	1	1	1	0	5
OG0021410	0	4	0	0	1	0	0	5
OG0021411	0	2	0	0	1	1	1	5
OG0021412	0	4	1	0	0	0	0	5
OG0021413	0	5	0	0	0	0	0	5
OG0021414	0	5	0	0	0	0	0	5
OG0021415	0	3	0	0	0	0	2	5
OG0021416	0	3	1	0	1	0	0	5
OG0021417	0	2	0	1	1	1	0	5
OG0021418	0	4	0	0	0	0	1	5
OG0021419	0	2	0	0	0	2	1	5
OG0021420	0	2	1	0	0	1	1	5
OG0021421	0	3	2	0	0	0	0	5
OG0021422	0	5	0	0	0	0	0	5
OG0021423	0	2	1	1	0	1	0	5
OG0021424	0	3	1	0	0	0	1	5
OG0021425	0	5	0	0	0	0	0	5
OG0021426	0	1	0	1	0	2	1	5
OG0021427	0	4	0	0	0	0	1	5
OG0021428	0	5	0	0	0	0	0	5
OG0021429	0	5	0	0	0	0	0	5
OG0021430	0	2	0	0	1	1	1	5
OG0021431	0	3	1	1	0	0	0	5
OG0021432	0	3	1	0	1	0	0	5
OG0021433	0	2	0	1	2	0	0	5
OG0021434	0	5	0	0	0	0	0	5
OG0021435	0	4	0	0	0	0	1	5
OG0021436	0	5	0	0	0	0	0	5
OG0021437	0	3	0	1	0	1	0	5
OG0021438	0	2	0	1	1	1	0	5
OG0021439	0	5	0	0	0	0	0	5
OG0021440	0	2	0	0	0	2	1	5
OG0021441	0	5	0	0	0	0	0	5
OG0021442	0	4	1	0	0	0	0	5
OG0021443	0	2	0	1	0	1	1	5
OG0021444	0	5	0	0	0	0	0	5
OG0021445	0	2	1	1	0	0	1	5
OG0021446	0	2	1	1	0	0	1	5
OG0021447	0	2	0	0	0	0	3	5
OG0021448	0	1	0	0	0	0	4	5
OG0021449	0	1	0	1	0	1	2	5
OG0021450	0	2	1	1	0	1	0	5
OG0021451	0	1	0	1	1	1	1	5
OG0021452	0	3	0	0	2	0	0	5
OG0021453	0	2	0	1	0	1	1	5
OG0021454	0	2	0	1	0	1	1	5
OG0021455	0	5	0	0	0	0	0	5
OG0021456	0	1	1	1	1	0	1	5
OG0021457	0	3	0	1	0	0	1	5
OG0021458	0	2	0	1	1	1	0	5
OG0021459	0	2	1	0	0	1	1	5
OG0021460	0	2	0	0	1	1	1	5
OG0021461	0	4	0	0	0	0	1	5
OG0021462	0	5	0	0	0	0	0	5
OG0021463	0	1	1	1	0	1	1	5
OG0021464	0	3	0	0	2	0	0	5
OG0021465	0	4	1	0	0	0	0	5
OG0021466	0	4	0	0	1	0	0	5
OG0021467	0	3	0	0	1	0	1	5
OG0021468	0	3	0	0	2	0	0	5
OG0021469	0	2	0	0	3	0	0	5
OG0021470	0	2	0	1	0	1	1	5
OG0021471	0	5	0	0	0	0	0	5
OG0021472	0	4	0	0	1	0	0	5
OG0021473	0	5	0	0	0	0	0	5
OG0021474	0	3	1	1	0	0	0	5
OG0021475	0	4	1	0	0	0	0	5
OG0021476	0	5	0	0	0	0	0	5
OG0021477	0	4	0	0	0	0	1	5
OG0021478	0	3	0	1	0	0	1	5
OG0021479	0	2	1	0	1	0	1	5
OG0021480	0	2	2	0	0	0	1	5
OG0021481	0	2	1	0	1	0	1	5
OG0021482	0	5	0	0	0	0	0	5
OG0021483	0	2	1	0	1	0	1	5
OG0021484	0	2	0	0	2	0	1	5
OG0021485	0	1	3	0	0	1	0	5
OG0021486	0	1	0	1	1	1	1	5
OG0021487	0	2	0	1	2	0	0	5
OG0021488	0	4	0	0	1	0	0	5
OG0021489	0	2	0	0	1	1	1	5
OG0021490	0	1	0	1	1	1	1	5
OG0021491	0	1	0	1	1	1	1	5
OG0021492	0	3	0	0	1	1	0	5
OG0021493	0	4	0	0	0	0	1	5
OG0021494	0	5	0	0	0	0	0	5
OG0021495	0	5	0	0	0	0	0	5
OG0021496	0	5	0	0	0	0	0	5
OG0021497	0	4	0	0	0	0	1	5
OG0021498	0	2	0	1	0	1	1	5
OG0021499	0	3	1	0	0	0	1	5
OG0021500	0	3	0	1	0	1	0	5
OG0021501	0	2	1	1	0	1	0	5
OG0021502	0	2	0	1	0	1	1	5
OG0021503	0	3	0	1	0	1	0	5
OG0021504	0	5	0	0	0	0	0	5
OG0021505	0	2	0	1	0	1	1	5
OG0021506	0	4	0	0	0	1	0	5
OG0021507	0	5	0	0	0	0	0	5
OG0021508	0	5	0	0	0	0	0	5
OG0021509	0	1	0	0	1	0	3	5
OG0021510	0	4	0	0	1	0	0	5
OG0021511	0	2	1	0	0	0	2	5
OG0021512	0	2	0	0	1	1	1	5
OG0021513	0	1	3	0	0	1	0	5
OG0021514	0	2	0	0	1	1	1	5
OG0021515	0	2	2	0	0	0	1	5
OG0021516	0	2	0	1	0	1	1	5
OG0021517	0	2	0	1	0	1	1	5
OG0021518	0	5	0	0	0	0	0	5
OG0021519	0	2	0	1	0	1	1	5
OG0021520	0	5	0	0	0	0	0	5
OG0021521	0	2	0	1	1	0	1	5
OG0021522	0	3	0	1	0	0	1	5
OG0021523	0	5	0	0	0	0	0	5
OG0021524	0	2	1	1	0	1	0	5
OG0021525	0	1	0	1	0	0	3	5
OG0021526	0	1	0	0	0	0	4	5
OG0021527	0	2	0	1	2	0	0	5
OG0021528	0	3	1	0	0	0	1	5
OG0021529	0	2	1	1	0	0	1	5
OG0021530	0	1	1	1	1	1	0	5
OG0021531	0	1	1	0	0	1	2	5
OG0021532	0	3	1	0	0	0	1	5
OG0021533	0	1	1	1	1	0	1	5
OG0021534	0	3	0	0	2	0	0	5
OG0021535	0	2	0	1	1	0	1	5
OG0021536	0	4	1	0	0	0	0	5
OG0021537	0	1	1	0	0	0	3	5
OG0021538	0	1	1	1	1	0	1	5
OG0021539	0	2	0	1	0	1	1	5
OG0021540	0	4	0	1	0	0	0	5
OG0021541	0	3	1	1	0	0	0	5
OG0021542	0	5	0	0	0	0	0	5
OG0021543	0	4	0	0	1	0	0	5
OG0021544	0	5	0	0	0	0	0	5
OG0021545	0	5	0	0	0	0	0	5
OG0021546	0	4	0	0	0	0	1	5
OG0021547	0	2	1	0	0	1	1	5
OG0021548	0	1	0	1	1	1	1	5
OG0021549	0	4	0	0	0	0	1	5
OG0021550	0	2	0	0	0	2	1	5
OG0021551	0	3	1	0	0	0	1	5
OG0021552	0	2	0	0	0	0	3	5
OG0021553	0	5	0	0	0	0	0	5
OG0021554	0	1	1	1	0	2	0	5
OG0021555	0	5	0	0	0	0	0	5
OG0021556	0	5	0	0	0	0	0	5
OG0021557	0	2	1	1	0	0	1	5
OG0021558	0	4	0	0	1	0	0	5
OG0021559	0	5	0	0	0	0	0	5
OG0021560	0	3	0	1	1	0	0	5
OG0021561	0	1	4	0	0	0	0	5
OG0021562	0	5	0	0	0	0	0	5
OG0021563	0	2	0	1	0	1	1	5
OG0021564	0	2	1	0	0	1	1	5
OG0021565	0	2	1	0	1	1	0	5
OG0021566	0	4	1	0	0	0	0	5
OG0021567	0	1	1	1	1	0	1	5
OG0021568	0	2	3	0	0	0	0	5
OG0021569	0	1	1	1	0	1	1	5
OG0021570	0	3	0	0	1	1	0	5
OG0021571	0	2	0	1	1	1	0	5
OG0021572	0	3	1	0	0	0	1	5
OG0021573	0	4	0	0	0	0	1	5
OG0021574	0	2	1	0	2	0	0	5
OG0021575	0	1	1	1	1	1	0	5
OG0021576	0	2	0	1	2	0	0	5
OG0021577	0	3	0	1	0	0	1	5
OG0021578	0	2	0	0	1	2	0	5
OG0021579	0	3	1	0	1	0	0	5
OG0021580	0	3	0	0	1	0	1	5
OG0021581	0	2	0	1	0	1	1	5
OG0021582	0	3	0	1	0	0	1	5
OG0021583	0	2	1	0	1	0	1	5
OG0021584	0	5	0	0	0	0	0	5
OG0021585	0	1	1	0	1	1	1	5
OG0021586	0	1	0	0	2	1	1	5
OG0021587	0	1	0	0	0	0	4	5
OG0021588	0	2	0	0	3	0	0	5
OG0021589	0	2	0	0	1	1	1	5
OG0021590	0	5	0	0	0	0	0	5
OG0021591	0	2	0	0	1	1	1	5
OG0021592	0	1	1	0	1	2	0	5
OG0021593	0	5	0	0	0	0	0	5
OG0021594	0	2	0	1	1	1	0	5
OG0021595	0	5	0	0	0	0	0	5
OG0021596	0	2	0	1	1	0	1	5
OG0021597	0	2	0	0	1	1	1	5
OG0021598	0	3	1	0	1	0	0	5
OG0021599	0	2	0	1	1	1	0	5
OG0021600	0	3	1	1	0	0	0	5
OG0021601	0	5	0	0	0	0	0	5
OG0021602	0	2	0	0	0	1	2	5
OG0021603	0	2	1	1	0	1	0	5
OG0021604	0	5	0	0	0	0	0	5
OG0021605	0	5	0	0	0	0	0	5
OG0021606	0	1	0	0	1	0	3	5
OG0021607	0	1	1	0	1	1	1	5
OG0021608	0	1	0	0	4	0	0	5
OG0021609	0	1	1	1	1	1	0	5
OG0021610	0	1	1	1	0	1	1	5
OG0021611	0	1	0	1	0	1	2	5
OG0021612	0	2	1	1	0	0	1	5
OG0021613	0	2	0	0	0	1	2	5
OG0021614	0	3	0	2	0	0	0	5
OG0021615	0	3	0	1	0	0	1	5
OG0021616	0	2	1	1	0	1	0	5
OG0021617	0	1	1	1	0	1	1	5
OG0021618	0	4	0	1	0	0	0	5
OG0021619	0	2	0	0	1	1	1	5
OG0021620	0	1	0	1	1	1	1	5
OG0021621	0	2	2	0	0	0	1	5
OG0021622	0	2	0	0	0	1	2	5
OG0021623	0	3	0	0	1	0	1	5
OG0021624	0	1	0	1	0	2	1	5
OG0021625	0	2	0	1	0	0	2	5
OG0021626	0	5	0	0	0	0	0	5
OG0021627	0	2	1	0	0	1	1	5
OG0021628	0	3	0	1	1	0	0	5
OG0021629	0	1	2	0	0	0	2	5
OG0021630	0	4	0	0	0	0	1	5
OG0021631	0	5	0	0	0	0	0	5
OG0021632	0	2	0	1	1	0	1	5
OG0021633	0	2	1	1	0	0	1	5
OG0021634	0	2	0	1	0	1	1	5
OG0021635	0	2	0	0	0	1	2	5
OG0021636	0	4	0	1	0	0	0	5
OG0021637	0	2	1	1	0	0	1	5
OG0021638	0	2	1	0	0	1	1	5
OG0021639	0	1	0	0	0	3	1	5
OG0021640	0	2	0	0	0	2	1	5
OG0021641	0	3	0	0	0	1	1	5
OG0021642	0	5	0	0	0	0	0	5
OG0021643	0	1	0	0	1	1	2	5
OG0021644	0	1	0	0	0	0	4	5
OG0021645	0	1	0	1	1	1	1	5
OG0021646	0	2	1	0	0	0	2	5
OG0021647	0	2	0	0	1	1	1	5
OG0021648	0	3	0	0	1	0	1	5
OG0021649	0	1	1	0	0	2	1	5
OG0021650	0	1	4	0	0	0	0	5
OG0021651	0	1	0	1	0	0	3	5
OG0021652	0	1	1	1	1	0	1	5
OG0021653	0	5	0	0	0	0	0	5
OG0021654	0	2	1	0	0	1	1	5
OG0021655	0	2	0	1	2	0	0	5
OG0021656	0	5	0	0	0	0	0	5
OG0021657	0	1	1	0	0	0	3	5
OG0021658	0	2	0	0	1	1	1	5
OG0021659	0	5	0	0	0	0	0	5
OG0021660	0	2	0	0	1	1	1	5
OG0021661	0	5	0	0	0	0	0	5
OG0021662	0	3	0	1	1	0	0	5
OG0021663	0	1	0	0	1	2	1	5
OG0021664	0	3	0	2	0	0	0	5
OG0021665	0	2	1	0	0	1	1	5
OG0021666	0	1	1	1	1	1	0	5
OG0021667	0	3	0	1	1	0	0	5
OG0021668	0	5	0	0	0	0	0	5
OG0021669	0	5	0	0	0	0	0	5
OG0021670	0	3	0	0	0	0	2	5
OG0021671	0	1	1	0	1	1	1	5
OG0021672	0	1	1	1	0	1	1	5
OG0021673	0	5	0	0	0	0	0	5
OG0021674	0	2	1	0	1	0	1	5
OG0021675	0	1	0	0	0	1	3	5
OG0021676	0	2	0	1	0	0	2	5
OG0021677	0	3	1	1	0	0	0	5
OG0021678	0	1	1	1	1	0	1	5
OG0021679	0	4	0	0	1	0	0	5
OG0021680	0	1	0	0	1	1	2	5
OG0021681	0	3	1	1	0	0	0	5
OG0021682	0	2	0	0	2	1	0	5
OG0021683	0	1	4	0	0	0	0	5
OG0021684	0	2	0	0	3	0	0	5
OG0021685	0	2	0	1	0	1	1	5
OG0021686	0	1	1	2	0	0	1	5
OG0021687	0	1	0	0	0	0	4	5
OG0021688	0	2	0	0	1	1	1	5
OG0021689	0	2	1	1	0	1	0	5
OG0021690	0	3	0	0	1	1	0	5
OG0021691	0	3	1	0	0	0	1	5
OG0021692	0	2	0	0	2	0	1	5
OG0021693	0	1	1	0	1	1	1	5
OG0021694	0	1	0	0	0	1	3	5
OG0021695	0	1	1	0	1	1	1	5
OG0021696	0	2	1	1	0	1	0	5
OG0021697	0	5	0	0	0	0	0	5
OG0021698	0	1	1	1	1	1	0	5
OG0021699	0	1	1	1	1	1	0	5
OG0021700	0	2	1	1	0	1	0	5
OG0021701	0	2	1	1	0	0	1	5
OG0021702	0	2	1	0	1	1	0	5
OG0021703	0	2	0	0	1	1	1	5
OG0021704	0	2	2	0	1	0	0	5
OG0021705	0	1	0	0	0	0	4	5
OG0021706	0	2	0	0	1	0	2	5
OG0021707	0	3	1	1	0	0	0	5
OG0021708	0	4	0	1	0	0	0	5
OG0021709	0	1	1	0	1	1	1	5
OG0021710	0	3	0	0	0	1	1	5
OG0021711	0	1	1	1	1	1	0	5
OG0021712	0	1	1	1	1	1	0	5
OG0021713	0	1	0	0	0	1	3	5
OG0021714	0	1	0	0	0	0	4	5
OG0021715	0	1	0	1	1	1	1	5
OG0021716	0	1	0	1	1	1	1	5
OG0021717	0	2	0	0	0	0	3	5
OG0021718	0	3	0	1	0	0	1	5
OG0021719	0	1	1	1	1	1	0	5
OG0021720	0	1	1	1	1	0	1	5
OG0021721	0	2	0	0	3	0	0	5
OG0021722	0	1	2	0	0	1	1	5
OG0021723	0	2	0	0	3	0	0	5
OG0021724	0	3	0	1	1	0	0	5
OG0021725	0	1	2	1	0	1	0	5
OG0021726	0	2	1	1	0	1	0	5
OG0021727	0	2	1	1	1	0	0	5
OG0021728	0	1	0	3	0	1	0	5
OG0021729	0	1	1	1	1	0	1	5
OG0021730	0	5	0	0	0	0	0	5
OG0021731	0	2	0	1	1	1	0	5
OG0021732	0	1	1	0	0	0	3	5
OG0021733	0	3	0	0	2	0	0	5
OG0021734	0	2	0	0	1	2	0	5
OG0021735	0	1	1	1	1	1	0	5
OG0021736	0	1	2	1	0	0	1	5
OG0021737	0	1	1	1	0	1	1	5
OG0021738	0	1	0	1	1	1	1	5
OG0021739	0	1	0	0	2	1	1	5
OG0021740	0	1	1	0	1	1	1	5
OG0021741	0	3	0	1	1	0	0	5
OG0021742	0	2	1	1	0	0	1	5
OG0021743	0	2	0	2	0	1	0	5
OG0021744	0	1	0	1	1	1	1	5
OG0021745	0	3	0	1	1	0	0	5
OG0021746	0	4	1	0	0	0	0	5
OG0021747	0	1	1	1	0	2	0	5
OG0021748	0	2	0	1	0	1	1	5
OG0021749	0	1	0	0	2	1	1	5
OG0021750	0	3	0	1	0	0	1	5
OG0021751	0	1	1	0	1	1	1	5
OG0021752	0	1	0	0	1	0	3	5
OG0021753	0	1	1	1	0	0	2	5
OG0021754	0	2	1	1	1	0	0	5
OG0021755	0	2	1	0	1	0	1	5
OG0021756	0	1	1	1	0	1	1	5
OG0021757	0	1	0	2	0	1	1	5
OG0021758	0	1	0	2	0	1	1	5
OG0021759	0	1	1	1	0	1	1	5
OG0021760	0	1	0	0	0	3	1	5
OG0021761	0	0	1	1	1	1	1	5
OG0021762	0	0	5	0	0	0	0	5
OG0021763	0	0	5	0	0	0	0	5
OG0021764	0	0	1	1	1	1	1	5
OG0021765	0	0	1	1	1	1	1	5
OG0021766	0	0	1	2	1	0	1	5
OG0021767	0	0	1	1	1	1	1	5
OG0021768	0	0	1	1	1	1	1	5
OG0021769	0	0	1	1	1	1	1	5
OG0021770	0	0	1	1	0	0	3	5
OG0021771	0	0	1	1	1	1	1	5
OG0021772	0	0	1	1	1	1	1	5
OG0021773	0	0	1	0	0	1	3	5
OG0021774	0	0	2	1	1	0	1	5
OG0021775	0	0	1	1	1	1	1	5
OG0021776	0	0	1	1	1	1	1	5
OG0021777	0	0	2	0	0	0	3	5
OG0021778	0	0	1	0	0	2	2	5
OG0021779	0	0	1	1	1	1	1	5
OG0021780	0	0	1	1	1	1	1	5
OG0021781	0	0	3	0	1	0	1	5
OG0021782	0	0	1	1	1	1	1	5
OG0021783	0	0	3	0	0	0	2	5
OG0021784	0	0	2	0	1	1	1	5
OG0021785	0	0	1	1	1	1	1	5
OG0021786	0	0	1	1	1	1	1	5
OG0021787	0	0	5	0	0	0	0	5
OG0021788	0	0	1	1	1	1	1	5
OG0021789	0	0	1	1	1	1	1	5
OG0021790	0	0	1	1	1	1	1	5
OG0021791	0	0	1	1	2	1	0	5
OG0021792	0	0	1	1	1	1	1	5
OG0021793	0	0	1	1	1	1	1	5
OG0021794	0	0	1	1	1	1	1	5
OG0021795	0	0	1	1	1	1	1	5
OG0021796	0	0	1	1	1	1	1	5
OG0021797	0	0	1	1	1	1	1	5
OG0021798	0	0	1	1	1	1	1	5
OG0021799	0	0	1	1	1	1	1	5
OG0021800	0	0	1	1	1	1	1	5
OG0021801	0	0	1	1	1	1	1	5
OG0021802	0	0	1	1	1	1	1	5
OG0021803	0	0	1	0	0	2	2	5
OG0021804	0	0	1	1	1	1	1	5
OG0021805	0	0	1	0	2	1	1	5
OG0021806	0	0	2	1	0	0	2	5
OG0021807	0	0	1	0	0	0	4	5
OG0021808	0	0	1	1	1	1	1	5
OG0021809	0	0	1	1	0	2	1	5
OG0021810	0	0	2	0	2	0	1	5
OG0021811	0	0	1	1	1	1	1	5
OG0021812	0	0	1	1	1	1	1	5
OG0021813	0	0	1	1	1	1	1	5
OG0021814	0	0	1	1	2	0	1	5
OG0021815	0	0	1	1	1	1	1	5
OG0021816	0	0	2	1	0	1	1	5
OG0021817	0	0	1	1	1	1	1	5
OG0021818	0	0	1	0	0	0	4	5
OG0021819	0	0	2	0	0	0	3	5
OG0021820	0	0	1	0	1	1	2	5
OG0021821	0	0	1	1	1	1	1	5
OG0021822	0	0	1	1	1	1	1	5
OG0021823	0	0	1	1	1	1	1	5
OG0021824	0	0	1	1	1	1	1	5
OG0021825	0	0	0	1	0	1	3	5
OG0021826	0	0	0	2	2	1	0	5
OG0021827	0	0	0	4	0	1	0	5
OG0021828	0	0	0	2	0	1	2	5
OG0021829	0	0	0	2	3	0	0	5
OG0021830	0	0	0	2	1	1	1	5
OG0021831	0	0	0	2	0	0	3	5
OG0021832	0	0	0	2	2	1	0	5
OG0021833	0	0	0	1	2	1	1	5
OG0021834	0	0	0	1	0	0	4	5
OG0021835	0	0	0	0	3	1	1	5
OG0021836	0	0	0	0	2	3	0	5
OG0021837	0	0	0	0	2	2	1	5
OG0021838	0	0	0	0	5	0	0	5
OG0021839	0	0	0	0	1	2	2	5
OG0021840	0	0	0	0	2	1	2	5
OG0021841	0	0	0	0	2	1	2	5
OG0021842	0	0	0	0	0	1	4	5
OG0021843	0	0	0	0	0	2	3	5
OG0021844	0	0	0	0	0	2	3	5
OG0021845	0	0	0	0	0	1	4	5
OG0021846	0	0	0	0	0	0	5	5
OG0021847	0	0	0	0	0	0	5	5
OG0021848	0	0	0	0	0	0	5	5
OG0021849	0	0	0	0	0	0	5	5
OG0021850	0	0	0	0	0	0	5	5
OG0021851	0	0	0	0	0	0	5	5
OG0021852	0	0	0	0	0	0	5	5
OG0021853	0	0	0	0	0	0	5	5
OG0021854	0	0	0	0	0	0	5	5
OG0021855	0	0	0	0	0	0	5	5
OG0021856	0	0	0	0	0	0	5	5
OG0021857	0	0	0	0	0	0	5	5
OG0021858	0	0	0	0	0	0	5	5
OG0021859	4	0	0	0	0	0	0	4
OG0021860	4	0	0	0	0	0	0	4
OG0021861	3	1	0	0	0	0	0	4
OG0021862	3	0	1	0	0	0	0	4
OG0021863	4	0	0	0	0	0	0	4
OG0021864	1	0	1	1	0	0	1	4
OG0021865	4	0	0	0	0	0	0	4
OG0021866	4	0	0	0	0	0	0	4
OG0021867	1	2	1	0	0	0	0	4
OG0021868	4	0	0	0	0	0	0	4
OG0021869	4	0	0	0	0	0	0	4
OG0021870	4	0	0	0	0	0	0	4
OG0021871	4	0	0	0	0	0	0	4
OG0021872	4	0	0	0	0	0	0	4
OG0021873	1	0	1	1	1	0	0	4
OG0021874	4	0	0	0	0	0	0	4
OG0021875	3	1	0	0	0	0	0	4
OG0021876	4	0	0	0	0	0	0	4
OG0021877	3	1	0	0	0	0	0	4
OG0021878	4	0	0	0	0	0	0	4
OG0021879	4	0	0	0	0	0	0	4
OG0021880	4	0	0	0	0	0	0	4
OG0021881	4	0	0	0	0	0	0	4
OG0021882	4	0	0	0	0	0	0	4
OG0021883	4	0	0	0	0	0	0	4
OG0021884	4	0	0	0	0	0	0	4
OG0021885	4	0	0	0	0	0	0	4
OG0021886	4	0	0	0	0	0	0	4
OG0021887	2	0	1	0	0	1	0	4
OG0021888	4	0	0	0	0	0	0	4
OG0021889	2	2	0	0	0	0	0	4
OG0021890	3	0	0	1	0	0	0	4
OG0021891	4	0	0	0	0	0	0	4
OG0021892	4	0	0	0	0	0	0	4
OG0021893	4	0	0	0	0	0	0	4
OG0021894	2	2	0	0	0	0	0	4
OG0021895	1	0	0	1	1	1	0	4
OG0021896	1	0	1	0	0	0	2	4
OG0021897	4	0	0	0	0	0	0	4
OG0021898	2	2	0	0	0	0	0	4
OG0021899	1	2	1	0	0	0	0	4
OG0021900	4	0	0	0	0	0	0	4
OG0021901	2	1	1	0	0	0	0	4
OG0021902	2	1	1	0	0	0	0	4
OG0021903	4	0	0	0	0	0	0	4
OG0021904	4	0	0	0	0	0	0	4
OG0021905	2	1	1	0	0	0	0	4
OG0021906	4	0	0	0	0	0	0	4
OG0021907	4	0	0	0	0	0	0	4
OG0021908	4	0	0	0	0	0	0	4
OG0021909	4	0	0	0	0	0	0	4
OG0021910	3	0	0	1	0	0	0	4
OG0021911	4	0	0	0	0	0	0	4
OG0021912	4	0	0	0	0	0	0	4
OG0021913	4	0	0	0	0	0	0	4
OG0021914	4	0	0	0	0	0	0	4
OG0021915	4	0	0	0	0	0	0	4
OG0021916	1	0	0	0	0	1	2	4
OG0021917	4	0	0	0	0	0	0	4
OG0021918	4	0	0	0	0	0	0	4
OG0021919	4	0	0	0	0	0	0	4
OG0021920	4	0	0	0	0	0	0	4
OG0021921	3	0	0	0	1	0	0	4
OG0021922	1	2	0	0	0	0	1	4
OG0021923	3	0	0	0	0	1	0	4
OG0021924	2	2	0	0	0	0	0	4
OG0021925	2	0	1	0	0	0	1	4
OG0021926	4	0	0	0	0	0	0	4
OG0021927	4	0	0	0	0	0	0	4
OG0021928	4	0	0	0	0	0	0	4
OG0021929	1	1	1	1	0	0	0	4
OG0021930	4	0	0	0	0	0	0	4
OG0021931	4	0	0	0	0	0	0	4
OG0021932	2	0	1	0	0	0	1	4
OG0021933	2	0	1	0	0	0	1	4
OG0021934	1	1	1	0	0	0	1	4
OG0021935	4	0	0	0	0	0	0	4
OG0021936	4	0	0	0	0	0	0	4
OG0021937	4	0	0	0	0	0	0	4
OG0021938	1	2	1	0	0	0	0	4
OG0021939	4	0	0	0	0	0	0	4
OG0021940	4	0	0	0	0	0	0	4
OG0021941	1	1	0	0	0	1	1	4
OG0021942	1	3	0	0	0	0	0	4
OG0021943	4	0	0	0	0	0	0	4
OG0021944	2	0	1	0	0	1	0	4
OG0021945	4	0	0	0	0	0	0	4
OG0021946	1	2	0	0	1	0	0	4
OG0021947	4	0	0	0	0	0	0	4
OG0021948	4	0	0	0	0	0	0	4
OG0021949	2	0	1	0	0	1	0	4
OG0021950	4	0	0	0	0	0	0	4
OG0021951	1	1	1	0	0	0	1	4
OG0021952	1	1	1	1	0	0	0	4
OG0021953	4	0	0	0	0	0	0	4
OG0021954	2	0	0	2	0	0	0	4
OG0021955	4	0	0	0	0	0	0	4
OG0021956	4	0	0	0	0	0	0	4
OG0021957	4	0	0	0	0	0	0	4
OG0021958	4	0	0	0	0	0	0	4
OG0021959	1	1	0	0	0	1	1	4
OG0021960	4	0	0	0	0	0	0	4
OG0021961	4	0	0	0	0	0	0	4
OG0021962	1	2	0	0	0	0	1	4
OG0021963	2	1	1	0	0	0	0	4
OG0021964	4	0	0	0	0	0	0	4
OG0021965	4	0	0	0	0	0	0	4
OG0021966	2	0	1	0	0	0	1	4
OG0021967	4	0	0	0	0	0	0	4
OG0021968	4	0	0	0	0	0	0	4
OG0021969	1	2	0	1	0	0	0	4
OG0021970	1	3	0	0	0	0	0	4
OG0021971	4	0	0	0	0	0	0	4
OG0021972	2	1	1	0	0	0	0	4
OG0021973	4	0	0	0	0	0	0	4
OG0021974	4	0	0	0	0	0	0	4
OG0021975	4	0	0	0	0	0	0	4
OG0021976	4	0	0	0	0	0	0	4
OG0021977	2	0	1	0	0	0	1	4
OG0021978	4	0	0	0	0	0	0	4
OG0021979	4	0	0	0	0	0	0	4
OG0021980	1	3	0	0	0	0	0	4
OG0021981	4	0	0	0	0	0	0	4
OG0021982	2	0	1	0	0	0	1	4
OG0021983	4	0	0	0	0	0	0	4
OG0021984	4	0	0	0	0	0	0	4
OG0021985	4	0	0	0	0	0	0	4
OG0021986	1	2	1	0	0	0	0	4
OG0021987	2	1	0	0	0	0	1	4
OG0021988	2	0	1	0	0	0	1	4
OG0021989	4	0	0	0	0	0	0	4
OG0021990	1	2	0	1	0	0	0	4
OG0021991	1	0	0	0	0	2	1	4
OG0021992	3	0	0	0	0	0	1	4
OG0021993	1	2	0	1	0	0	0	4
OG0021994	4	0	0	0	0	0	0	4
OG0021995	4	0	0	0	0	0	0	4
OG0021996	4	0	0	0	0	0	0	4
OG0021997	3	1	0	0	0	0	0	4
OG0021998	1	0	1	0	0	1	1	4
OG0021999	4	0	0	0	0	0	0	4
OG0022000	4	0	0	0	0	0	0	4
OG0022001	1	2	1	0	0	0	0	4
OG0022002	4	0	0	0	0	0	0	4
OG0022003	4	0	0	0	0	0	0	4
OG0022004	4	0	0	0	0	0	0	4
OG0022005	4	0	0	0	0	0	0	4
OG0022006	4	0	0	0	0	0	0	4
OG0022007	1	3	0	0	0	0	0	4
OG0022008	4	0	0	0	0	0	0	4
OG0022009	4	0	0	0	0	0	0	4
OG0022010	4	0	0	0	0	0	0	4
OG0022011	4	0	0	0	0	0	0	4
OG0022012	1	3	0	0	0	0	0	4
OG0022013	2	1	0	1	0	0	0	4
OG0022014	1	2	0	0	0	0	1	4
OG0022015	1	0	2	0	0	0	1	4
OG0022016	1	1	0	0	0	0	2	4
OG0022017	1	1	1	0	0	0	1	4
OG0022018	4	0	0	0	0	0	0	4
OG0022019	4	0	0	0	0	0	0	4
OG0022020	1	1	0	0	0	0	2	4
OG0022021	4	0	0	0	0	0	0	4
OG0022022	1	0	1	0	0	0	2	4
OG0022023	1	2	0	0	0	1	0	4
OG0022024	4	0	0	0	0	0	0	4
OG0022025	4	0	0	0	0	0	0	4
OG0022026	4	0	0	0	0	0	0	4
OG0022027	4	0	0	0	0	0	0	4
OG0022028	2	1	0	0	1	0	0	4
OG0022029	4	0	0	0	0	0	0	4
OG0022030	3	0	0	0	1	0	0	4
OG0022031	1	2	1	0	0	0	0	4
OG0022032	4	0	0	0	0	0	0	4
OG0022033	1	2	1	0	0	0	0	4
OG0022034	2	1	0	0	1	0	0	4
OG0022035	1	1	1	0	0	0	1	4
OG0022036	1	1	0	0	1	0	1	4
OG0022037	4	0	0	0	0	0	0	4
OG0022038	1	1	1	0	0	0	1	4
OG0022039	4	0	0	0	0	0	0	4
OG0022040	4	0	0	0	0	0	0	4
OG0022041	4	0	0	0	0	0	0	4
OG0022042	1	0	0	0	0	0	3	4
OG0022043	4	0	0	0	0	0	0	4
OG0022044	4	0	0	0	0	0	0	4
OG0022045	4	0	0	0	0	0	0	4
OG0022046	4	0	0	0	0	0	0	4
OG0022047	4	0	0	0	0	0	0	4
OG0022048	1	1	1	0	1	0	0	4
OG0022049	1	1	1	1	0	0	0	4
OG0022050	4	0	0	0	0	0	0	4
OG0022051	1	0	1	0	1	1	0	4
OG0022052	2	2	0	0	0	0	0	4
OG0022053	4	0	0	0	0	0	0	4
OG0022054	4	0	0	0	0	0	0	4
OG0022055	4	0	0	0	0	0	0	4
OG0022056	4	0	0	0	0	0	0	4
OG0022057	4	0	0	0	0	0	0	4
OG0022058	1	2	1	0	0	0	0	4
OG0022059	4	0	0	0	0	0	0	4
OG0022060	2	0	1	0	0	0	1	4
OG0022061	1	3	0	0	0	0	0	4
OG0022062	2	1	0	0	1	0	0	4
OG0022063	1	1	1	0	1	0	0	4
OG0022064	3	0	0	0	0	0	1	4
OG0022065	1	2	0	0	1	0	0	4
OG0022066	4	0	0	0	0	0	0	4
OG0022067	4	0	0	0	0	0	0	4
OG0022068	2	0	1	0	0	0	1	4
OG0022069	4	0	0	0	0	0	0	4
OG0022070	4	0	0	0	0	0	0	4
OG0022071	2	0	1	0	0	0	1	4
OG0022072	3	0	0	0	0	0	1	4
OG0022073	1	0	1	1	0	0	1	4
OG0022074	4	0	0	0	0	0	0	4
OG0022075	4	0	0	0	0	0	0	4
OG0022076	2	0	1	0	0	0	1	4
OG0022077	1	0	1	0	0	0	2	4
OG0022078	4	0	0	0	0	0	0	4
OG0022079	4	0	0	0	0	0	0	4
OG0022080	4	0	0	0	0	0	0	4
OG0022081	4	0	0	0	0	0	0	4
OG0022082	4	0	0	0	0	0	0	4
OG0022083	1	2	1	0	0	0	0	4
OG0022084	1	1	0	0	0	1	1	4
OG0022085	4	0	0	0	0	0	0	4
OG0022086	4	0	0	0	0	0	0	4
OG0022087	1	2	0	0	1	0	0	4
OG0022088	1	3	0	0	0	0	0	4
OG0022089	3	0	1	0	0	0	0	4
OG0022090	3	0	0	0	1	0	0	4
OG0022091	4	0	0	0	0	0	0	4
OG0022092	2	1	1	0	0	0	0	4
OG0022093	1	0	0	0	0	1	2	4
OG0022094	1	2	1	0	0	0	0	4
OG0022095	2	0	1	0	0	0	1	4
OG0022096	4	0	0	0	0	0	0	4
OG0022097	1	3	0	0	0	0	0	4
OG0022098	4	0	0	0	0	0	0	4
OG0022099	1	0	1	0	0	1	1	4
OG0022100	1	3	0	0	0	0	0	4
OG0022101	3	0	0	1	0	0	0	4
OG0022102	1	1	0	1	0	0	1	4
OG0022103	4	0	0	0	0	0	0	4
OG0022104	4	0	0	0	0	0	0	4
OG0022105	1	1	1	1	0	0	0	4
OG0022106	4	0	0	0	0	0	0	4
OG0022107	4	0	0	0	0	0	0	4
OG0022108	4	0	0	0	0	0	0	4
OG0022109	1	3	0	0	0	0	0	4
OG0022110	4	0	0	0	0	0	0	4
OG0022111	4	0	0	0	0	0	0	4
OG0022112	4	0	0	0	0	0	0	4
OG0022113	1	0	0	3	0	0	0	4
OG0022114	1	0	3	0	0	0	0	4
OG0022115	4	0	0	0	0	0	0	4
OG0022116	4	0	0	0	0	0	0	4
OG0022117	1	0	1	0	1	1	0	4
OG0022118	2	0	2	0	0	0	0	4
OG0022119	3	1	0	0	0	0	0	4
OG0022120	3	0	0	0	0	0	1	4
OG0022121	4	0	0	0	0	0	0	4
OG0022122	4	0	0	0	0	0	0	4
OG0022123	4	0	0	0	0	0	0	4
OG0022124	1	3	0	0	0	0	0	4
OG0022125	1	1	1	0	0	0	1	4
OG0022126	4	0	0	0	0	0	0	4
OG0022127	3	0	1	0	0	0	0	4
OG0022128	1	3	0	0	0	0	0	4
OG0022129	1	2	0	0	1	0	0	4
OG0022130	4	0	0	0	0	0	0	4
OG0022131	4	0	0	0	0	0	0	4
OG0022132	2	0	1	0	0	0	1	4
OG0022133	2	2	0	0	0	0	0	4
OG0022134	1	1	1	1	0	0	0	4
OG0022135	3	1	0	0	0	0	0	4
OG0022136	4	0	0	0	0	0	0	4
OG0022137	4	0	0	0	0	0	0	4
OG0022138	4	0	0	0	0	0	0	4
OG0022139	1	2	0	0	1	0	0	4
OG0022140	2	2	0	0	0	0	0	4
OG0022141	3	1	0	0	0	0	0	4
OG0022142	4	0	0	0	0	0	0	4
OG0022143	1	2	0	0	0	1	0	4
OG0022144	1	2	1	0	0	0	0	4
OG0022145	1	0	1	0	0	1	1	4
OG0022146	2	0	0	0	0	0	2	4
OG0022147	2	0	1	0	0	0	1	4
OG0022148	4	0	0	0	0	0	0	4
OG0022149	2	0	1	0	0	0	1	4
OG0022150	1	0	1	1	0	1	0	4
OG0022151	1	1	1	0	0	1	0	4
OG0022152	1	0	1	1	0	1	0	4
OG0022153	1	1	1	0	0	1	0	4
OG0022154	4	0	0	0	0	0	0	4
OG0022155	1	2	0	0	1	0	0	4
OG0022156	4	0	0	0	0	0	0	4
OG0022157	1	2	1	0	0	0	0	4
OG0022158	1	0	1	1	0	1	0	4
OG0022159	1	1	0	0	1	1	0	4
OG0022160	2	0	1	0	0	0	1	4
OG0022161	2	0	1	0	0	0	1	4
OG0022162	4	0	0	0	0	0	0	4
OG0022163	1	3	0	0	0	0	0	4
OG0022164	4	0	0	0	0	0	0	4
OG0022165	1	0	1	0	1	0	1	4
OG0022166	2	0	1	0	1	0	0	4
OG0022167	4	0	0	0	0	0	0	4
OG0022168	1	0	0	1	1	1	0	4
OG0022169	1	1	1	0	0	1	0	4
OG0022170	4	0	0	0	0	0	0	4
OG0022171	4	0	0	0	0	0	0	4
OG0022172	1	1	2	0	0	0	0	4
OG0022173	4	0	0	0	0	0	0	4
OG0022174	1	2	1	0	0	0	0	4
OG0022175	1	1	1	0	0	0	1	4
OG0022176	2	2	0	0	0	0	0	4
OG0022177	2	2	0	0	0	0	0	4
OG0022178	2	0	1	0	0	0	1	4
OG0022179	2	0	0	1	0	0	1	4
OG0022180	1	3	0	0	0	0	0	4
OG0022181	4	0	0	0	0	0	0	4
OG0022182	1	0	0	1	0	1	1	4
OG0022183	2	2	0	0	0	0	0	4
OG0022184	4	0	0	0	0	0	0	4
OG0022185	1	3	0	0	0	0	0	4
OG0022186	2	1	1	0	0	0	0	4
OG0022187	1	1	0	0	0	1	1	4
OG0022188	1	0	1	1	0	0	1	4
OG0022189	1	2	0	0	1	0	0	4
OG0022190	1	1	0	1	0	1	0	4
OG0022191	2	0	2	0	0	0	0	4
OG0022192	4	0	0	0	0	0	0	4
OG0022193	4	0	0	0	0	0	0	4
OG0022194	2	1	0	1	0	0	0	4
OG0022195	1	0	1	0	0	0	2	4
OG0022196	1	0	1	0	0	0	2	4
OG0022197	1	1	1	1	0	0	0	4
OG0022198	1	1	1	1	0	0	0	4
OG0022199	2	0	1	0	0	0	1	4
OG0022200	1	0	0	1	1	0	1	4
OG0022201	1	2	0	1	0	0	0	4
OG0022202	4	0	0	0	0	0	0	4
OG0022203	1	1	1	0	0	0	1	4
OG0022204	1	1	0	1	0	0	1	4
OG0022205	4	0	0	0	0	0	0	4
OG0022206	1	0	0	0	0	3	0	4
OG0022207	1	3	0	0	0	0	0	4
OG0022208	2	0	0	0	0	1	1	4
OG0022209	4	0	0	0	0	0	0	4
OG0022210	2	0	1	0	0	1	0	4
OG0022211	1	1	1	1	0	0	0	4
OG0022212	4	0	0	0	0	0	0	4
OG0022213	1	1	0	1	0	1	0	4
OG0022214	2	2	0	0	0	0	0	4
OG0022215	1	1	1	0	0	0	1	4
OG0022216	1	3	0	0	0	0	0	4
OG0022217	1	0	1	0	0	1	1	4
OG0022218	1	2	0	1	0	0	0	4
OG0022219	1	1	1	0	0	1	0	4
OG0022220	1	2	0	0	0	0	1	4
OG0022221	1	2	1	0	0	0	0	4
OG0022222	1	0	0	1	1	0	1	4
OG0022223	2	0	1	0	0	0	1	4
OG0022224	1	0	1	1	0	0	1	4
OG0022225	1	0	1	1	0	1	0	4
OG0022226	1	2	0	0	0	1	0	4
OG0022227	1	3	0	0	0	0	0	4
OG0022228	1	2	0	0	1	0	0	4
OG0022229	1	2	0	0	1	0	0	4
OG0022230	1	3	0	0	0	0	0	4
OG0022231	1	3	0	0	0	0	0	4
OG0022232	1	0	3	0	0	0	0	4
OG0022233	1	3	0	0	0	0	0	4
OG0022234	1	1	1	0	0	0	1	4
OG0022235	1	1	0	1	0	1	0	4
OG0022236	2	1	1	0	0	0	0	4
OG0022237	1	0	1	1	0	1	0	4
OG0022238	2	1	0	1	0	0	0	4
OG0022239	1	2	1	0	0	0	0	4
OG0022240	1	3	0	0	0	0	0	4
OG0022241	1	1	1	0	0	0	1	4
OG0022242	1	3	0	0	0	0	0	4
OG0022243	2	0	1	0	0	0	1	4
OG0022244	2	0	1	0	0	0	1	4
OG0022245	2	0	1	0	0	0	1	4
OG0022246	1	2	0	0	1	0	0	4
OG0022247	1	1	1	0	0	0	1	4
OG0022248	1	3	0	0	0	0	0	4
OG0022249	1	1	1	0	1	0	0	4
OG0022250	1	1	1	0	0	1	0	4
OG0022251	1	0	0	1	0	2	0	4
OG0022252	1	1	1	0	0	0	1	4
OG0022253	1	1	1	0	1	0	0	4
OG0022254	1	1	1	0	0	0	1	4
OG0022255	1	2	1	0	0	0	0	4
OG0022256	1	0	1	1	1	0	0	4
OG0022257	1	1	1	0	0	1	0	4
OG0022258	1	1	1	0	0	0	1	4
OG0022259	1	3	0	0	0	0	0	4
OG0022260	1	0	1	0	1	1	0	4
OG0022261	1	2	1	0	0	0	0	4
OG0022262	1	1	1	0	0	0	1	4
OG0022263	1	2	0	0	1	0	0	4
OG0022264	1	0	1	1	0	1	0	4
OG0022265	0	3	0	0	1	0	0	4
OG0022266	0	4	0	0	0	0	0	4
OG0022267	0	3	0	1	0	0	0	4
OG0022268	0	1	1	0	0	1	1	4
OG0022269	0	3	0	1	0	0	0	4
OG0022270	0	4	0	0	0	0	0	4
OG0022271	0	3	0	0	1	0	0	4
OG0022272	0	3	0	0	1	0	0	4
OG0022273	0	2	0	1	1	0	0	4
OG0022274	0	4	0	0	0	0	0	4
OG0022275	0	3	0	0	0	0	1	4
OG0022276	0	4	0	0	0	0	0	4
OG0022277	0	3	0	0	1	0	0	4
OG0022278	0	1	0	1	1	1	0	4
OG0022279	0	3	0	0	0	0	1	4
OG0022280	0	4	0	0	0	0	0	4
OG0022281	0	2	0	0	0	1	1	4
OG0022282	0	4	0	0	0	0	0	4
OG0022283	0	3	0	0	1	0	0	4
OG0022284	0	4	0	0	0	0	0	4
OG0022285	0	2	0	1	0	0	1	4
OG0022286	0	3	0	0	0	0	1	4
OG0022287	0	4	0	0	0	0	0	4
OG0022288	0	3	0	1	0	0	0	4
OG0022289	0	2	0	0	0	1	1	4
OG0022290	0	4	0	0	0	0	0	4
OG0022291	0	3	0	1	0	0	0	4
OG0022292	0	4	0	0	0	0	0	4
OG0022293	0	3	0	0	1	0	0	4
OG0022294	0	3	0	0	0	0	1	4
OG0022295	0	3	1	0	0	0	0	4
OG0022296	0	4	0	0	0	0	0	4
OG0022297	0	3	0	0	0	0	1	4
OG0022298	0	3	0	0	0	0	1	4
OG0022299	0	4	0	0	0	0	0	4
OG0022300	0	4	0	0	0	0	0	4
OG0022301	0	4	0	0	0	0	0	4
OG0022302	0	3	0	0	0	0	1	4
OG0022303	0	4	0	0	0	0	0	4
OG0022304	0	1	0	1	0	0	2	4
OG0022305	0	4	0	0	0	0	0	4
OG0022306	0	1	1	0	0	0	2	4
OG0022307	0	4	0	0	0	0	0	4
OG0022308	0	4	0	0	0	0	0	4
OG0022309	0	4	0	0	0	0	0	4
OG0022310	0	3	0	1	0	0	0	4
OG0022311	0	4	0	0	0	0	0	4
OG0022312	0	4	0	0	0	0	0	4
OG0022313	0	2	0	0	0	1	1	4
OG0022314	0	3	0	1	0	0	0	4
OG0022315	0	1	0	0	0	0	3	4
OG0022316	0	1	1	1	0	0	1	4
OG0022317	0	4	0	0	0	0	0	4
OG0022318	0	3	0	0	0	0	1	4
OG0022319	0	3	0	1	0	0	0	4
OG0022320	0	3	1	0	0	0	0	4
OG0022321	0	4	0	0	0	0	0	4
OG0022322	0	1	1	0	1	1	0	4
OG0022323	0	4	0	0	0	0	0	4
OG0022324	0	2	0	1	0	0	1	4
OG0022325	0	2	0	1	1	0	0	4
OG0022326	0	2	1	1	0	0	0	4
OG0022327	0	3	0	1	0	0	0	4
OG0022328	0	4	0	0	0	0	0	4
OG0022329	0	4	0	0	0	0	0	4
OG0022330	0	4	0	0	0	0	0	4
OG0022331	0	4	0	0	0	0	0	4
OG0022332	0	4	0	0	0	0	0	4
OG0022333	0	4	0	0	0	0	0	4
OG0022334	0	3	1	0	0	0	0	4
OG0022335	0	4	0	0	0	0	0	4
OG0022336	0	4	0	0	0	0	0	4
OG0022337	0	2	0	1	1	0	0	4
OG0022338	0	3	0	0	0	0	1	4
OG0022339	0	3	0	0	1	0	0	4
OG0022340	0	3	1	0	0	0	0	4
OG0022341	0	4	0	0	0	0	0	4
OG0022342	0	4	0	0	0	0	0	4
OG0022343	0	4	0	0	0	0	0	4
OG0022344	0	4	0	0	0	0	0	4
OG0022345	0	4	0	0	0	0	0	4
OG0022346	0	4	0	0	0	0	0	4
OG0022347	0	4	0	0	0	0	0	4
OG0022348	0	4	0	0	0	0	0	4
OG0022349	0	4	0	0	0	0	0	4
OG0022350	0	4	0	0	0	0	0	4
OG0022351	0	4	0	0	0	0	0	4
OG0022352	0	3	0	1	0	0	0	4
OG0022353	0	4	0	0	0	0	0	4
OG0022354	0	4	0	0	0	0	0	4
OG0022355	0	4	0	0	0	0	0	4
OG0022356	0	4	0	0	0	0	0	4
OG0022357	0	4	0	0	0	0	0	4
OG0022358	0	4	0	0	0	0	0	4
OG0022359	0	4	0	0	0	0	0	4
OG0022360	0	4	0	0	0	0	0	4
OG0022361	0	4	0	0	0	0	0	4
OG0022362	0	4	0	0	0	0	0	4
OG0022363	0	3	0	0	1	0	0	4
OG0022364	0	4	0	0	0	0	0	4
OG0022365	0	1	1	1	1	0	0	4
OG0022366	0	4	0	0	0	0	0	4
OG0022367	0	2	1	0	0	0	1	4
OG0022368	0	1	0	1	0	1	1	4
OG0022369	0	4	0	0	0	0	0	4
OG0022370	0	2	1	0	0	0	1	4
OG0022371	0	4	0	0	0	0	0	4
OG0022372	0	4	0	0	0	0	0	4
OG0022373	0	4	0	0	0	0	0	4
OG0022374	0	4	0	0	0	0	0	4
OG0022375	0	2	0	1	1	0	0	4
OG0022376	0	2	0	0	0	0	2	4
OG0022377	0	2	0	0	0	1	1	4
OG0022378	0	4	0	0	0	0	0	4
OG0022379	0	4	0	0	0	0	0	4
OG0022380	0	4	0	0	0	0	0	4
OG0022381	0	1	0	1	1	1	0	4
OG0022382	0	4	0	0	0	0	0	4
OG0022383	0	3	0	0	1	0	0	4
OG0022384	0	4	0	0	0	0	0	4
OG0022385	0	3	1	0	0	0	0	4
OG0022386	0	2	0	0	0	2	0	4
OG0022387	0	2	1	0	0	1	0	4
OG0022388	0	4	0	0	0	0	0	4
OG0022389	0	4	0	0	0	0	0	4
OG0022390	0	2	0	0	1	1	0	4
OG0022391	0	3	0	1	0	0	0	4
OG0022392	0	3	0	0	1	0	0	4
OG0022393	0	4	0	0	0	0	0	4
OG0022394	0	4	0	0	0	0	0	4
OG0022395	0	4	0	0	0	0	0	4
OG0022396	0	3	0	0	0	1	0	4
OG0022397	0	4	0	0	0	0	0	4
OG0022398	0	3	0	1	0	0	0	4
OG0022399	0	4	0	0	0	0	0	4
OG0022400	0	4	0	0	0	0	0	4
OG0022401	0	4	0	0	0	0	0	4
OG0022402	0	4	0	0	0	0	0	4
OG0022403	0	1	0	0	0	1	2	4
OG0022404	0	4	0	0	0	0	0	4
OG0022405	0	3	0	0	0	0	1	4
OG0022406	0	3	0	1	0	0	0	4
OG0022407	0	4	0	0	0	0	0	4
OG0022408	0	4	0	0	0	0	0	4
OG0022409	0	3	0	0	0	0	1	4
OG0022410	0	1	1	0	0	0	2	4
OG0022411	0	4	0	0	0	0	0	4
OG0022412	0	4	0	0	0	0	0	4
OG0022413	0	4	0	0	0	0	0	4
OG0022414	0	1	1	1	1	0	0	4
OG0022415	0	2	1	0	0	0	1	4
OG0022416	0	3	0	0	1	0	0	4
OG0022417	0	2	1	0	0	0	1	4
OG0022418	0	4	0	0	0	0	0	4
OG0022419	0	2	0	1	0	1	0	4
OG0022420	0	3	1	0	0	0	0	4
OG0022421	0	2	0	1	1	0	0	4
OG0022422	0	3	0	0	1	0	0	4
OG0022423	0	4	0	0	0	0	0	4
OG0022424	0	1	1	0	1	0	1	4
OG0022425	0	3	0	1	0	0	0	4
OG0022426	0	4	0	0	0	0	0	4
OG0022427	0	4	0	0	0	0	0	4
OG0022428	0	2	0	0	0	1	1	4
OG0022429	0	2	0	0	0	1	1	4
OG0022430	0	3	0	1	0	0	0	4
OG0022431	0	3	0	1	0	0	0	4
OG0022432	0	4	0	0	0	0	0	4
OG0022433	0	3	1	0	0	0	0	4
OG0022434	0	3	0	0	0	1	0	4
OG0022435	0	4	0	0	0	0	0	4
OG0022436	0	3	1	0	0	0	0	4
OG0022437	0	4	0	0	0	0	0	4
OG0022438	0	2	0	1	0	1	0	4
OG0022439	0	3	1	0	0	0	0	4
OG0022440	0	4	0	0	0	0	0	4
OG0022441	0	4	0	0	0	0	0	4
OG0022442	0	4	0	0	0	0	0	4
OG0022443	0	4	0	0	0	0	0	4
OG0022444	0	4	0	0	0	0	0	4
OG0022445	0	1	1	1	0	0	1	4
OG0022446	0	2	0	1	0	0	1	4
OG0022447	0	2	0	1	0	0	1	4
OG0022448	0	3	1	0	0	0	0	4
OG0022449	0	2	0	1	1	0	0	4
OG0022450	0	2	0	0	1	0	1	4
OG0022451	0	4	0	0	0	0	0	4
OG0022452	0	4	0	0	0	0	0	4
OG0022453	0	4	0	0	0	0	0	4
OG0022454	0	4	0	0	0	0	0	4
OG0022455	0	2	0	0	1	0	1	4
OG0022456	0	4	0	0	0	0	0	4
OG0022457	0	4	0	0	0	0	0	4
OG0022458	0	4	0	0	0	0	0	4
OG0022459	0	4	0	0	0	0	0	4
OG0022460	0	4	0	0	0	0	0	4
OG0022461	0	4	0	0	0	0	0	4
OG0022462	0	4	0	0	0	0	0	4
OG0022463	0	2	0	0	1	0	1	4
OG0022464	0	3	0	0	0	0	1	4
OG0022465	0	2	1	0	1	0	0	4
OG0022466	0	4	0	0	0	0	0	4
OG0022467	0	4	0	0	0	0	0	4
OG0022468	0	4	0	0	0	0	0	4
OG0022469	0	4	0	0	0	0	0	4
OG0022470	0	2	0	1	0	1	0	4
OG0022471	0	4	0	0	0	0	0	4
OG0022472	0	2	0	0	1	0	1	4
OG0022473	0	4	0	0	0	0	0	4
OG0022474	0	4	0	0	0	0	0	4
OG0022475	0	4	0	0	0	0	0	4
OG0022476	0	1	0	2	1	0	0	4
OG0022477	0	4	0	0	0	0	0	4
OG0022478	0	3	0	0	0	0	1	4
OG0022479	0	2	1	0	1	0	0	4
OG0022480	0	2	0	0	0	1	1	4
OG0022481	0	4	0	0	0	0	0	4
OG0022482	0	4	0	0	0	0	0	4
OG0022483	0	4	0	0	0	0	0	4
OG0022484	0	1	0	0	1	1	1	4
OG0022485	0	4	0	0	0	0	0	4
OG0022486	0	1	0	0	0	1	2	4
OG0022487	0	4	0	0	0	0	0	4
OG0022488	0	4	0	0	0	0	0	4
OG0022489	0	4	0	0	0	0	0	4
OG0022490	0	3	0	0	1	0	0	4
OG0022491	0	4	0	0	0	0	0	4
OG0022492	0	4	0	0	0	0	0	4
OG0022493	0	4	0	0	0	0	0	4
OG0022494	0	3	1	0	0	0	0	4
OG0022495	0	3	0	0	1	0	0	4
OG0022496	0	3	0	0	0	0	1	4
OG0022497	0	2	0	0	1	0	1	4
OG0022498	0	2	1	0	0	1	0	4
OG0022499	0	4	0	0	0	0	0	4
OG0022500	0	3	0	0	0	0	1	4
OG0022501	0	4	0	0	0	0	0	4
OG0022502	0	2	0	0	0	0	2	4
OG0022503	0	2	0	0	0	1	1	4
OG0022504	0	3	1	0	0	0	0	4
OG0022505	0	4	0	0	0	0	0	4
OG0022506	0	4	0	0	0	0	0	4
OG0022507	0	4	0	0	0	0	0	4
OG0022508	0	4	0	0	0	0	0	4
OG0022509	0	4	0	0	0	0	0	4
OG0022510	0	1	0	0	1	0	2	4
OG0022511	0	3	0	0	0	0	1	4
OG0022512	0	4	0	0	0	0	0	4
OG0022513	0	4	0	0	0	0	0	4
OG0022514	0	1	1	1	0	0	1	4
OG0022515	0	4	0	0	0	0	0	4
OG0022516	0	4	0	0	0	0	0	4
OG0022517	0	2	1	0	0	0	1	4
OG0022518	0	3	0	1	0	0	0	4
OG0022519	0	3	0	0	1	0	0	4
OG0022520	0	3	0	1	0	0	0	4
OG0022521	0	3	0	0	0	0	1	4
OG0022522	0	4	0	0	0	0	0	4
OG0022523	0	4	0	0	0	0	0	4
OG0022524	0	2	1	0	1	0	0	4
OG0022525	0	3	1	0	0	0	0	4
OG0022526	0	3	0	0	1	0	0	4
OG0022527	0	2	1	1	0	0	0	4
OG0022528	0	4	0	0	0	0	0	4
OG0022529	0	1	1	0	1	1	0	4
OG0022530	0	2	0	1	1	0	0	4
OG0022531	0	2	0	1	0	1	0	4
OG0022532	0	4	0	0	0	0	0	4
OG0022533	0	4	0	0	0	0	0	4
OG0022534	0	2	0	1	0	0	1	4
OG0022535	0	2	0	2	0	0	0	4
OG0022536	0	4	0	0	0	0	0	4
OG0022537	0	4	0	0	0	0	0	4
OG0022538	0	3	0	1	0	0	0	4
OG0022539	0	4	0	0	0	0	0	4
OG0022540	0	4	0	0	0	0	0	4
OG0022541	0	2	0	0	1	0	1	4
OG0022542	0	2	0	1	0	0	1	4
OG0022543	0	3	1	0	0	0	0	4
OG0022544	0	4	0	0	0	0	0	4
OG0022545	0	3	0	0	0	0	1	4
OG0022546	0	3	0	1	0	0	0	4
OG0022547	0	2	2	0	0	0	0	4
OG0022548	0	2	0	0	1	0	1	4
OG0022549	0	3	0	0	0	0	1	4
OG0022550	0	4	0	0	0	0	0	4
OG0022551	0	3	0	1	0	0	0	4
OG0022552	0	3	1	0	0	0	0	4
OG0022553	0	3	0	1	0	0	0	4
OG0022554	0	4	0	0	0	0	0	4
OG0022555	0	2	1	1	0	0	0	4
OG0022556	0	4	0	0	0	0	0	4
OG0022557	0	3	0	1	0	0	0	4
OG0022558	0	3	0	0	0	0	1	4
OG0022559	0	2	0	1	1	0	0	4
OG0022560	0	2	1	1	0	0	0	4
OG0022561	0	4	0	0	0	0	0	4
OG0022562	0	4	0	0	0	0	0	4
OG0022563	0	3	0	0	1	0	0	4
OG0022564	0	4	0	0	0	0	0	4
OG0022565	0	3	1	0	0	0	0	4
OG0022566	0	3	0	0	0	0	1	4
OG0022567	0	4	0	0	0	0	0	4
OG0022568	0	4	0	0	0	0	0	4
OG0022569	0	3	0	0	1	0	0	4
OG0022570	0	4	0	0	0	0	0	4
OG0022571	0	4	0	0	0	0	0	4
OG0022572	0	4	0	0	0	0	0	4
OG0022573	0	4	0	0	0	0	0	4
OG0022574	0	2	2	0	0	0	0	4
OG0022575	0	3	0	0	0	0	1	4
OG0022576	0	2	0	0	1	0	1	4
OG0022577	0	2	1	0	0	0	1	4
OG0022578	0	2	0	0	0	1	1	4
OG0022579	0	4	0	0	0	0	0	4
OG0022580	0	4	0	0	0	0	0	4
OG0022581	0	2	0	0	1	0	1	4
OG0022582	0	4	0	0	0	0	0	4
OG0022583	0	4	0	0	0	0	0	4
OG0022584	0	1	0	1	2	0	0	4
OG0022585	0	2	1	0	1	0	0	4
OG0022586	0	4	0	0	0	0	0	4
OG0022587	0	1	1	0	1	1	0	4
OG0022588	0	4	0	0	0	0	0	4
OG0022589	0	4	0	0	0	0	0	4
OG0022590	0	2	0	0	0	1	1	4
OG0022591	0	4	0	0	0	0	0	4
OG0022592	0	2	0	0	1	0	1	4
OG0022593	0	3	0	0	0	0	1	4
OG0022594	0	4	0	0	0	0	0	4
OG0022595	0	4	0	0	0	0	0	4
OG0022596	0	2	0	0	1	0	1	4
OG0022597	0	4	0	0	0	0	0	4
OG0022598	0	4	0	0	0	0	0	4
OG0022599	0	4	0	0	0	0	0	4
OG0022600	0	3	0	0	0	1	0	4
OG0022601	0	1	0	0	1	1	1	4
OG0022602	0	4	0	0	0	0	0	4
OG0022603	0	4	0	0	0	0	0	4
OG0022604	0	2	0	1	1	0	0	4
OG0022605	0	3	0	0	1	0	0	4
OG0022606	0	4	0	0	0	0	0	4
OG0022607	0	2	0	0	2	0	0	4
OG0022608	0	2	0	0	0	0	2	4
OG0022609	0	4	0	0	0	0	0	4
OG0022610	0	1	1	1	0	1	0	4
OG0022611	0	2	0	0	1	0	1	4
OG0022612	0	2	0	0	0	1	1	4
OG0022613	0	4	0	0	0	0	0	4
OG0022614	0	3	0	1	0	0	0	4
OG0022615	0	2	0	1	0	1	0	4
OG0022616	0	4	0	0	0	0	0	4
OG0022617	0	4	0	0	0	0	0	4
OG0022618	0	2	0	1	1	0	0	4
OG0022619	0	4	0	0	0	0	0	4
OG0022620	0	4	0	0	0	0	0	4
OG0022621	0	3	1	0	0	0	0	4
OG0022622	0	1	1	1	1	0	0	4
OG0022623	0	4	0	0	0	0	0	4
OG0022624	0	4	0	0	0	0	0	4
OG0022625	0	3	0	1	0	0	0	4
OG0022626	0	4	0	0	0	0	0	4
OG0022627	0	2	0	1	1	0	0	4
OG0022628	0	3	0	0	0	0	1	4
OG0022629	0	2	0	0	1	1	0	4
OG0022630	0	2	0	0	2	0	0	4
OG0022631	0	4	0	0	0	0	0	4
OG0022632	0	3	0	0	0	0	1	4
OG0022633	0	4	0	0	0	0	0	4
OG0022634	0	4	0	0	0	0	0	4
OG0022635	0	2	0	1	1	0	0	4
OG0022636	0	4	0	0	0	0	0	4
OG0022637	0	4	0	0	0	0	0	4
OG0022638	0	3	0	0	0	0	1	4
OG0022639	0	1	1	0	0	1	1	4
OG0022640	0	4	0	0	0	0	0	4
OG0022641	0	4	0	0	0	0	0	4
OG0022642	0	4	0	0	0	0	0	4
OG0022643	0	3	0	1	0	0	0	4
OG0022644	0	3	0	1	0	0	0	4
OG0022645	0	3	0	0	1	0	0	4
OG0022646	0	4	0	0	0	0	0	4
OG0022647	0	2	0	1	0	1	0	4
OG0022648	0	4	0	0	0	0	0	4
OG0022649	0	2	0	1	0	0	1	4
OG0022650	0	4	0	0	0	0	0	4
OG0022651	0	4	0	0	0	0	0	4
OG0022652	0	2	0	0	0	1	1	4
OG0022653	0	3	0	0	0	1	0	4
OG0022654	0	1	0	1	1	1	0	4
OG0022655	0	2	0	1	1	0	0	4
OG0022656	0	4	0	0	0	0	0	4
OG0022657	0	1	0	0	1	1	1	4
OG0022658	0	4	0	0	0	0	0	4
OG0022659	0	4	0	0	0	0	0	4
OG0022660	0	3	0	1	0	0	0	4
OG0022661	0	4	0	0	0	0	0	4
OG0022662	0	2	1	0	0	0	1	4
OG0022663	0	2	0	0	0	0	2	4
OG0022664	0	4	0	0	0	0	0	4
OG0022665	0	2	0	1	0	1	0	4
OG0022666	0	2	0	0	0	0	2	4
OG0022667	0	4	0	0	0	0	0	4
OG0022668	0	4	0	0	0	0	0	4
OG0022669	0	4	0	0	0	0	0	4
OG0022670	0	4	0	0	0	0	0	4
OG0022671	0	4	0	0	0	0	0	4
OG0022672	0	3	1	0	0	0	0	4
OG0022673	0	4	0	0	0	0	0	4
OG0022674	0	2	0	0	1	0	1	4
OG0022675	0	4	0	0	0	0	0	4
OG0022676	0	4	0	0	0	0	0	4
OG0022677	0	3	0	0	0	0	1	4
OG0022678	0	4	0	0	0	0	0	4
OG0022679	0	1	0	1	1	1	0	4
OG0022680	0	3	0	0	1	0	0	4
OG0022681	0	3	0	0	1	0	0	4
OG0022682	0	4	0	0	0	0	0	4
OG0022683	0	3	0	0	0	0	1	4
OG0022684	0	2	0	1	1	0	0	4
OG0022685	0	4	0	0	0	0	0	4
OG0022686	0	1	1	1	1	0	0	4
OG0022687	0	4	0	0	0	0	0	4
OG0022688	0	4	0	0	0	0	0	4
OG0022689	0	4	0	0	0	0	0	4
OG0022690	0	4	0	0	0	0	0	4
OG0022691	0	3	0	0	0	0	1	4
OG0022692	0	3	1	0	0	0	0	4
OG0022693	0	4	0	0	0	0	0	4
OG0022694	0	3	0	0	1	0	0	4
OG0022695	0	1	0	1	0	1	1	4
OG0022696	0	2	2	0	0	0	0	4
OG0022697	0	3	0	0	0	0	1	4
OG0022698	0	3	1	0	0	0	0	4
OG0022699	0	2	1	0	1	0	0	4
OG0022700	0	2	0	0	1	0	1	4
OG0022701	0	4	0	0	0	0	0	4
OG0022702	0	4	0	0	0	0	0	4
OG0022703	0	4	0	0	0	0	0	4
OG0022704	0	2	0	0	1	1	0	4
OG0022705	0	4	0	0	0	0	0	4
OG0022706	0	1	0	0	1	1	1	4
OG0022707	0	2	0	1	0	1	0	4
OG0022708	0	2	0	1	0	1	0	4
OG0022709	0	1	0	2	0	1	0	4
OG0022710	0	2	1	0	0	0	1	4
OG0022711	0	3	1	0	0	0	0	4
OG0022712	0	4	0	0	0	0	0	4
OG0022713	0	4	0	0	0	0	0	4
OG0022714	0	2	0	2	0	0	0	4
OG0022715	0	2	0	2	0	0	0	4
OG0022716	0	4	0	0	0	0	0	4
OG0022717	0	3	0	1	0	0	0	4
OG0022718	0	3	0	1	0	0	0	4
OG0022719	0	4	0	0	0	0	0	4
OG0022720	0	4	0	0	0	0	0	4
OG0022721	0	4	0	0	0	0	0	4
OG0022722	0	4	0	0	0	0	0	4
OG0022723	0	4	0	0	0	0	0	4
OG0022724	0	4	0	0	0	0	0	4
OG0022725	0	4	0	0	0	0	0	4
OG0022726	0	4	0	0	0	0	0	4
OG0022727	0	3	0	0	1	0	0	4
OG0022728	0	3	0	0	0	0	1	4
OG0022729	0	4	0	0	0	0	0	4
OG0022730	0	2	2	0	0	0	0	4
OG0022731	0	2	0	2	0	0	0	4
OG0022732	0	4	0	0	0	0	0	4
OG0022733	0	2	0	0	0	0	2	4
OG0022734	0	1	0	2	0	0	1	4
OG0022735	0	3	0	1	0	0	0	4
OG0022736	0	3	0	0	0	0	1	4
OG0022737	0	4	0	0	0	0	0	4
OG0022738	0	2	0	0	0	0	2	4
OG0022739	0	4	0	0	0	0	0	4
OG0022740	0	2	0	1	1	0	0	4
OG0022741	0	4	0	0	0	0	0	4
OG0022742	0	1	0	0	1	1	1	4
OG0022743	0	2	1	0	0	1	0	4
OG0022744	0	2	0	1	1	0	0	4
OG0022745	0	2	1	1	0	0	0	4
OG0022746	0	3	1	0	0	0	0	4
OG0022747	0	4	0	0	0	0	0	4
OG0022748	0	4	0	0	0	0	0	4
OG0022749	0	4	0	0	0	0	0	4
OG0022750	0	1	0	1	1	1	0	4
OG0022751	0	4	0	0	0	0	0	4
OG0022752	0	1	0	0	1	1	1	4
OG0022753	0	2	0	0	0	0	2	4
OG0022754	0	1	0	0	0	0	3	4
OG0022755	0	4	0	0	0	0	0	4
OG0022756	0	3	0	0	0	1	0	4
OG0022757	0	4	0	0	0	0	0	4
OG0022758	0	2	0	0	1	0	1	4
OG0022759	0	2	1	0	0	0	1	4
OG0022760	0	3	0	1	0	0	0	4
OG0022761	0	3	0	0	1	0	0	4
OG0022762	0	4	0	0	0	0	0	4
OG0022763	0	2	0	1	0	1	0	4
OG0022764	0	3	1	0	0	0	0	4
OG0022765	0	3	0	0	1	0	0	4
OG0022766	0	3	0	0	1	0	0	4
OG0022767	0	4	0	0	0	0	0	4
OG0022768	0	2	1	0	0	1	0	4
OG0022769	0	1	0	0	0	0	3	4
OG0022770	0	4	0	0	0	0	0	4
OG0022771	0	4	0	0	0	0	0	4
OG0022772	0	2	1	0	0	1	0	4
OG0022773	0	2	0	2	0	0	0	4
OG0022774	0	3	1	0	0	0	0	4
OG0022775	0	4	0	0	0	0	0	4
OG0022776	0	4	0	0	0	0	0	4
OG0022777	0	4	0	0	0	0	0	4
OG0022778	0	2	0	2	0	0	0	4
OG0022779	0	1	0	1	0	1	1	4
OG0022780	0	4	0	0	0	0	0	4
OG0022781	0	2	1	0	1	0	0	4
OG0022782	0	4	0	0	0	0	0	4
OG0022783	0	4	0	0	0	0	0	4
OG0022784	0	4	0	0	0	0	0	4
OG0022785	0	1	0	0	0	0	3	4
OG0022786	0	4	0	0	0	0	0	4
OG0022787	0	3	0	0	0	0	1	4
OG0022788	0	2	0	0	0	1	1	4
OG0022789	0	3	0	0	0	0	1	4
OG0022790	0	1	0	2	0	1	0	4
OG0022791	0	2	0	0	0	1	1	4
OG0022792	0	4	0	0	0	0	0	4
OG0022793	0	2	0	0	1	0	1	4
OG0022794	0	1	0	1	0	1	1	4
OG0022795	0	3	0	0	1	0	0	4
OG0022796	0	4	0	0	0	0	0	4
OG0022797	0	3	0	0	0	0	1	4
OG0022798	0	4	0	0	0	0	0	4
OG0022799	0	2	0	2	0	0	0	4
OG0022800	0	2	0	0	0	1	1	4
OG0022801	0	2	1	1	0	0	0	4
OG0022802	0	1	1	1	0	0	1	4
OG0022803	0	4	0	0	0	0	0	4
OG0022804	0	2	0	1	0	0	1	4
OG0022805	0	2	0	0	0	0	2	4
OG0022806	0	3	1	0	0	0	0	4
OG0022807	0	1	0	0	0	0	3	4
OG0022808	0	4	0	0	0	0	0	4
OG0022809	0	4	0	0	0	0	0	4
OG0022810	0	2	0	0	1	0	1	4
OG0022811	0	1	0	0	0	1	2	4
OG0022812	0	4	0	0	0	0	0	4
OG0022813	0	4	0	0	0	0	0	4
OG0022814	0	1	0	1	0	1	1	4
OG0022815	0	2	0	1	1	0	0	4
OG0022816	0	3	0	1	0	0	0	4
OG0022817	0	3	0	0	0	0	1	4
OG0022818	0	4	0	0	0	0	0	4
OG0022819	0	2	0	0	1	1	0	4
OG0022820	0	2	0	0	0	1	1	4
OG0022821	0	2	1	0	1	0	0	4
OG0022822	0	4	0	0	0	0	0	4
OG0022823	0	1	0	0	0	0	3	4
OG0022824	0	4	0	0	0	0	0	4
OG0022825	0	4	0	0	0	0	0	4
OG0022826	0	3	0	1	0	0	0	4
OG0022827	0	2	0	1	1	0	0	4
OG0022828	0	4	0	0	0	0	0	4
OG0022829	0	4	0	0	0	0	0	4
OG0022830	0	2	0	1	0	0	1	4
OG0022831	0	2	0	1	1	0	0	4
OG0022832	0	1	0	1	1	1	0	4
OG0022833	0	2	0	1	0	1	0	4
OG0022834	0	4	0	0	0	0	0	4
OG0022835	0	2	0	1	1	0	0	4
OG0022836	0	2	1	0	1	0	0	4
OG0022837	0	3	1	0	0	0	0	4
OG0022838	0	4	0	0	0	0	0	4
OG0022839	0	2	0	0	0	0	2	4
OG0022840	0	4	0	0	0	0	0	4
OG0022841	0	4	0	0	0	0	0	4
OG0022842	0	3	0	0	0	1	0	4
OG0022843	0	3	0	0	0	1	0	4
OG0022844	0	3	0	0	0	0	1	4
OG0022845	0	2	1	1	0	0	0	4
OG0022846	0	3	0	0	0	0	1	4
OG0022847	0	4	0	0	0	0	0	4
OG0022848	0	4	0	0	0	0	0	4
OG0022849	0	3	0	0	0	0	1	4
OG0022850	0	3	1	0	0	0	0	4
OG0022851	0	2	0	2	0	0	0	4
OG0022852	0	4	0	0	0	0	0	4
OG0022853	0	4	0	0	0	0	0	4
OG0022854	0	4	0	0	0	0	0	4
OG0022855	0	4	0	0	0	0	0	4
OG0022856	0	1	0	1	0	0	2	4
OG0022857	0	1	1	0	0	1	1	4
OG0022858	0	3	1	0	0	0	0	4
OG0022859	0	2	1	0	1	0	0	4
OG0022860	0	1	0	1	0	0	2	4
OG0022861	0	4	0	0	0	0	0	4
OG0022862	0	2	0	0	0	1	1	4
OG0022863	0	4	0	0	0	0	0	4
OG0022864	0	2	1	0	0	0	1	4
OG0022865	0	3	0	0	0	0	1	4
OG0022866	0	4	0	0	0	0	0	4
OG0022867	0	2	0	0	1	0	1	4
OG0022868	0	1	1	0	0	1	1	4
OG0022869	0	4	0	0	0	0	0	4
OG0022870	0	2	0	0	0	1	1	4
OG0022871	0	2	0	1	1	0	0	4
OG0022872	0	2	0	1	1	0	0	4
OG0022873	0	2	0	1	0	1	0	4
OG0022874	0	3	0	1	0	0	0	4
OG0022875	0	1	0	2	0	1	0	4
OG0022876	0	3	0	1	0	0	0	4
OG0022877	0	4	0	0	0	0	0	4
OG0022878	0	4	0	0	0	0	0	4
OG0022879	0	4	0	0	0	0	0	4
OG0022880	0	4	0	0	0	0	0	4
OG0022881	0	3	0	0	0	1	0	4
OG0022882	0	2	0	1	0	0	1	4
OG0022883	0	4	0	0	0	0	0	4
OG0022884	0	4	0	0	0	0	0	4
OG0022885	0	4	0	0	0	0	0	4
OG0022886	0	4	0	0	0	0	0	4
OG0022887	0	1	0	0	1	2	0	4
OG0022888	0	3	0	0	0	0	1	4
OG0022889	0	2	0	1	1	0	0	4
OG0022890	0	1	1	0	0	1	1	4
OG0022891	0	3	0	1	0	0	0	4
OG0022892	0	3	0	0	0	0	1	4
OG0022893	0	2	0	0	1	0	1	4
OG0022894	0	1	1	0	1	0	1	4
OG0022895	0	2	0	1	1	0	0	4
OG0022896	0	2	0	0	1	1	0	4
OG0022897	0	4	0	0	0	0	0	4
OG0022898	0	1	1	0	1	1	0	4
OG0022899	0	4	0	0	0	0	0	4
OG0022900	0	4	0	0	0	0	0	4
OG0022901	0	1	0	1	1	1	0	4
OG0022902	0	4	0	0	0	0	0	4
OG0022903	0	2	0	2	0	0	0	4
OG0022904	0	4	0	0	0	0	0	4
OG0022905	0	4	0	0	0	0	0	4
OG0022906	0	4	0	0	0	0	0	4
OG0022907	0	2	0	0	1	1	0	4
OG0022908	0	4	0	0	0	0	0	4
OG0022909	0	3	0	1	0	0	0	4
OG0022910	0	3	0	0	0	1	0	4
OG0022911	0	3	1	0	0	0	0	4
OG0022912	0	3	0	0	1	0	0	4
OG0022913	0	2	0	2	0	0	0	4
OG0022914	0	4	0	0	0	0	0	4
OG0022915	0	2	1	0	1	0	0	4
OG0022916	0	4	0	0	0	0	0	4
OG0022917	0	3	0	1	0	0	0	4
OG0022918	0	4	0	0	0	0	0	4
OG0022919	0	4	0	0	0	0	0	4
OG0022920	0	4	0	0	0	0	0	4
OG0022921	0	3	0	1	0	0	0	4
OG0022922	0	2	1	1	0	0	0	4
OG0022923	0	4	0	0	0	0	0	4
OG0022924	0	2	0	0	1	0	1	4
OG0022925	0	2	0	1	1	0	0	4
OG0022926	0	4	0	0	0	0	0	4
OG0022927	0	4	0	0	0	0	0	4
OG0022928	0	4	0	0	0	0	0	4
OG0022929	0	4	0	0	0	0	0	4
OG0022930	0	4	0	0	0	0	0	4
OG0022931	0	3	0	0	0	0	1	4
OG0022932	0	4	0	0	0	0	0	4
OG0022933	0	1	0	0	2	1	0	4
OG0022934	0	3	0	0	1	0	0	4
OG0022935	0	4	0	0	0	0	0	4
OG0022936	0	4	0	0	0	0	0	4
OG0022937	0	4	0	0	0	0	0	4
OG0022938	0	2	0	0	1	1	0	4
OG0022939	0	2	0	1	0	1	0	4
OG0022940	0	4	0	0	0	0	0	4
OG0022941	0	3	0	1	0	0	0	4
OG0022942	0	4	0	0	0	0	0	4
OG0022943	0	3	0	0	0	0	1	4
OG0022944	0	3	0	0	1	0	0	4
OG0022945	0	3	0	0	1	0	0	4
OG0022946	0	3	0	0	1	0	0	4
OG0022947	0	4	0	0	0	0	0	4
OG0022948	0	2	0	1	0	1	0	4
OG0022949	0	2	1	0	0	0	1	4
OG0022950	0	3	1	0	0	0	0	4
OG0022951	0	2	0	1	0	0	1	4
OG0022952	0	3	0	0	0	0	1	4
OG0022953	0	1	1	0	0	0	2	4
OG0022954	0	3	0	1	0	0	0	4
OG0022955	0	1	0	1	1	1	0	4
OG0022956	0	1	1	0	0	1	1	4
OG0022957	0	3	0	1	0	0	0	4
OG0022958	0	4	0	0	0	0	0	4
OG0022959	0	1	1	1	1	0	0	4
OG0022960	0	1	0	1	0	1	1	4
OG0022961	0	1	1	1	1	0	0	4
OG0022962	0	1	0	1	0	0	2	4
OG0022963	0	1	0	1	0	1	1	4
OG0022964	0	1	1	0	1	0	1	4
OG0022965	0	4	0	0	0	0	0	4
OG0022966	0	4	0	0	0	0	0	4
OG0022967	0	4	0	0	0	0	0	4
OG0022968	0	4	0	0	0	0	0	4
OG0022969	0	2	1	0	0	0	1	4
OG0022970	0	4	0	0	0	0	0	4
OG0022971	0	1	0	1	0	1	1	4
OG0022972	0	4	0	0	0	0	0	4
OG0022973	0	2	0	1	0	0	1	4
OG0022974	0	4	0	0	0	0	0	4
OG0022975	0	4	0	0	0	0	0	4
OG0022976	0	4	0	0	0	0	0	4
OG0022977	0	2	1	0	0	0	1	4
OG0022978	0	3	0	0	0	0	1	4
OG0022979	0	1	1	0	0	1	1	4
OG0022980	0	2	0	2	0	0	0	4
OG0022981	0	4	0	0	0	0	0	4
OG0022982	0	2	2	0	0	0	0	4
OG0022983	0	3	0	1	0	0	0	4
OG0022984	0	4	0	0	0	0	0	4
OG0022985	0	1	1	0	0	1	1	4
OG0022986	0	4	0	0	0	0	0	4
OG0022987	0	4	0	0	0	0	0	4
OG0022988	0	2	0	1	0	0	1	4
OG0022989	0	3	0	0	1	0	0	4
OG0022990	0	2	0	0	0	0	2	4
OG0022991	0	3	0	0	0	0	1	4
OG0022992	0	4	0	0	0	0	0	4
OG0022993	0	2	1	0	0	0	1	4
OG0022994	0	3	0	0	1	0	0	4
OG0022995	0	4	0	0	0	0	0	4
OG0022996	0	2	0	1	0	1	0	4
OG0022997	0	2	0	1	0	0	1	4
OG0022998	0	2	0	1	1	0	0	4
OG0022999	0	3	0	0	1	0	0	4
OG0023000	0	3	0	0	1	0	0	4
OG0023001	0	2	1	0	0	0	1	4
OG0023002	0	2	0	0	1	1	0	4
OG0023003	0	4	0	0	0	0	0	4
OG0023004	0	1	0	1	1	0	1	4
OG0023005	0	2	0	0	1	1	0	4
OG0023006	0	2	0	1	0	0	1	4
OG0023007	0	3	0	1	0	0	0	4
OG0023008	0	4	0	0	0	0	0	4
OG0023009	0	4	0	0	0	0	0	4
OG0023010	0	3	1	0	0	0	0	4
OG0023011	0	3	0	0	0	0	1	4
OG0023012	0	1	0	0	1	1	1	4
OG0023013	0	2	0	0	1	0	1	4
OG0023014	0	3	0	0	0	0	1	4
OG0023015	0	4	0	0	0	0	0	4
OG0023016	0	3	1	0	0	0	0	4
OG0023017	0	2	0	0	1	0	1	4
OG0023018	0	3	1	0	0	0	0	4
OG0023019	0	3	0	0	0	0	1	4
OG0023020	0	2	0	0	0	1	1	4
OG0023021	0	2	0	1	0	0	1	4
OG0023022	0	4	0	0	0	0	0	4
OG0023023	0	3	1	0	0	0	0	4
OG0023024	0	2	0	1	1	0	0	4
OG0023025	0	4	0	0	0	0	0	4
OG0023026	0	3	0	1	0	0	0	4
OG0023027	0	1	0	0	1	2	0	4
OG0023028	0	1	0	3	0	0	0	4
OG0023029	0	1	0	0	0	0	3	4
OG0023030	0	3	0	0	0	0	1	4
OG0023031	0	2	0	1	1	0	0	4
OG0023032	0	1	3	0	0	0	0	4
OG0023033	0	3	0	0	0	0	1	4
OG0023034	0	2	0	0	1	1	0	4
OG0023035	0	2	0	0	1	1	0	4
OG0023036	0	2	1	0	0	0	1	4
OG0023037	0	3	0	0	1	0	0	4
OG0023038	0	1	0	0	0	2	1	4
OG0023039	0	1	0	2	0	1	0	4
OG0023040	0	4	0	0	0	0	0	4
OG0023041	0	1	0	1	1	1	0	4
OG0023042	0	3	1	0	0	0	0	4
OG0023043	0	1	0	0	1	1	1	4
OG0023044	0	2	0	0	0	0	2	4
OG0023045	0	3	0	0	1	0	0	4
OG0023046	0	2	0	0	2	0	0	4
OG0023047	0	4	0	0	0	0	0	4
OG0023048	0	4	0	0	0	0	0	4
OG0023049	0	4	0	0	0	0	0	4
OG0023050	0	2	0	0	1	1	0	4
OG0023051	0	2	0	0	1	1	0	4
OG0023052	0	3	0	0	0	0	1	4
OG0023053	0	1	0	1	0	1	1	4
OG0023054	0	2	0	2	0	0	0	4
OG0023055	0	4	0	0	0	0	0	4
OG0023056	0	1	1	0	1	0	1	4
OG0023057	0	3	0	0	0	0	1	4
OG0023058	0	3	1	0	0	0	0	4
OG0023059	0	2	0	0	0	0	2	4
OG0023060	0	3	0	1	0	0	0	4
OG0023061	0	4	0	0	0	0	0	4
OG0023062	0	4	0	0	0	0	0	4
OG0023063	0	3	0	1	0	0	0	4
OG0023064	0	4	0	0	0	0	0	4
OG0023065	0	3	0	0	0	1	0	4
OG0023066	0	2	1	1	0	0	0	4
OG0023067	0	1	1	0	2	0	0	4
OG0023068	0	2	2	0	0	0	0	4
OG0023069	0	2	0	0	1	1	0	4
OG0023070	0	4	0	0	0	0	0	4
OG0023071	0	4	0	0	0	0	0	4
OG0023072	0	4	0	0	0	0	0	4
OG0023073	0	1	0	1	0	1	1	4
OG0023074	0	4	0	0	0	0	0	4
OG0023075	0	4	0	0	0	0	0	4
OG0023076	0	2	0	2	0	0	0	4
OG0023077	0	4	0	0	0	0	0	4
OG0023078	0	4	0	0	0	0	0	4
OG0023079	0	2	0	1	0	1	0	4
OG0023080	0	3	1	0	0	0	0	4
OG0023081	0	4	0	0	0	0	0	4
OG0023082	0	4	0	0	0	0	0	4
OG0023083	0	4	0	0	0	0	0	4
OG0023084	0	1	0	0	1	1	1	4
OG0023085	0	4	0	0	0	0	0	4
OG0023086	0	1	0	1	0	1	1	4
OG0023087	0	3	0	1	0	0	0	4
OG0023088	0	1	0	1	0	0	2	4
OG0023089	0	3	0	0	0	1	0	4
OG0023090	0	1	0	1	0	0	2	4
OG0023091	0	4	0	0	0	0	0	4
OG0023092	0	2	0	1	0	1	0	4
OG0023093	0	2	1	0	0	1	0	4
OG0023094	0	2	0	0	1	1	0	4
OG0023095	0	4	0	0	0	0	0	4
OG0023096	0	3	0	0	1	0	0	4
OG0023097	0	1	0	2	1	0	0	4
OG0023098	0	2	0	0	2	0	0	4
OG0023099	0	2	0	0	1	0	1	4
OG0023100	0	2	0	0	1	1	0	4
OG0023101	0	3	0	0	0	1	0	4
OG0023102	0	4	0	0	0	0	0	4
OG0023103	0	1	1	0	0	0	2	4
OG0023104	0	2	0	0	1	1	0	4
OG0023105	0	3	0	0	0	0	1	4
OG0023106	0	2	0	0	1	0	1	4
OG0023107	0	2	0	0	0	0	2	4
OG0023108	0	1	0	0	0	1	2	4
OG0023109	0	4	0	0	0	0	0	4
OG0023110	0	2	0	0	1	1	0	4
OG0023111	0	4	0	0	0	0	0	4
OG0023112	0	4	0	0	0	0	0	4
OG0023113	0	3	0	0	1	0	0	4
OG0023114	0	3	0	0	1	0	0	4
OG0023115	0	3	0	1	0	0	0	4
OG0023116	0	2	0	1	1	0	0	4
OG0023117	0	4	0	0	0	0	0	4
OG0023118	0	2	0	0	0	1	1	4
OG0023119	0	4	0	0	0	0	0	4
OG0023120	0	3	0	0	0	0	1	4
OG0023121	0	4	0	0	0	0	0	4
OG0023122	0	3	0	1	0	0	0	4
OG0023123	0	3	1	0	0	0	0	4
OG0023124	0	3	0	0	0	0	1	4
OG0023125	0	2	0	1	1	0	0	4
OG0023126	0	2	0	0	0	0	2	4
OG0023127	0	2	2	0	0	0	0	4
OG0023128	0	1	0	1	0	1	1	4
OG0023129	0	3	0	0	0	0	1	4
OG0023130	0	4	0	0	0	0	0	4
OG0023131	0	3	0	1	0	0	0	4
OG0023132	0	2	0	1	0	1	0	4
OG0023133	0	4	0	0	0	0	0	4
OG0023134	0	4	0	0	0	0	0	4
OG0023135	0	4	0	0	0	0	0	4
OG0023136	0	2	0	1	1	0	0	4
OG0023137	0	1	1	1	0	1	0	4
OG0023138	0	4	0	0	0	0	0	4
OG0023139	0	1	0	1	0	1	1	4
OG0023140	0	1	0	1	0	1	1	4
OG0023141	0	4	0	0	0	0	0	4
OG0023142	0	3	0	0	0	0	1	4
OG0023143	0	4	0	0	0	0	0	4
OG0023144	0	3	0	0	1	0	0	4
OG0023145	0	2	0	0	1	1	0	4
OG0023146	0	1	0	0	1	1	1	4
OG0023147	0	4	0	0	0	0	0	4
OG0023148	0	2	0	0	1	1	0	4
OG0023149	0	1	0	0	1	1	1	4
OG0023150	0	3	0	0	0	1	0	4
OG0023151	0	4	0	0	0	0	0	4
OG0023152	0	2	0	1	1	0	0	4
OG0023153	0	2	0	1	1	0	0	4
OG0023154	0	4	0	0	0	0	0	4
OG0023155	0	2	0	1	1	0	0	4
OG0023156	0	3	0	1	0	0	0	4
OG0023157	0	4	0	0	0	0	0	4
OG0023158	0	3	0	0	0	0	1	4
OG0023159	0	1	0	0	1	1	1	4
OG0023160	0	2	0	0	1	0	1	4
OG0023161	0	3	0	0	1	0	0	4
OG0023162	0	1	0	0	1	1	1	4
OG0023163	0	4	0	0	0	0	0	4
OG0023164	0	2	0	0	0	1	1	4
OG0023165	0	4	0	0	0	0	0	4
OG0023166	0	2	0	0	0	1	1	4
OG0023167	0	2	0	1	1	0	0	4
OG0023168	0	2	0	2	0	0	0	4
OG0023169	0	2	0	2	0	0	0	4
OG0023170	0	3	0	0	0	0	1	4
OG0023171	0	2	0	1	0	0	1	4
OG0023172	0	1	0	1	1	0	1	4
OG0023173	0	2	0	1	0	1	0	4
OG0023174	0	2	0	1	1	0	0	4
OG0023175	0	2	2	0	0	0	0	4
OG0023176	0	4	0	0	0	0	0	4
OG0023177	0	2	2	0	0	0	0	4
OG0023178	0	3	0	1	0	0	0	4
OG0023179	0	3	0	0	0	0	1	4
OG0023180	0	2	0	0	2	0	0	4
OG0023181	0	3	0	0	0	0	1	4
OG0023182	0	4	0	0	0	0	0	4
OG0023183	0	2	1	1	0	0	0	4
OG0023184	0	2	1	1	0	0	0	4
OG0023185	0	3	1	0	0	0	0	4
OG0023186	0	4	0	0	0	0	0	4
OG0023187	0	2	2	0	0	0	0	4
OG0023188	0	2	1	0	0	0	1	4
OG0023189	0	2	0	1	1	0	0	4
OG0023190	0	1	0	1	2	0	0	4
OG0023191	0	4	0	0	0	0	0	4
OG0023192	0	1	0	1	0	1	1	4
OG0023193	0	2	0	1	1	0	0	4
OG0023194	0	2	1	1	0	0	0	4
OG0023195	0	2	0	2	0	0	0	4
OG0023196	0	2	0	1	0	1	0	4
OG0023197	0	4	0	0	0	0	0	4
OG0023198	0	1	1	1	0	0	1	4
OG0023199	0	1	0	0	0	2	1	4
OG0023200	0	1	0	1	1	0	1	4
OG0023201	0	2	0	0	0	0	2	4
OG0023202	0	1	0	1	0	1	1	4
OG0023203	0	4	0	0	0	0	0	4
OG0023204	0	2	0	2	0	0	0	4
OG0023205	0	1	1	0	0	1	1	4
OG0023206	0	4	0	0	0	0	0	4
OG0023207	0	4	0	0	0	0	0	4
OG0023208	0	4	0	0	0	0	0	4
OG0023209	0	3	0	0	0	0	1	4
OG0023210	0	4	0	0	0	0	0	4
OG0023211	0	3	0	0	1	0	0	4
OG0023212	0	3	0	0	0	1	0	4
OG0023213	0	2	0	0	0	2	0	4
OG0023214	0	1	0	0	1	1	1	4
OG0023215	0	1	0	1	0	1	1	4
OG0023216	0	3	0	0	0	0	1	4
OG0023217	0	4	0	0	0	0	0	4
OG0023218	0	3	0	1	0	0	0	4
OG0023219	0	4	0	0	0	0	0	4
OG0023220	0	2	0	1	0	0	1	4
OG0023221	0	3	0	0	0	0	1	4
OG0023222	0	3	0	0	1	0	0	4
OG0023223	0	2	1	0	1	0	0	4
OG0023224	0	1	1	0	1	1	0	4
OG0023225	0	1	1	0	1	1	0	4
OG0023226	0	4	0	0	0	0	0	4
OG0023227	0	3	0	0	1	0	0	4
OG0023228	0	3	0	0	1	0	0	4
OG0023229	0	4	0	0	0	0	0	4
OG0023230	0	2	0	0	1	1	0	4
OG0023231	0	2	0	0	0	0	2	4
OG0023232	0	2	0	0	1	0	1	4
OG0023233	0	1	0	0	1	1	1	4
OG0023234	0	1	0	0	1	1	1	4
OG0023235	0	2	0	0	0	0	2	4
OG0023236	0	1	1	0	0	0	2	4
OG0023237	0	2	0	1	1	0	0	4
OG0023238	0	2	0	1	0	1	0	4
OG0023239	0	1	0	1	0	1	1	4
OG0023240	0	2	0	1	0	0	1	4
OG0023241	0	4	0	0	0	0	0	4
OG0023242	0	2	1	1	0	0	0	4
OG0023243	0	2	0	1	0	1	0	4
OG0023244	0	4	0	0	0	0	0	4
OG0023245	0	1	1	1	1	0	0	4
OG0023246	0	4	0	0	0	0	0	4
OG0023247	0	1	1	0	1	1	0	4
OG0023248	0	2	0	0	1	0	1	4
OG0023249	0	1	0	0	0	0	3	4
OG0023250	0	3	0	0	1	0	0	4
OG0023251	0	4	0	0	0	0	0	4
OG0023252	0	1	0	0	1	1	1	4
OG0023253	0	4	0	0	0	0	0	4
OG0023254	0	4	0	0	0	0	0	4
OG0023255	0	2	0	0	1	1	0	4
OG0023256	0	4	0	0	0	0	0	4
OG0023257	0	3	0	0	0	0	1	4
OG0023258	0	3	1	0	0	0	0	4
OG0023259	0	2	0	0	2	0	0	4
OG0023260	0	2	0	0	1	0	1	4
OG0023261	0	4	0	0	0	0	0	4
OG0023262	0	1	0	0	1	0	2	4
OG0023263	0	2	0	0	0	0	2	4
OG0023264	0	4	0	0	0	0	0	4
OG0023265	0	1	0	0	0	1	2	4
OG0023266	0	2	0	0	0	1	1	4
OG0023267	0	2	0	1	0	0	1	4
OG0023268	0	1	0	1	2	0	0	4
OG0023269	0	4	0	0	0	0	0	4
OG0023270	0	1	0	0	0	0	3	4
OG0023271	0	3	0	0	1	0	0	4
OG0023272	0	1	1	0	0	1	1	4
OG0023273	0	4	0	0	0	0	0	4
OG0023274	0	3	0	0	1	0	0	4
OG0023275	0	4	0	0	0	0	0	4
OG0023276	0	3	1	0	0	0	0	4
OG0023277	0	2	0	1	1	0	0	4
OG0023278	0	1	0	0	0	1	2	4
OG0023279	0	2	0	0	1	0	1	4
OG0023280	0	4	0	0	0	0	0	4
OG0023281	0	1	0	0	0	0	3	4
OG0023282	0	2	0	1	1	0	0	4
OG0023283	0	4	0	0	0	0	0	4
OG0023284	0	2	0	0	0	0	2	4
OG0023285	0	4	0	0	0	0	0	4
OG0023286	0	2	0	0	1	1	0	4
OG0023287	0	3	0	0	1	0	0	4
OG0023288	0	2	1	1	0	0	0	4
OG0023289	0	3	0	0	0	0	1	4
OG0023290	0	4	0	0	0	0	0	4
OG0023291	0	3	0	1	0	0	0	4
OG0023292	0	1	1	0	0	1	1	4
OG0023293	0	2	0	1	1	0	0	4
OG0023294	0	2	1	0	0	0	1	4
OG0023295	0	1	0	1	0	1	1	4
OG0023296	0	2	0	1	1	0	0	4
OG0023297	0	2	0	2	0	0	0	4
OG0023298	0	2	0	1	0	0	1	4
OG0023299	0	2	0	0	1	0	1	4
OG0023300	0	2	0	0	1	1	0	4
OG0023301	0	2	1	0	0	0	1	4
OG0023302	0	4	0	0	0	0	0	4
OG0023303	0	1	0	1	1	1	0	4
OG0023304	0	2	0	1	1	0	0	4
OG0023305	0	2	0	1	1	0	0	4
OG0023306	0	2	1	0	0	0	1	4
OG0023307	0	4	0	0	0	0	0	4
OG0023308	0	3	0	1	0	0	0	4
OG0023309	0	1	0	0	1	1	1	4
OG0023310	0	2	0	0	1	0	1	4
OG0023311	0	1	0	0	0	1	2	4
OG0023312	0	1	0	1	1	1	0	4
OG0023313	0	4	0	0	0	0	0	4
OG0023314	0	2	0	1	0	0	1	4
OG0023315	0	1	1	0	1	1	0	4
OG0023316	0	1	0	2	1	0	0	4
OG0023317	0	1	1	1	0	0	1	4
OG0023318	0	1	0	0	0	1	2	4
OG0023319	0	1	0	0	0	0	3	4
OG0023320	0	2	0	1	0	0	1	4
OG0023321	0	1	0	2	1	0	0	4
OG0023322	0	4	0	0	0	0	0	4
OG0023323	0	2	1	0	1	0	0	4
OG0023324	0	1	0	0	2	1	0	4
OG0023325	0	1	0	0	0	0	3	4
OG0023326	0	1	0	0	1	1	1	4
OG0023327	0	4	0	0	0	0	0	4
OG0023328	0	2	0	1	1	0	0	4
OG0023329	0	1	0	1	2	0	0	4
OG0023330	0	1	1	1	0	0	1	4
OG0023331	0	2	0	1	0	1	0	4
OG0023332	0	3	0	0	0	0	1	4
OG0023333	0	3	0	0	0	0	1	4
OG0023334	0	1	0	0	0	0	3	4
OG0023335	0	4	0	0	0	0	0	4
OG0023336	0	2	0	0	0	1	1	4
OG0023337	0	2	1	0	0	0	1	4
OG0023338	0	1	0	0	1	0	2	4
OG0023339	0	1	0	2	1	0	0	4
OG0023340	0	2	0	1	0	0	1	4
OG0023341	0	1	0	0	1	1	1	4
OG0023342	0	1	0	0	0	2	1	4
OG0023343	0	2	0	0	1	0	1	4
OG0023344	0	2	0	0	0	0	2	4
OG0023345	0	1	0	0	0	2	1	4
OG0023346	0	2	0	0	2	0	0	4
OG0023347	0	2	1	1	0	0	0	4
OG0023348	0	3	0	1	0	0	0	4
OG0023349	0	1	0	1	0	1	1	4
OG0023350	0	1	0	1	1	1	0	4
OG0023351	0	4	0	0	0	0	0	4
OG0023352	0	3	0	0	0	0	1	4
OG0023353	0	1	1	0	1	1	0	4
OG0023354	0	1	0	0	0	0	3	4
OG0023355	0	2	0	0	0	1	1	4
OG0023356	0	2	0	0	0	1	1	4
OG0023357	0	2	0	0	0	1	1	4
OG0023358	0	2	0	1	0	1	0	4
OG0023359	0	1	1	1	1	0	0	4
OG0023360	0	2	1	0	1	0	0	4
OG0023361	0	1	0	1	1	1	0	4
OG0023362	0	2	0	0	1	1	0	4
OG0023363	0	1	0	0	2	0	1	4
OG0023364	0	1	1	1	0	0	1	4
OG0023365	0	1	0	1	0	0	2	4
OG0023366	0	1	1	1	1	0	0	4
OG0023367	0	1	0	0	0	1	2	4
OG0023368	0	1	0	0	0	0	3	4
OG0023369	0	1	1	0	0	0	2	4
OG0023370	0	2	0	0	0	1	1	4
OG0023371	0	2	0	1	0	0	1	4
OG0023372	0	1	0	2	0	1	0	4
OG0023373	0	2	0	0	1	1	0	4
OG0023374	0	1	0	1	0	1	1	4
OG0023375	0	1	0	1	0	1	1	4
OG0023376	0	1	0	0	1	2	0	4
OG0023377	0	1	0	0	1	1	1	4
OG0023378	0	1	0	0	1	1	1	4
OG0023379	0	3	0	0	1	0	0	4
OG0023380	0	1	0	0	0	1	2	4
OG0023381	0	1	0	0	1	1	1	4
OG0023382	0	2	0	1	0	0	1	4
OG0023383	0	2	0	0	0	0	2	4
OG0023384	0	1	0	0	0	1	2	4
OG0023385	0	1	0	2	0	0	1	4
OG0023386	0	1	0	1	0	1	1	4
OG0023387	0	1	1	1	0	0	1	4
OG0023388	0	1	0	0	1	0	2	4
OG0023389	0	1	0	1	1	0	1	4
OG0023390	0	1	1	0	0	1	1	4
OG0023391	0	1	0	3	0	0	0	4
OG0023392	0	1	0	1	0	1	1	4
OG0023393	0	2	0	0	0	1	1	4
OG0023394	0	3	0	1	0	0	0	4
OG0023395	0	1	1	0	1	1	0	4
OG0023396	0	1	1	0	0	1	1	4
OG0023397	0	2	0	0	0	1	1	4
OG0023398	0	4	0	0	0	0	0	4
OG0023399	0	2	0	0	0	1	1	4
OG0023400	0	1	0	0	1	1	1	4
OG0023401	0	1	0	0	1	1	1	4
OG0023402	0	1	0	1	1	1	0	4
OG0023403	0	2	1	0	0	0	1	4
OG0023404	0	1	0	0	0	1	2	4
OG0023405	0	2	0	0	0	0	2	4
OG0023406	0	2	0	0	0	0	2	4
OG0023407	0	1	0	0	1	1	1	4
OG0023408	0	1	0	0	1	1	1	4
OG0023409	0	2	1	1	0	0	0	4
OG0023410	0	2	0	1	1	0	0	4
OG0023411	0	1	0	1	1	1	0	4
OG0023412	0	1	0	1	2	0	0	4
OG0023413	0	2	0	0	1	0	1	4
OG0023414	0	1	0	1	1	1	0	4
OG0023415	0	1	0	1	0	1	1	4
OG0023416	0	2	0	0	1	1	0	4
OG0023417	0	2	1	0	0	0	1	4
OG0023418	0	1	0	0	1	1	1	4
OG0023419	0	2	0	1	1	0	0	4
OG0023420	0	3	0	0	0	1	0	4
OG0023421	0	3	0	0	0	0	1	4
OG0023422	0	1	0	1	2	0	0	4
OG0023423	0	1	0	0	0	0	3	4
OG0023424	0	2	1	0	1	0	0	4
OG0023425	0	1	1	0	1	0	1	4
OG0023426	0	1	0	0	1	1	1	4
OG0023427	0	1	1	0	1	0	1	4
OG0023428	0	1	0	1	1	1	0	4
OG0023429	0	2	0	0	0	1	1	4
OG0023430	0	1	1	1	0	0	1	4
OG0023431	0	1	0	1	0	1	1	4
OG0023432	0	2	0	1	0	0	1	4
OG0023433	0	1	0	1	0	1	1	4
OG0023434	0	1	0	0	1	1	1	4
OG0023435	0	2	0	0	0	1	1	4
OG0023436	0	2	0	0	1	0	1	4
OG0023437	0	3	0	0	1	0	0	4
OG0023438	0	2	0	0	1	0	1	4
OG0023439	0	1	1	0	0	1	1	4
OG0023440	0	1	3	0	0	0	0	4
OG0023441	0	1	0	1	0	0	2	4
OG0023442	0	2	0	1	1	0	0	4
OG0023443	0	1	0	0	1	0	2	4
OG0023444	0	1	0	1	0	1	1	4
OG0023445	0	1	1	0	1	1	0	4
OG0023446	0	1	0	0	1	1	1	4
OG0023447	0	1	0	1	1	0	1	4
OG0023448	0	1	0	1	0	0	2	4
OG0023449	0	2	0	1	1	0	0	4
OG0023450	0	2	1	0	0	0	1	4
OG0023451	0	1	0	1	1	1	0	4
OG0023452	0	1	1	0	1	0	1	4
OG0023453	0	2	0	1	1	0	0	4
OG0023454	0	1	1	1	0	0	1	4
OG0023455	0	1	0	1	2	0	0	4
OG0023456	0	1	0	0	0	1	2	4
OG0023457	0	1	0	3	0	0	0	4
OG0023458	0	1	0	1	0	1	1	4
OG0023459	0	1	1	1	0	1	0	4
OG0023460	0	2	0	0	2	0	0	4
OG0023461	0	1	0	0	0	1	2	4
OG0023462	0	1	0	1	0	1	1	4
OG0023463	0	1	0	0	0	0	3	4
OG0023464	0	0	1	0	1	0	2	4
OG0023465	0	0	3	0	1	0	0	4
OG0023466	0	0	4	0	0	0	0	4
OG0023467	0	0	4	0	0	0	0	4
OG0023468	0	0	1	0	0	0	3	4
OG0023469	0	0	1	1	1	1	0	4
OG0023470	0	0	4	0	0	0	0	4
OG0023471	0	0	2	1	0	0	1	4
OG0023472	0	0	4	0	0	0	0	4
OG0023473	0	0	2	0	0	0	2	4
OG0023474	0	0	1	0	0	0	3	4
OG0023475	0	0	1	0	1	0	2	4
OG0023476	0	0	4	0	0	0	0	4
OG0023477	0	0	4	0	0	0	0	4
OG0023478	0	0	1	0	0	2	1	4
OG0023479	0	0	1	1	0	1	1	4
OG0023480	0	0	1	0	1	1	1	4
OG0023481	0	0	4	0	0	0	0	4
OG0023482	0	0	1	0	1	1	1	4
OG0023483	0	0	2	1	0	0	1	4
OG0023484	0	0	3	0	0	0	1	4
OG0023485	0	0	1	1	1	0	1	4
OG0023486	0	0	2	0	0	0	2	4
OG0023487	0	0	1	1	0	1	1	4
OG0023488	0	0	1	1	1	1	0	4
OG0023489	0	0	4	0	0	0	0	4
OG0023490	0	0	1	0	1	1	1	4
OG0023491	0	0	4	0	0	0	0	4
OG0023492	0	0	1	1	1	0	1	4
OG0023493	0	0	4	0	0	0	0	4
OG0023494	0	0	4	0	0	0	0	4
OG0023495	0	0	1	0	0	0	3	4
OG0023496	0	0	2	0	0	1	1	4
OG0023497	0	0	1	0	1	1	1	4
OG0023498	0	0	1	1	1	0	1	4
OG0023499	0	0	1	1	0	2	0	4
OG0023500	0	0	1	0	0	0	3	4
OG0023501	0	0	4	0	0	0	0	4
OG0023502	0	0	1	1	0	1	1	4
OG0023503	0	0	1	0	0	1	2	4
OG0023504	0	0	1	1	1	0	1	4
OG0023505	0	0	1	0	1	1	1	4
OG0023506	0	0	1	1	0	1	1	4
OG0023507	0	0	1	0	0	0	3	4
OG0023508	0	0	1	0	0	0	3	4
OG0023509	0	0	1	1	0	1	1	4
OG0023510	0	0	1	0	0	0	3	4
OG0023511	0	0	1	0	0	1	2	4
OG0023512	0	0	1	1	2	0	0	4
OG0023513	0	0	1	1	1	0	1	4
OG0023514	0	0	1	0	1	1	1	4
OG0023515	0	0	1	0	1	1	1	4
OG0023516	0	0	3	0	0	0	1	4
OG0023517	0	0	1	1	1	1	0	4
OG0023518	0	0	1	1	1	1	0	4
OG0023519	0	0	1	1	0	1	1	4
OG0023520	0	0	1	1	1	1	0	4
OG0023521	0	0	0	1	2	1	0	4
OG0023522	0	0	0	1	1	2	0	4
OG0023523	0	0	0	1	0	1	2	4
OG0023524	0	0	0	4	0	0	0	4
OG0023525	0	0	0	1	1	1	1	4
OG0023526	0	0	0	2	0	1	1	4
OG0023527	0	0	0	2	2	0	0	4
OG0023528	0	0	0	1	0	2	1	4
OG0023529	0	0	0	1	1	1	1	4
OG0023530	0	0	0	2	1	1	0	4
OG0023531	0	0	0	1	0	0	3	4
OG0023532	0	0	0	1	1	1	1	4
OG0023533	0	0	0	1	1	1	1	4
OG0023534	0	0	0	1	1	0	2	4
OG0023535	0	0	0	1	1	1	1	4
OG0023536	0	0	0	1	3	0	0	4
OG0023537	0	0	0	1	3	0	0	4
OG0023538	0	0	0	1	0	1	2	4
OG0023539	0	0	0	1	1	1	1	4
OG0023540	0	0	0	1	0	1	2	4
OG0023541	0	0	0	2	1	1	0	4
OG0023542	0	0	0	1	3	0	0	4
OG0023543	0	0	0	1	3	0	0	4
OG0023544	0	0	0	2	1	0	1	4
OG0023545	0	0	0	1	1	1	1	4
OG0023546	0	0	0	2	1	0	1	4
OG0023547	0	0	0	1	0	2	1	4
OG0023548	0	0	0	2	0	0	2	4
OG0023549	0	0	0	2	2	0	0	4
OG0023550	0	0	0	1	1	1	1	4
OG0023551	0	0	0	2	0	1	1	4
OG0023552	0	0	0	2	2	0	0	4
OG0023553	0	0	0	1	0	0	3	4
OG0023554	0	0	0	1	0	1	2	4
OG0023555	0	0	0	1	0	2	1	4
OG0023556	0	0	0	1	2	1	0	4
OG0023557	0	0	0	0	2	2	0	4
OG0023558	0	0	0	0	3	1	0	4
OG0023559	0	0	0	0	2	2	0	4
OG0023560	0	0	0	0	2	1	1	4
OG0023561	0	0	0	0	2	1	1	4
OG0023562	0	0	0	0	2	1	1	4
OG0023563	0	0	0	0	2	1	1	4
OG0023564	0	0	0	0	3	1	0	4
OG0023565	0	0	0	0	1	1	2	4
OG0023566	0	0	0	0	2	1	1	4
OG0023567	0	0	0	0	3	0	1	4
OG0023568	0	0	0	0	1	2	1	4
OG0023569	0	0	0	0	0	1	3	4
OG0023570	0	0	0	0	0	1	3	4
OG0023571	0	0	0	0	0	2	2	4
OG0023572	0	0	0	0	0	3	1	4
OG0023573	0	0	0	0	0	2	2	4
OG0023574	0	0	0	0	0	2	2	4
OG0023575	0	0	0	0	0	1	3	4
OG0023576	0	0	0	0	0	2	2	4
OG0023577	0	0	0	0	0	1	3	4
OG0023578	0	0	0	0	0	1	3	4
OG0023579	0	0	0	0	0	2	2	4
OG0023580	0	0	0	0	0	1	3	4
OG0023581	0	0	0	0	0	1	3	4
OG0023582	0	0	0	0	0	1	3	4
OG0023583	0	0	0	0	0	0	4	4
OG0023584	0	0	0	0	0	0	4	4
OG0023585	0	0	0	0	0	0	4	4
OG0023586	0	0	0	0	0	0	4	4
OG0023587	0	0	0	0	0	0	4	4
OG0023588	0	0	0	0	0	0	4	4
OG0023589	0	0	0	0	0	0	4	4
OG0023590	0	0	0	0	0	0	4	4
OG0023591	0	0	0	0	0	0	4	4
OG0023592	0	0	0	0	0	0	4	4
OG0023593	0	0	0	0	0	0	4	4
OG0023594	0	0	0	0	0	0	4	4
OG0023595	0	0	0	0	0	0	4	4
OG0023596	0	0	0	0	0	0	4	4
OG0023597	0	0	0	0	0	0	4	4
OG0023598	0	0	0	0	0	0	4	4
OG0023599	0	0	0	0	0	0	4	4
OG0023600	0	0	0	0	0	0	4	4
OG0023601	0	0	0	0	0	0	4	4
OG0023602	0	0	0	0	0	0	4	4
OG0023603	0	0	0	0	0	0	4	4
OG0023604	0	0	0	0	0	0	4	4
OG0023605	0	0	0	0	0	0	4	4
OG0023606	0	0	0	0	0	0	4	4
OG0023607	0	0	0	0	0	0	4	4
OG0023608	0	0	0	0	0	0	4	4
OG0023609	0	0	0	0	0	0	4	4
OG0023610	0	0	0	0	0	0	4	4
OG0023611	0	0	0	0	0	0	4	4
OG0023612	0	0	0	0	0	0	4	4
OG0023613	3	0	0	0	0	0	0	3
OG0023614	3	0	0	0	0	0	0	3
OG0023615	3	0	0	0	0	0	0	3
OG0023616	2	0	0	0	0	1	0	3
OG0023617	3	0	0	0	0	0	0	3
OG0023618	3	0	0	0	0	0	0	3
OG0023619	3	0	0	0	0	0	0	3
OG0023620	3	0	0	0	0	0	0	3
OG0023621	2	0	1	0	0	0	0	3
OG0023622	3	0	0	0	0	0	0	3
OG0023623	3	0	0	0	0	0	0	3
OG0023624	3	0	0	0	0	0	0	3
OG0023625	3	0	0	0	0	0	0	3
OG0023626	3	0	0	0	0	0	0	3
OG0023627	3	0	0	0	0	0	0	3
OG0023628	3	0	0	0	0	0	0	3
OG0023629	1	1	0	0	1	0	0	3
OG0023630	2	1	0	0	0	0	0	3
OG0023631	2	0	0	0	0	1	0	3
OG0023632	3	0	0	0	0	0	0	3
OG0023633	1	2	0	0	0	0	0	3
OG0023634	1	0	1	0	0	0	1	3
OG0023635	3	0	0	0	0	0	0	3
OG0023636	3	0	0	0	0	0	0	3
OG0023637	3	0	0	0	0	0	0	3
OG0023638	3	0	0	0	0	0	0	3
OG0023639	1	0	1	0	0	0	1	3
OG0023640	2	0	1	0	0	0	0	3
OG0023641	3	0	0	0	0	0	0	3
OG0023642	3	0	0	0	0	0	0	3
OG0023643	3	0	0	0	0	0	0	3
OG0023644	1	2	0	0	0	0	0	3
OG0023645	3	0	0	0	0	0	0	3
OG0023646	2	0	1	0	0	0	0	3
OG0023647	3	0	0	0	0	0	0	3
OG0023648	1	2	0	0	0	0	0	3
OG0023649	3	0	0	0	0	0	0	3
OG0023650	3	0	0	0	0	0	0	3
OG0023651	3	0	0	0	0	0	0	3
OG0023652	3	0	0	0	0	0	0	3
OG0023653	2	1	0	0	0	0	0	3
OG0023654	3	0	0	0	0	0	0	3
OG0023655	2	0	1	0	0	0	0	3
OG0023656	3	0	0	0	0	0	0	3
OG0023657	3	0	0	0	0	0	0	3
OG0023658	3	0	0	0	0	0	0	3
OG0023659	3	0	0	0	0	0	0	3
OG0023660	2	1	0	0	0	0	0	3
OG0023661	3	0	0	0	0	0	0	3
OG0023662	3	0	0	0	0	0	0	3
OG0023663	3	0	0	0	0	0	0	3
OG0023664	3	0	0	0	0	0	0	3
OG0023665	3	0	0	0	0	0	0	3
OG0023666	3	0	0	0	0	0	0	3
OG0023667	3	0	0	0	0	0	0	3
OG0023668	3	0	0	0	0	0	0	3
OG0023669	3	0	0	0	0	0	0	3
OG0023670	2	1	0	0	0	0	0	3
OG0023671	3	0	0	0	0	0	0	3
OG0023672	3	0	0	0	0	0	0	3
OG0023673	3	0	0	0	0	0	0	3
OG0023674	3	0	0	0	0	0	0	3
OG0023675	3	0	0	0	0	0	0	3
OG0023676	3	0	0	0	0	0	0	3
OG0023677	3	0	0	0	0	0	0	3
OG0023678	3	0	0	0	0	0	0	3
OG0023679	2	1	0	0	0	0	0	3
OG0023680	3	0	0	0	0	0	0	3
OG0023681	3	0	0	0	0	0	0	3
OG0023682	2	1	0	0	0	0	0	3
OG0023683	3	0	0	0	0	0	0	3
OG0023684	3	0	0	0	0	0	0	3
OG0023685	3	0	0	0	0	0	0	3
OG0023686	3	0	0	0	0	0	0	3
OG0023687	3	0	0	0	0	0	0	3
OG0023688	3	0	0	0	0	0	0	3
OG0023689	1	2	0	0	0	0	0	3
OG0023690	3	0	0	0	0	0	0	3
OG0023691	3	0	0	0	0	0	0	3
OG0023692	3	0	0	0	0	0	0	3
OG0023693	2	1	0	0	0	0	0	3
OG0023694	3	0	0	0	0	0	0	3
OG0023695	1	2	0	0	0	0	0	3
OG0023696	3	0	0	0	0	0	0	3
OG0023697	3	0	0	0	0	0	0	3
OG0023698	3	0	0	0	0	0	0	3
OG0023699	1	2	0	0	0	0	0	3
OG0023700	3	0	0	0	0	0	0	3
OG0023701	3	0	0	0	0	0	0	3
OG0023702	3	0	0	0	0	0	0	3
OG0023703	3	0	0	0	0	0	0	3
OG0023704	3	0	0	0	0	0	0	3
OG0023705	3	0	0	0	0	0	0	3
OG0023706	3	0	0	0	0	0	0	3
OG0023707	3	0	0	0	0	0	0	3
OG0023708	3	0	0	0	0	0	0	3
OG0023709	1	1	0	1	0	0	0	3
OG0023710	3	0	0	0	0	0	0	3
OG0023711	3	0	0	0	0	0	0	3
OG0023712	3	0	0	0	0	0	0	3
OG0023713	3	0	0	0	0	0	0	3
OG0023714	1	1	1	0	0	0	0	3
OG0023715	3	0	0	0	0	0	0	3
OG0023716	3	0	0	0	0	0	0	3
OG0023717	3	0	0	0	0	0	0	3
OG0023718	2	0	0	1	0	0	0	3
OG0023719	3	0	0	0	0	0	0	3
OG0023720	3	0	0	0	0	0	0	3
OG0023721	3	0	0	0	0	0	0	3
OG0023722	3	0	0	0	0	0	0	3
OG0023723	3	0	0	0	0	0	0	3
OG0023724	3	0	0	0	0	0	0	3
OG0023725	3	0	0	0	0	0	0	3
OG0023726	1	1	1	0	0	0	0	3
OG0023727	3	0	0	0	0	0	0	3
OG0023728	3	0	0	0	0	0	0	3
OG0023729	3	0	0	0	0	0	0	3
OG0023730	3	0	0	0	0	0	0	3
OG0023731	3	0	0	0	0	0	0	3
OG0023732	1	2	0	0	0	0	0	3
OG0023733	3	0	0	0	0	0	0	3
OG0023734	3	0	0	0	0	0	0	3
OG0023735	3	0	0	0	0	0	0	3
OG0023736	3	0	0	0	0	0	0	3
OG0023737	3	0	0	0	0	0	0	3
OG0023738	2	1	0	0	0	0	0	3
OG0023739	3	0	0	0	0	0	0	3
OG0023740	1	0	1	0	0	0	1	3
OG0023741	3	0	0	0	0	0	0	3
OG0023742	3	0	0	0	0	0	0	3
OG0023743	3	0	0	0	0	0	0	3
OG0023744	1	1	0	1	0	0	0	3
OG0023745	1	2	0	0	0	0	0	3
OG0023746	3	0	0	0	0	0	0	3
OG0023747	3	0	0	0	0	0	0	3
OG0023748	1	1	0	0	1	0	0	3
OG0023749	3	0	0	0	0	0	0	3
OG0023750	3	0	0	0	0	0	0	3
OG0023751	3	0	0	0	0	0	0	3
OG0023752	2	1	0	0	0	0	0	3
OG0023753	3	0	0	0	0	0	0	3
OG0023754	3	0	0	0	0	0	0	3
OG0023755	3	0	0	0	0	0	0	3
OG0023756	2	0	0	0	0	1	0	3
OG0023757	3	0	0	0	0	0	0	3
OG0023758	3	0	0	0	0	0	0	3
OG0023759	3	0	0	0	0	0	0	3
OG0023760	3	0	0	0	0	0	0	3
OG0023761	3	0	0	0	0	0	0	3
OG0023762	3	0	0	0	0	0	0	3
OG0023763	3	0	0	0	0	0	0	3
OG0023764	1	2	0	0	0	0	0	3
OG0023765	3	0	0	0	0	0	0	3
OG0023766	3	0	0	0	0	0	0	3
OG0023767	3	0	0	0	0	0	0	3
OG0023768	2	1	0	0	0	0	0	3
OG0023769	3	0	0	0	0	0	0	3
OG0023770	1	1	0	1	0	0	0	3
OG0023771	1	0	0	1	0	1	0	3
OG0023772	3	0	0	0	0	0	0	3
OG0023773	1	1	1	0	0	0	0	3
OG0023774	3	0	0	0	0	0	0	3
OG0023775	3	0	0	0	0	0	0	3
OG0023776	3	0	0	0	0	0	0	3
OG0023777	3	0	0	0	0	0	0	3
OG0023778	3	0	0	0	0	0	0	3
OG0023779	3	0	0	0	0	0	0	3
OG0023780	3	0	0	0	0	0	0	3
OG0023781	2	0	0	0	0	1	0	3
OG0023782	1	0	0	0	1	1	0	3
OG0023783	3	0	0	0	0	0	0	3
OG0023784	3	0	0	0	0	0	0	3
OG0023785	1	1	0	0	0	1	0	3
OG0023786	3	0	0	0	0	0	0	3
OG0023787	3	0	0	0	0	0	0	3
OG0023788	3	0	0	0	0	0	0	3
OG0023789	3	0	0	0	0	0	0	3
OG0023790	3	0	0	0	0	0	0	3
OG0023791	3	0	0	0	0	0	0	3
OG0023792	2	1	0	0	0	0	0	3
OG0023793	3	0	0	0	0	0	0	3
OG0023794	3	0	0	0	0	0	0	3
OG0023795	3	0	0	0	0	0	0	3
OG0023796	3	0	0	0	0	0	0	3
OG0023797	2	1	0	0	0	0	0	3
OG0023798	3	0	0	0	0	0	0	3
OG0023799	3	0	0	0	0	0	0	3
OG0023800	3	0	0	0	0	0	0	3
OG0023801	3	0	0	0	0	0	0	3
OG0023802	3	0	0	0	0	0	0	3
OG0023803	3	0	0	0	0	0	0	3
OG0023804	3	0	0	0	0	0	0	3
OG0023805	3	0	0	0	0	0	0	3
OG0023806	3	0	0	0	0	0	0	3
OG0023807	3	0	0	0	0	0	0	3
OG0023808	3	0	0	0	0	0	0	3
OG0023809	3	0	0	0	0	0	0	3
OG0023810	3	0	0	0	0	0	0	3
OG0023811	3	0	0	0	0	0	0	3
OG0023812	3	0	0	0	0	0	0	3
OG0023813	3	0	0	0	0	0	0	3
OG0023814	3	0	0	0	0	0	0	3
OG0023815	3	0	0	0	0	0	0	3
OG0023816	3	0	0	0	0	0	0	3
OG0023817	3	0	0	0	0	0	0	3
OG0023818	3	0	0	0	0	0	0	3
OG0023819	3	0	0	0	0	0	0	3
OG0023820	3	0	0	0	0	0	0	3
OG0023821	1	0	1	0	0	0	1	3
OG0023822	3	0	0	0	0	0	0	3
OG0023823	3	0	0	0	0	0	0	3
OG0023824	3	0	0	0	0	0	0	3
OG0023825	3	0	0	0	0	0	0	3
OG0023826	1	2	0	0	0	0	0	3
OG0023827	1	0	0	0	0	0	2	3
OG0023828	2	0	0	0	0	1	0	3
OG0023829	3	0	0	0	0	0	0	3
OG0023830	3	0	0	0	0	0	0	3
OG0023831	3	0	0	0	0	0	0	3
OG0023832	1	2	0	0	0	0	0	3
OG0023833	3	0	0	0	0	0	0	3
OG0023834	3	0	0	0	0	0	0	3
OG0023835	2	0	0	0	0	0	1	3
OG0023836	3	0	0	0	0	0	0	3
OG0023837	3	0	0	0	0	0	0	3
OG0023838	1	1	0	0	0	1	0	3
OG0023839	3	0	0	0	0	0	0	3
OG0023840	3	0	0	0	0	0	0	3
OG0023841	3	0	0	0	0	0	0	3
OG0023842	3	0	0	0	0	0	0	3
OG0023843	3	0	0	0	0	0	0	3
OG0023844	3	0	0	0	0	0	0	3
OG0023845	1	1	1	0	0	0	0	3
OG0023846	3	0	0	0	0	0	0	3
OG0023847	3	0	0	0	0	0	0	3
OG0023848	3	0	0	0	0	0	0	3
OG0023849	3	0	0	0	0	0	0	3
OG0023850	1	2	0	0	0	0	0	3
OG0023851	2	0	1	0	0	0	0	3
OG0023852	3	0	0	0	0	0	0	3
OG0023853	3	0	0	0	0	0	0	3
OG0023854	2	0	0	0	0	0	1	3
OG0023855	3	0	0	0	0	0	0	3
OG0023856	3	0	0	0	0	0	0	3
OG0023857	3	0	0	0	0	0	0	3
OG0023858	3	0	0	0	0	0	0	3
OG0023859	3	0	0	0	0	0	0	3
OG0023860	2	1	0	0	0	0	0	3
OG0023861	1	0	0	1	0	0	1	3
OG0023862	3	0	0	0	0	0	0	3
OG0023863	2	1	0	0	0	0	0	3
OG0023864	3	0	0	0	0	0	0	3
OG0023865	3	0	0	0	0	0	0	3
OG0023866	2	0	1	0	0	0	0	3
OG0023867	3	0	0	0	0	0	0	3
OG0023868	3	0	0	0	0	0	0	3
OG0023869	1	0	1	0	0	0	1	3
OG0023870	2	1	0	0	0	0	0	3
OG0023871	3	0	0	0	0	0	0	3
OG0023872	3	0	0	0	0	0	0	3
OG0023873	1	1	1	0	0	0	0	3
OG0023874	2	0	0	0	0	1	0	3
OG0023875	3	0	0	0	0	0	0	3
OG0023876	1	1	0	0	0	0	1	3
OG0023877	1	0	0	1	0	0	1	3
OG0023878	3	0	0	0	0	0	0	3
OG0023879	3	0	0	0	0	0	0	3
OG0023880	3	0	0	0	0	0	0	3
OG0023881	3	0	0	0	0	0	0	3
OG0023882	3	0	0	0	0	0	0	3
OG0023883	3	0	0	0	0	0	0	3
OG0023884	1	0	1	0	0	0	1	3
OG0023885	1	1	0	0	0	1	0	3
OG0023886	3	0	0	0	0	0	0	3
OG0023887	3	0	0	0	0	0	0	3
OG0023888	3	0	0	0	0	0	0	3
OG0023889	3	0	0	0	0	0	0	3
OG0023890	3	0	0	0	0	0	0	3
OG0023891	1	2	0	0	0	0	0	3
OG0023892	3	0	0	0	0	0	0	3
OG0023893	3	0	0	0	0	0	0	3
OG0023894	3	0	0	0	0	0	0	3
OG0023895	1	2	0	0	0	0	0	3
OG0023896	3	0	0	0	0	0	0	3
OG0023897	3	0	0	0	0	0	0	3
OG0023898	3	0	0	0	0	0	0	3
OG0023899	3	0	0	0	0	0	0	3
OG0023900	3	0	0	0	0	0	0	3
OG0023901	3	0	0	0	0	0	0	3
OG0023902	3	0	0	0	0	0	0	3
OG0023903	3	0	0	0	0	0	0	3
OG0023904	3	0	0	0	0	0	0	3
OG0023905	1	1	0	0	0	1	0	3
OG0023906	3	0	0	0	0	0	0	3
OG0023907	3	0	0	0	0	0	0	3
OG0023908	3	0	0	0	0	0	0	3
OG0023909	1	1	0	0	1	0	0	3
OG0023910	1	1	1	0	0	0	0	3
OG0023911	3	0	0	0	0	0	0	3
OG0023912	3	0	0	0	0	0	0	3
OG0023913	3	0	0	0	0	0	0	3
OG0023914	3	0	0	0	0	0	0	3
OG0023915	1	0	0	0	0	1	1	3
OG0023916	3	0	0	0	0	0	0	3
OG0023917	3	0	0	0	0	0	0	3
OG0023918	3	0	0	0	0	0	0	3
OG0023919	1	0	2	0	0	0	0	3
OG0023920	1	1	0	1	0	0	0	3
OG0023921	2	1	0	0	0	0	0	3
OG0023922	1	0	2	0	0	0	0	3
OG0023923	1	0	1	0	0	0	1	3
OG0023924	1	1	0	0	1	0	0	3
OG0023925	1	0	1	0	0	0	1	3
OG0023926	3	0	0	0	0	0	0	3
OG0023927	2	0	1	0	0	0	0	3
OG0023928	2	1	0	0	0	0	0	3
OG0023929	1	1	0	1	0	0	0	3
OG0023930	1	0	1	0	0	0	1	3
OG0023931	3	0	0	0	0	0	0	3
OG0023932	3	0	0	0	0	0	0	3
OG0023933	1	2	0	0	0	0	0	3
OG0023934	3	0	0	0	0	0	0	3
OG0023935	3	0	0	0	0	0	0	3
OG0023936	3	0	0	0	0	0	0	3
OG0023937	3	0	0	0	0	0	0	3
OG0023938	3	0	0	0	0	0	0	3
OG0023939	2	0	1	0	0	0	0	3
OG0023940	3	0	0	0	0	0	0	3
OG0023941	2	0	0	1	0	0	0	3
OG0023942	1	2	0	0	0	0	0	3
OG0023943	3	0	0	0	0	0	0	3
OG0023944	3	0	0	0	0	0	0	3
OG0023945	3	0	0	0	0	0	0	3
OG0023946	1	2	0	0	0	0	0	3
OG0023947	3	0	0	0	0	0	0	3
OG0023948	2	1	0	0	0	0	0	3
OG0023949	1	2	0	0	0	0	0	3
OG0023950	1	0	0	1	0	0	1	3
OG0023951	1	1	0	1	0	0	0	3
OG0023952	2	1	0	0	0	0	0	3
OG0023953	3	0	0	0	0	0	0	3
OG0023954	1	2	0	0	0	0	0	3
OG0023955	1	1	1	0	0	0	0	3
OG0023956	2	1	0	0	0	0	0	3
OG0023957	2	0	0	0	1	0	0	3
OG0023958	3	0	0	0	0	0	0	3
OG0023959	2	0	1	0	0	0	0	3
OG0023960	1	1	0	0	1	0	0	3
OG0023961	3	0	0	0	0	0	0	3
OG0023962	1	1	0	0	0	1	0	3
OG0023963	2	1	0	0	0	0	0	3
OG0023964	3	0	0	0	0	0	0	3
OG0023965	3	0	0	0	0	0	0	3
OG0023966	3	0	0	0	0	0	0	3
OG0023967	3	0	0	0	0	0	0	3
OG0023968	1	2	0	0	0	0	0	3
OG0023969	3	0	0	0	0	0	0	3
OG0023970	3	0	0	0	0	0	0	3
OG0023971	3	0	0	0	0	0	0	3
OG0023972	3	0	0	0	0	0	0	3
OG0023973	3	0	0	0	0	0	0	3
OG0023974	3	0	0	0	0	0	0	3
OG0023975	3	0	0	0	0	0	0	3
OG0023976	1	2	0	0	0	0	0	3
OG0023977	3	0	0	0	0	0	0	3
OG0023978	1	2	0	0	0	0	0	3
OG0023979	1	0	0	0	1	0	1	3
OG0023980	1	2	0	0	0	0	0	3
OG0023981	3	0	0	0	0	0	0	3
OG0023982	3	0	0	0	0	0	0	3
OG0023983	1	1	0	0	0	0	1	3
OG0023984	1	0	1	0	0	0	1	3
OG0023985	1	1	0	0	0	0	1	3
OG0023986	3	0	0	0	0	0	0	3
OG0023987	3	0	0	0	0	0	0	3
OG0023988	1	2	0	0	0	0	0	3
OG0023989	3	0	0	0	0	0	0	3
OG0023990	3	0	0	0	0	0	0	3
OG0023991	1	0	1	0	1	0	0	3
OG0023992	3	0	0	0	0	0	0	3
OG0023993	2	1	0	0	0	0	0	3
OG0023994	1	2	0	0	0	0	0	3
OG0023995	1	2	0	0	0	0	0	3
OG0023996	3	0	0	0	0	0	0	3
OG0023997	3	0	0	0	0	0	0	3
OG0023998	3	0	0	0	0	0	0	3
OG0023999	3	0	0	0	0	0	0	3
OG0024000	2	1	0	0	0	0	0	3
OG0024001	2	0	0	0	0	0	1	3
OG0024002	2	1	0	0	0	0	0	3
OG0024003	3	0	0	0	0	0	0	3
OG0024004	3	0	0	0	0	0	0	3
OG0024005	1	2	0	0	0	0	0	3
OG0024006	1	1	0	0	0	0	1	3
OG0024007	2	0	1	0	0	0	0	3
OG0024008	3	0	0	0	0	0	0	3
OG0024009	3	0	0	0	0	0	0	3
OG0024010	2	0	0	0	0	0	1	3
OG0024011	1	1	1	0	0	0	0	3
OG0024012	3	0	0	0	0	0	0	3
OG0024013	2	1	0	0	0	0	0	3
OG0024014	3	0	0	0	0	0	0	3
OG0024015	2	0	0	0	0	1	0	3
OG0024016	2	0	1	0	0	0	0	3
OG0024017	2	1	0	0	0	0	0	3
OG0024018	2	0	0	0	0	0	1	3
OG0024019	3	0	0	0	0	0	0	3
OG0024020	1	2	0	0	0	0	0	3
OG0024021	3	0	0	0	0	0	0	3
OG0024022	2	0	1	0	0	0	0	3
OG0024023	2	1	0	0	0	0	0	3
OG0024024	3	0	0	0	0	0	0	3
OG0024025	1	1	0	0	0	0	1	3
OG0024026	3	0	0	0	0	0	0	3
OG0024027	3	0	0	0	0	0	0	3
OG0024028	1	0	0	1	1	0	0	3
OG0024029	1	2	0	0	0	0	0	3
OG0024030	1	1	1	0	0	0	0	3
OG0024031	3	0	0	0	0	0	0	3
OG0024032	2	1	0	0	0	0	0	3
OG0024033	3	0	0	0	0	0	0	3
OG0024034	1	2	0	0	0	0	0	3
OG0024035	1	1	0	0	0	1	0	3
OG0024036	3	0	0	0	0	0	0	3
OG0024037	3	0	0	0	0	0	0	3
OG0024038	3	0	0	0	0	0	0	3
OG0024039	1	2	0	0	0	0	0	3
OG0024040	1	0	0	0	0	1	1	3
OG0024041	2	0	0	0	1	0	0	3
OG0024042	1	2	0	0	0	0	0	3
OG0024043	3	0	0	0	0	0	0	3
OG0024044	3	0	0	0	0	0	0	3
OG0024045	1	1	0	0	0	0	1	3
OG0024046	1	1	0	0	0	0	1	3
OG0024047	2	1	0	0	0	0	0	3
OG0024048	3	0	0	0	0	0	0	3
OG0024049	1	0	0	0	0	0	2	3
OG0024050	3	0	0	0	0	0	0	3
OG0024051	3	0	0	0	0	0	0	3
OG0024052	2	1	0	0	0	0	0	3
OG0024053	3	0	0	0	0	0	0	3
OG0024054	3	0	0	0	0	0	0	3
OG0024055	1	2	0	0	0	0	0	3
OG0024056	3	0	0	0	0	0	0	3
OG0024057	2	0	1	0	0	0	0	3
OG0024058	3	0	0	0	0	0	0	3
OG0024059	3	0	0	0	0	0	0	3
OG0024060	1	1	0	0	0	0	1	3
OG0024061	3	0	0	0	0	0	0	3
OG0024062	3	0	0	0	0	0	0	3
OG0024063	3	0	0	0	0	0	0	3
OG0024064	1	1	1	0	0	0	0	3
OG0024065	2	0	1	0	0	0	0	3
OG0024066	1	2	0	0	0	0	0	3
OG0024067	3	0	0	0	0	0	0	3
OG0024068	1	2	0	0	0	0	0	3
OG0024069	1	0	1	0	0	1	0	3
OG0024070	1	1	0	0	1	0	0	3
OG0024071	3	0	0	0	0	0	0	3
OG0024072	1	2	0	0	0	0	0	3
OG0024073	1	0	1	0	0	0	1	3
OG0024074	2	0	0	0	0	0	1	3
OG0024075	1	0	0	0	0	1	1	3
OG0024076	1	1	0	1	0	0	0	3
OG0024077	3	0	0	0	0	0	0	3
OG0024078	1	1	0	0	0	1	0	3
OG0024079	1	2	0	0	0	0	0	3
OG0024080	1	0	0	0	0	1	1	3
OG0024081	2	0	1	0	0	0	0	3
OG0024082	3	0	0	0	0	0	0	3
OG0024083	1	1	1	0	0	0	0	3
OG0024084	1	1	0	1	0	0	0	3
OG0024085	3	0	0	0	0	0	0	3
OG0024086	3	0	0	0	0	0	0	3
OG0024087	2	0	0	1	0	0	0	3
OG0024088	3	0	0	0	0	0	0	3
OG0024089	1	0	1	1	0	0	0	3
OG0024090	3	0	0	0	0	0	0	3
OG0024091	1	1	0	0	1	0	0	3
OG0024092	1	2	0	0	0	0	0	3
OG0024093	2	0	0	1	0	0	0	3
OG0024094	1	2	0	0	0	0	0	3
OG0024095	1	0	1	0	0	0	1	3
OG0024096	1	1	1	0	0	0	0	3
OG0024097	1	0	1	0	0	0	1	3
OG0024098	3	0	0	0	0	0	0	3
OG0024099	3	0	0	0	0	0	0	3
OG0024100	1	0	1	0	0	0	1	3
OG0024101	1	0	1	0	0	0	1	3
OG0024102	1	1	0	0	0	0	1	3
OG0024103	3	0	0	0	0	0	0	3
OG0024104	1	1	1	0	0	0	0	3
OG0024105	1	0	0	0	0	1	1	3
OG0024106	3	0	0	0	0	0	0	3
OG0024107	1	1	0	0	0	0	1	3
OG0024108	1	1	1	0	0	0	0	3
OG0024109	3	0	0	0	0	0	0	3
OG0024110	2	0	0	0	0	0	1	3
OG0024111	2	0	1	0	0	0	0	3
OG0024112	3	0	0	0	0	0	0	3
OG0024113	1	1	1	0	0	0	0	3
OG0024114	1	1	1	0	0	0	0	3
OG0024115	1	1	1	0	0	0	0	3
OG0024116	1	0	1	0	0	0	1	3
OG0024117	1	2	0	0	0	0	0	3
OG0024118	1	1	1	0	0	0	0	3
OG0024119	1	0	2	0	0	0	0	3
OG0024120	2	0	0	0	0	0	1	3
OG0024121	1	2	0	0	0	0	0	3
OG0024122	1	0	0	0	0	2	0	3
OG0024123	1	0	1	0	0	0	1	3
OG0024124	1	0	0	0	0	1	1	3
OG0024125	1	0	2	0	0	0	0	3
OG0024126	1	2	0	0	0	0	0	3
OG0024127	1	2	0	0	0	0	0	3
OG0024128	3	0	0	0	0	0	0	3
OG0024129	1	1	1	0	0	0	0	3
OG0024130	1	0	0	2	0	0	0	3
OG0024131	1	2	0	0	0	0	0	3
OG0024132	2	1	0	0	0	0	0	3
OG0024133	1	2	0	0	0	0	0	3
OG0024134	1	0	1	0	0	0	1	3
OG0024135	1	1	0	0	1	0	0	3
OG0024136	1	2	0	0	0	0	0	3
OG0024137	1	0	1	0	0	0	1	3
OG0024138	1	1	1	0	0	0	0	3
OG0024139	1	1	0	1	0	0	0	3
OG0024140	1	1	0	0	0	0	1	3
OG0024141	1	1	0	0	1	0	0	3
OG0024142	1	1	0	0	1	0	0	3
OG0024143	1	2	0	0	0	0	0	3
OG0024144	1	0	1	0	0	0	1	3
OG0024145	1	0	0	0	2	0	0	3
OG0024146	1	2	0	0	0	0	0	3
OG0024147	1	1	0	0	0	1	0	3
OG0024148	1	1	0	0	1	0	0	3
OG0024149	1	1	0	0	1	0	0	3
OG0024150	1	0	0	0	0	1	1	3
OG0024151	1	1	1	0	0	0	0	3
OG0024152	1	1	0	0	0	0	1	3
OG0024153	1	0	1	0	0	0	1	3
OG0024154	1	2	0	0	0	0	0	3
OG0024155	0	3	0	0	0	0	0	3
OG0024156	0	2	0	0	0	0	1	3
OG0024157	0	3	0	0	0	0	0	3
OG0024158	0	3	0	0	0	0	0	3
OG0024159	0	1	2	0	0	0	0	3
OG0024160	0	3	0	0	0	0	0	3
OG0024161	0	3	0	0	0	0	0	3
OG0024162	0	3	0	0	0	0	0	3
OG0024163	0	3	0	0	0	0	0	3
OG0024164	0	2	0	0	0	0	1	3
OG0024165	0	3	0	0	0	0	0	3
OG0024166	0	3	0	0	0	0	0	3
OG0024167	0	3	0	0	0	0	0	3
OG0024168	0	2	0	0	0	0	1	3
OG0024169	0	3	0	0	0	0	0	3
OG0024170	0	1	0	0	0	1	1	3
OG0024171	0	2	0	0	0	0	1	3
OG0024172	0	3	0	0	0	0	0	3
OG0024173	0	3	0	0	0	0	0	3
OG0024174	0	2	0	1	0	0	0	3
OG0024175	0	2	0	0	0	1	0	3
OG0024176	0	3	0	0	0	0	0	3
OG0024177	0	3	0	0	0	0	0	3
OG0024178	0	3	0	0	0	0	0	3
OG0024179	0	3	0	0	0	0	0	3
OG0024180	0	3	0	0	0	0	0	3
OG0024181	0	2	0	0	1	0	0	3
OG0024182	0	3	0	0	0	0	0	3
OG0024183	0	3	0	0	0	0	0	3
OG0024184	0	2	0	1	0	0	0	3
OG0024185	0	3	0	0	0	0	0	3
OG0024186	0	3	0	0	0	0	0	3
OG0024187	0	3	0	0	0	0	0	3
OG0024188	0	3	0	0	0	0	0	3
OG0024189	0	3	0	0	0	0	0	3
OG0024190	0	1	0	0	0	1	1	3
OG0024191	0	2	0	0	0	1	0	3
OG0024192	0	3	0	0	0	0	0	3
OG0024193	0	2	0	0	1	0	0	3
OG0024194	0	2	1	0	0	0	0	3
OG0024195	0	2	0	1	0	0	0	3
OG0024196	0	1	0	0	0	1	1	3
OG0024197	0	3	0	0	0	0	0	3
OG0024198	0	3	0	0	0	0	0	3
OG0024199	0	3	0	0	0	0	0	3
OG0024200	0	3	0	0	0	0	0	3
OG0024201	0	3	0	0	0	0	0	3
OG0024202	0	2	0	0	0	0	1	3
OG0024203	0	3	0	0	0	0	0	3
OG0024204	0	3	0	0	0	0	0	3
OG0024205	0	2	0	0	1	0	0	3
OG0024206	0	3	0	0	0	0	0	3
OG0024207	0	2	0	0	1	0	0	3
OG0024208	0	3	0	0	0	0	0	3
OG0024209	0	3	0	0	0	0	0	3
OG0024210	0	3	0	0	0	0	0	3
OG0024211	0	2	0	0	0	0	1	3
OG0024212	0	3	0	0	0	0	0	3
OG0024213	0	2	0	1	0	0	0	3
OG0024214	0	3	0	0	0	0	0	3
OG0024215	0	3	0	0	0	0	0	3
OG0024216	0	2	0	0	0	1	0	3
OG0024217	0	3	0	0	0	0	0	3
OG0024218	0	2	0	0	0	0	1	3
OG0024219	0	3	0	0	0	0	0	3
OG0024220	0	3	0	0	0	0	0	3
OG0024221	0	1	0	2	0	0	0	3
OG0024222	0	3	0	0	0	0	0	3
OG0024223	0	2	1	0	0	0	0	3
OG0024224	0	3	0	0	0	0	0	3
OG0024225	0	3	0	0	0	0	0	3
OG0024226	0	3	0	0	0	0	0	3
OG0024227	0	2	0	1	0	0	0	3
OG0024228	0	3	0	0	0	0	0	3
OG0024229	0	1	0	0	0	1	1	3
OG0024230	0	3	0	0	0	0	0	3
OG0024231	0	3	0	0	0	0	0	3
OG0024232	0	1	0	2	0	0	0	3
OG0024233	0	3	0	0	0	0	0	3
OG0024234	0	3	0	0	0	0	0	3
OG0024235	0	2	0	0	1	0	0	3
OG0024236	0	2	0	1	0	0	0	3
OG0024237	0	2	0	0	0	0	1	3
OG0024238	0	3	0	0	0	0	0	3
OG0024239	0	2	0	0	0	1	0	3
OG0024240	0	2	0	0	0	0	1	3
OG0024241	0	2	0	1	0	0	0	3
OG0024242	0	3	0	0	0	0	0	3
OG0024243	0	2	0	0	0	0	1	3
OG0024244	0	3	0	0	0	0	0	3
OG0024245	0	3	0	0	0	0	0	3
OG0024246	0	2	0	1	0	0	0	3
OG0024247	0	2	0	0	0	0	1	3
OG0024248	0	2	0	0	1	0	0	3
OG0024249	0	2	0	0	0	1	0	3
OG0024250	0	2	0	0	1	0	0	3
OG0024251	0	3	0	0	0	0	0	3
OG0024252	0	3	0	0	0	0	0	3
OG0024253	0	3	0	0	0	0	0	3
OG0024254	0	3	0	0	0	0	0	3
OG0024255	0	3	0	0	0	0	0	3
OG0024256	0	3	0	0	0	0	0	3
OG0024257	0	3	0	0	0	0	0	3
OG0024258	0	2	0	1	0	0	0	3
OG0024259	0	2	0	0	0	0	1	3
OG0024260	0	2	0	0	1	0	0	3
OG0024261	0	3	0	0	0	0	0	3
OG0024262	0	3	0	0	0	0	0	3
OG0024263	0	2	0	0	0	0	1	3
OG0024264	0	2	1	0	0	0	0	3
OG0024265	0	3	0	0	0	0	0	3
OG0024266	0	3	0	0	0	0	0	3
OG0024267	0	3	0	0	0	0	0	3
OG0024268	0	3	0	0	0	0	0	3
OG0024269	0	3	0	0	0	0	0	3
OG0024270	0	3	0	0	0	0	0	3
OG0024271	0	3	0	0	0	0	0	3
OG0024272	0	3	0	0	0	0	0	3
OG0024273	0	2	0	0	0	1	0	3
OG0024274	0	2	0	0	0	0	1	3
OG0024275	0	3	0	0	0	0	0	3
OG0024276	0	3	0	0	0	0	0	3
OG0024277	0	1	0	0	0	1	1	3
OG0024278	0	2	0	0	0	0	1	3
OG0024279	0	2	1	0	0	0	0	3
OG0024280	0	3	0	0	0	0	0	3
OG0024281	0	3	0	0	0	0	0	3
OG0024282	0	1	1	0	0	0	1	3
OG0024283	0	3	0	0	0	0	0	3
OG0024284	0	2	1	0	0	0	0	3
OG0024285	0	3	0	0	0	0	0	3
OG0024286	0	2	0	0	0	1	0	3
OG0024287	0	3	0	0	0	0	0	3
OG0024288	0	2	0	0	1	0	0	3
OG0024289	0	3	0	0	0	0	0	3
OG0024290	0	3	0	0	0	0	0	3
OG0024291	0	3	0	0	0	0	0	3
OG0024292	0	3	0	0	0	0	0	3
OG0024293	0	2	0	0	1	0	0	3
OG0024294	0	3	0	0	0	0	0	3
OG0024295	0	2	0	0	0	1	0	3
OG0024296	0	2	0	0	1	0	0	3
OG0024297	0	3	0	0	0	0	0	3
OG0024298	0	2	0	0	0	0	1	3
OG0024299	0	2	0	0	0	1	0	3
OG0024300	0	1	0	0	1	1	0	3
OG0024301	0	3	0	0	0	0	0	3
OG0024302	0	3	0	0	0	0	0	3
OG0024303	0	2	1	0	0	0	0	3
OG0024304	0	3	0	0	0	0	0	3
OG0024305	0	3	0	0	0	0	0	3
OG0024306	0	2	0	0	1	0	0	3
OG0024307	0	2	0	0	1	0	0	3
OG0024308	0	3	0	0	0	0	0	3
OG0024309	0	3	0	0	0	0	0	3
OG0024310	0	2	0	0	0	0	1	3
OG0024311	0	3	0	0	0	0	0	3
OG0024312	0	3	0	0	0	0	0	3
OG0024313	0	3	0	0	0	0	0	3
OG0024314	0	1	0	1	0	0	1	3
OG0024315	0	2	0	0	1	0	0	3
OG0024316	0	3	0	0	0	0	0	3
OG0024317	0	3	0	0	0	0	0	3
OG0024318	0	1	0	2	0	0	0	3
OG0024319	0	3	0	0	0	0	0	3
OG0024320	0	3	0	0	0	0	0	3
OG0024321	0	1	0	0	0	1	1	3
OG0024322	0	3	0	0	0	0	0	3
OG0024323	0	2	0	1	0	0	0	3
OG0024324	0	2	0	1	0	0	0	3
OG0024325	0	3	0	0	0	0	0	3
OG0024326	0	2	0	1	0	0	0	3
OG0024327	0	3	0	0	0	0	0	3
OG0024328	0	3	0	0	0	0	0	3
OG0024329	0	3	0	0	0	0	0	3
OG0024330	0	3	0	0	0	0	0	3
OG0024331	0	3	0	0	0	0	0	3
OG0024332	0	2	0	0	1	0	0	3
OG0024333	0	1	2	0	0	0	0	3
OG0024334	0	3	0	0	0	0	0	3
OG0024335	0	3	0	0	0	0	0	3
OG0024336	0	1	1	0	0	0	1	3
OG0024337	0	3	0	0	0	0	0	3
OG0024338	0	2	0	1	0	0	0	3
OG0024339	0	3	0	0	0	0	0	3
OG0024340	0	3	0	0	0	0	0	3
OG0024341	0	3	0	0	0	0	0	3
OG0024342	0	3	0	0	0	0	0	3
OG0024343	0	3	0	0	0	0	0	3
OG0024344	0	3	0	0	0	0	0	3
OG0024345	0	2	0	0	0	0	1	3
OG0024346	0	2	1	0	0	0	0	3
OG0024347	0	3	0	0	0	0	0	3
OG0024348	0	2	1	0	0	0	0	3
OG0024349	0	2	0	0	1	0	0	3
OG0024350	0	1	1	0	0	1	0	3
OG0024351	0	2	0	0	1	0	0	3
OG0024352	0	3	0	0	0	0	0	3
OG0024353	0	3	0	0	0	0	0	3
OG0024354	0	3	0	0	0	0	0	3
OG0024355	0	2	0	0	0	1	0	3
OG0024356	0	2	0	0	1	0	0	3
OG0024357	0	2	0	0	1	0	0	3
OG0024358	0	2	0	0	1	0	0	3
OG0024359	0	3	0	0	0	0	0	3
OG0024360	0	3	0	0	0	0	0	3
OG0024361	0	2	1	0	0	0	0	3
OG0024362	0	2	0	0	1	0	0	3
OG0024363	0	2	0	0	1	0	0	3
OG0024364	0	3	0	0	0	0	0	3
OG0024365	0	1	0	0	1	0	1	3
OG0024366	0	3	0	0	0	0	0	3
OG0024367	0	1	1	1	0	0	0	3
OG0024368	0	2	1	0	0	0	0	3
OG0024369	0	3	0	0	0	0	0	3
OG0024370	0	3	0	0	0	0	0	3
OG0024371	0	1	1	0	1	0	0	3
OG0024372	0	3	0	0	0	0	0	3
OG0024373	0	1	1	0	1	0	0	3
OG0024374	0	2	0	0	0	0	1	3
OG0024375	0	3	0	0	0	0	0	3
OG0024376	0	3	0	0	0	0	0	3
OG0024377	0	3	0	0	0	0	0	3
OG0024378	0	3	0	0	0	0	0	3
OG0024379	0	3	0	0	0	0	0	3
OG0024380	0	3	0	0	0	0	0	3
OG0024381	0	2	0	0	0	0	1	3
OG0024382	0	3	0	0	0	0	0	3
OG0024383	0	2	0	0	0	1	0	3
OG0024384	0	3	0	0	0	0	0	3
OG0024385	0	2	0	0	1	0	0	3
OG0024386	0	3	0	0	0	0	0	3
OG0024387	0	3	0	0	0	0	0	3
OG0024388	0	3	0	0	0	0	0	3
OG0024389	0	3	0	0	0	0	0	3
OG0024390	0	3	0	0	0	0	0	3
OG0024391	0	2	0	0	1	0	0	3
OG0024392	0	3	0	0	0	0	0	3
OG0024393	0	1	1	0	0	0	1	3
OG0024394	0	3	0	0	0	0	0	3
OG0024395	0	2	0	0	0	0	1	3
OG0024396	0	2	1	0	0	0	0	3
OG0024397	0	3	0	0	0	0	0	3
OG0024398	0	3	0	0	0	0	0	3
OG0024399	0	3	0	0	0	0	0	3
OG0024400	0	1	0	0	0	1	1	3
OG0024401	0	3	0	0	0	0	0	3
OG0024402	0	3	0	0	0	0	0	3
OG0024403	0	2	0	0	0	0	1	3
OG0024404	0	3	0	0	0	0	0	3
OG0024405	0	1	0	0	0	1	1	3
OG0024406	0	3	0	0	0	0	0	3
OG0024407	0	3	0	0	0	0	0	3
OG0024408	0	2	0	1	0	0	0	3
OG0024409	0	3	0	0	0	0	0	3
OG0024410	0	3	0	0	0	0	0	3
OG0024411	0	2	0	0	0	0	1	3
OG0024412	0	1	0	1	0	1	0	3
OG0024413	0	3	0	0	0	0	0	3
OG0024414	0	1	0	0	1	1	0	3
OG0024415	0	2	0	0	0	1	0	3
OG0024416	0	2	0	0	1	0	0	3
OG0024417	0	1	1	0	0	0	1	3
OG0024418	0	2	0	0	0	0	1	3
OG0024419	0	3	0	0	0	0	0	3
OG0024420	0	1	1	0	0	0	1	3
OG0024421	0	2	0	1	0	0	0	3
OG0024422	0	3	0	0	0	0	0	3
OG0024423	0	3	0	0	0	0	0	3
OG0024424	0	1	1	0	0	0	1	3
OG0024425	0	1	0	1	1	0	0	3
OG0024426	0	1	0	0	0	1	1	3
OG0024427	0	3	0	0	0	0	0	3
OG0024428	0	2	0	0	1	0	0	3
OG0024429	0	1	1	0	0	0	1	3
OG0024430	0	1	1	0	1	0	0	3
OG0024431	0	1	1	0	1	0	0	3
OG0024432	0	3	0	0	0	0	0	3
OG0024433	0	1	0	0	1	0	1	3
OG0024434	0	1	0	0	1	0	1	3
OG0024435	0	1	1	0	0	0	1	3
OG0024436	0	1	0	0	0	0	2	3
OG0024437	0	2	0	0	1	0	0	3
OG0024438	0	1	0	0	1	0	1	3
OG0024439	0	2	0	0	1	0	0	3
OG0024440	0	2	0	0	1	0	0	3
OG0024441	0	3	0	0	0	0	0	3
OG0024442	0	3	0	0	0	0	0	3
OG0024443	0	3	0	0	0	0	0	3
OG0024444	0	3	0	0	0	0	0	3
OG0024445	0	3	0	0	0	0	0	3
OG0024446	0	3	0	0	0	0	0	3
OG0024447	0	3	0	0	0	0	0	3
OG0024448	0	1	0	0	0	1	1	3
OG0024449	0	2	0	0	0	1	0	3
OG0024450	0	3	0	0	0	0	0	3
OG0024451	0	2	1	0	0	0	0	3
OG0024452	0	3	0	0	0	0	0	3
OG0024453	0	3	0	0	0	0	0	3
OG0024454	0	3	0	0	0	0	0	3
OG0024455	0	3	0	0	0	0	0	3
OG0024456	0	2	0	0	1	0	0	3
OG0024457	0	2	0	0	1	0	0	3
OG0024458	0	3	0	0	0	0	0	3
OG0024459	0	2	1	0	0	0	0	3
OG0024460	0	3	0	0	0	0	0	3
OG0024461	0	3	0	0	0	0	0	3
OG0024462	0	2	0	0	0	0	1	3
OG0024463	0	3	0	0	0	0	0	3
OG0024464	0	3	0	0	0	0	0	3
OG0024465	0	2	0	1	0	0	0	3
OG0024466	0	3	0	0	0	0	0	3
OG0024467	0	3	0	0	0	0	0	3
OG0024468	0	3	0	0	0	0	0	3
OG0024469	0	3	0	0	0	0	0	3
OG0024470	0	3	0	0	0	0	0	3
OG0024471	0	2	0	0	1	0	0	3
OG0024472	0	1	1	0	0	0	1	3
OG0024473	0	1	1	0	0	0	1	3
OG0024474	0	2	0	0	1	0	0	3
OG0024475	0	3	0	0	0	0	0	3
OG0024476	0	3	0	0	0	0	0	3
OG0024477	0	2	0	0	1	0	0	3
OG0024478	0	1	1	1	0	0	0	3
OG0024479	0	3	0	0	0	0	0	3
OG0024480	0	1	0	0	1	1	0	3
OG0024481	0	3	0	0	0	0	0	3
OG0024482	0	3	0	0	0	0	0	3
OG0024483	0	3	0	0	0	0	0	3
OG0024484	0	2	0	0	1	0	0	3
OG0024485	0	1	1	0	1	0	0	3
OG0024486	0	3	0	0	0	0	0	3
OG0024487	0	3	0	0	0	0	0	3
OG0024488	0	2	1	0	0	0	0	3
OG0024489	0	2	1	0	0	0	0	3
OG0024490	0	3	0	0	0	0	0	3
OG0024491	0	1	0	0	1	1	0	3
OG0024492	0	2	0	0	1	0	0	3
OG0024493	0	3	0	0	0	0	0	3
OG0024494	0	3	0	0	0	0	0	3
OG0024495	0	2	0	0	1	0	0	3
OG0024496	0	1	0	1	1	0	0	3
OG0024497	0	2	0	0	1	0	0	3
OG0024498	0	3	0	0	0	0	0	3
OG0024499	0	3	0	0	0	0	0	3
OG0024500	0	3	0	0	0	0	0	3
OG0024501	0	2	0	0	0	1	0	3
OG0024502	0	3	0	0	0	0	0	3
OG0024503	0	3	0	0	0	0	0	3
OG0024504	0	3	0	0	0	0	0	3
OG0024505	0	2	1	0	0	0	0	3
OG0024506	0	3	0	0	0	0	0	3
OG0024507	0	3	0	0	0	0	0	3
OG0024508	0	3	0	0	0	0	0	3
OG0024509	0	2	0	1	0	0	0	3
OG0024510	0	2	0	0	1	0	0	3
OG0024511	0	3	0	0	0	0	0	3
OG0024512	0	2	0	0	1	0	0	3
OG0024513	0	3	0	0	0	0	0	3
OG0024514	0	2	0	0	1	0	0	3
OG0024515	0	3	0	0	0	0	0	3
OG0024516	0	1	0	1	1	0	0	3
OG0024517	0	2	0	0	0	0	1	3
OG0024518	0	3	0	0	0	0	0	3
OG0024519	0	3	0	0	0	0	0	3
OG0024520	0	3	0	0	0	0	0	3
OG0024521	0	3	0	0	0	0	0	3
OG0024522	0	1	1	0	1	0	0	3
OG0024523	0	2	0	0	1	0	0	3
OG0024524	0	3	0	0	0	0	0	3
OG0024525	0	3	0	0	0	0	0	3
OG0024526	0	3	0	0	0	0	0	3
OG0024527	0	3	0	0	0	0	0	3
OG0024528	0	2	0	0	0	0	1	3
OG0024529	0	3	0	0	0	0	0	3
OG0024530	0	3	0	0	0	0	0	3
OG0024531	0	3	0	0	0	0	0	3
OG0024532	0	3	0	0	0	0	0	3
OG0024533	0	3	0	0	0	0	0	3
OG0024534	0	3	0	0	0	0	0	3
OG0024535	0	3	0	0	0	0	0	3
OG0024536	0	1	0	0	1	0	1	3
OG0024537	0	2	0	1	0	0	0	3
OG0024538	0	3	0	0	0	0	0	3
OG0024539	0	3	0	0	0	0	0	3
OG0024540	0	3	0	0	0	0	0	3
OG0024541	0	2	0	1	0	0	0	3
OG0024542	0	3	0	0	0	0	0	3
OG0024543	0	3	0	0	0	0	0	3
OG0024544	0	2	0	0	1	0	0	3
OG0024545	0	3	0	0	0	0	0	3
OG0024546	0	2	0	1	0	0	0	3
OG0024547	0	3	0	0	0	0	0	3
OG0024548	0	2	0	1	0	0	0	3
OG0024549	0	3	0	0	0	0	0	3
OG0024550	0	3	0	0	0	0	0	3
OG0024551	0	2	0	1	0	0	0	3
OG0024552	0	1	0	1	0	1	0	3
OG0024553	0	3	0	0	0	0	0	3
OG0024554	0	2	0	0	0	0	1	3
OG0024555	0	3	0	0	0	0	0	3
OG0024556	0	3	0	0	0	0	0	3
OG0024557	0	3	0	0	0	0	0	3
OG0024558	0	2	0	1	0	0	0	3
OG0024559	0	3	0	0	0	0	0	3
OG0024560	0	3	0	0	0	0	0	3
OG0024561	0	3	0	0	0	0	0	3
OG0024562	0	2	0	0	1	0	0	3
OG0024563	0	2	0	0	1	0	0	3
OG0024564	0	3	0	0	0	0	0	3
OG0024565	0	3	0	0	0	0	0	3
OG0024566	0	3	0	0	0	0	0	3
OG0024567	0	3	0	0	0	0	0	3
OG0024568	0	2	0	1	0	0	0	3
OG0024569	0	2	0	0	0	0	1	3
OG0024570	0	3	0	0	0	0	0	3
OG0024571	0	2	0	0	1	0	0	3
OG0024572	0	2	0	0	1	0	0	3
OG0024573	0	3	0	0	0	0	0	3
OG0024574	0	2	0	0	1	0	0	3
OG0024575	0	2	0	0	1	0	0	3
OG0024576	0	2	0	0	1	0	0	3
OG0024577	0	3	0	0	0	0	0	3
OG0024578	0	2	0	0	1	0	0	3
OG0024579	0	3	0	0	0	0	0	3
OG0024580	0	3	0	0	0	0	0	3
OG0024581	0	1	0	0	0	1	1	3
OG0024582	0	3	0	0	0	0	0	3
OG0024583	0	2	0	0	1	0	0	3
OG0024584	0	2	0	0	1	0	0	3
OG0024585	0	3	0	0	0	0	0	3
OG0024586	0	3	0	0	0	0	0	3
OG0024587	0	3	0	0	0	0	0	3
OG0024588	0	3	0	0	0	0	0	3
OG0024589	0	2	0	0	0	0	1	3
OG0024590	0	2	0	0	1	0	0	3
OG0024591	0	3	0	0	0	0	0	3
OG0024592	0	3	0	0	0	0	0	3
OG0024593	0	3	0	0	0	0	0	3
OG0024594	0	2	0	0	0	0	1	3
OG0024595	0	3	0	0	0	0	0	3
OG0024596	0	3	0	0	0	0	0	3
OG0024597	0	3	0	0	0	0	0	3
OG0024598	0	3	0	0	0	0	0	3
OG0024599	0	3	0	0	0	0	0	3
OG0024600	0	3	0	0	0	0	0	3
OG0024601	0	3	0	0	0	0	0	3
OG0024602	0	3	0	0	0	0	0	3
OG0024603	0	3	0	0	0	0	0	3
OG0024604	0	3	0	0	0	0	0	3
OG0024605	0	3	0	0	0	0	0	3
OG0024606	0	3	0	0	0	0	0	3
OG0024607	0	3	0	0	0	0	0	3
OG0024608	0	2	0	1	0	0	0	3
OG0024609	0	2	0	1	0	0	0	3
OG0024610	0	2	0	1	0	0	0	3
OG0024611	0	3	0	0	0	0	0	3
OG0024612	0	3	0	0	0	0	0	3
OG0024613	0	2	0	0	1	0	0	3
OG0024614	0	2	0	0	1	0	0	3
OG0024615	0	2	0	0	1	0	0	3
OG0024616	0	2	1	0	0	0	0	3
OG0024617	0	1	0	0	0	0	2	3
OG0024618	0	3	0	0	0	0	0	3
OG0024619	0	3	0	0	0	0	0	3
OG0024620	0	3	0	0	0	0	0	3
OG0024621	0	2	0	0	1	0	0	3
OG0024622	0	3	0	0	0	0	0	3
OG0024623	0	3	0	0	0	0	0	3
OG0024624	0	2	0	0	1	0	0	3
OG0024625	0	1	0	0	1	1	0	3
OG0024626	0	2	0	0	1	0	0	3
OG0024627	0	3	0	0	0	0	0	3
OG0024628	0	2	1	0	0	0	0	3
OG0024629	0	3	0	0	0	0	0	3
OG0024630	0	3	0	0	0	0	0	3
OG0024631	0	3	0	0	0	0	0	3
OG0024632	0	1	0	0	1	1	0	3
OG0024633	0	2	0	0	1	0	0	3
OG0024634	0	3	0	0	0	0	0	3
OG0024635	0	3	0	0	0	0	0	3
OG0024636	0	3	0	0	0	0	0	3
OG0024637	0	2	1	0	0	0	0	3
OG0024638	0	2	0	0	1	0	0	3
OG0024639	0	2	0	0	1	0	0	3
OG0024640	0	2	0	1	0	0	0	3
OG0024641	0	3	0	0	0	0	0	3
OG0024642	0	3	0	0	0	0	0	3
OG0024643	0	2	0	0	1	0	0	3
OG0024644	0	3	0	0	0	0	0	3
OG0024645	0	3	0	0	0	0	0	3
OG0024646	0	3	0	0	0	0	0	3
OG0024647	0	3	0	0	0	0	0	3
OG0024648	0	3	0	0	0	0	0	3
OG0024649	0	2	0	0	0	1	0	3
OG0024650	0	2	0	0	0	0	1	3
OG0024651	0	2	0	0	1	0	0	3
OG0024652	0	3	0	0	0	0	0	3
OG0024653	0	2	0	0	1	0	0	3
OG0024654	0	3	0	0	0	0	0	3
OG0024655	0	2	1	0	0	0	0	3
OG0024656	0	3	0	0	0	0	0	3
OG0024657	0	3	0	0	0	0	0	3
OG0024658	0	3	0	0	0	0	0	3
OG0024659	0	3	0	0	0	0	0	3
OG0024660	0	3	0	0	0	0	0	3
OG0024661	0	1	0	0	1	0	1	3
OG0024662	0	2	0	0	0	0	1	3
OG0024663	0	3	0	0	0	0	0	3
OG0024664	0	1	0	0	0	1	1	3
OG0024665	0	3	0	0	0	0	0	3
OG0024666	0	3	0	0	0	0	0	3
OG0024667	0	3	0	0	0	0	0	3
OG0024668	0	1	1	0	0	1	0	3
OG0024669	0	3	0	0	0	0	0	3
OG0024670	0	3	0	0	0	0	0	3
OG0024671	0	3	0	0	0	0	0	3
OG0024672	0	3	0	0	0	0	0	3
OG0024673	0	3	0	0	0	0	0	3
OG0024674	0	3	0	0	0	0	0	3
OG0024675	0	3	0	0	0	0	0	3
OG0024676	0	3	0	0	0	0	0	3
OG0024677	0	3	0	0	0	0	0	3
OG0024678	0	3	0	0	0	0	0	3
OG0024679	0	3	0	0	0	0	0	3
OG0024680	0	3	0	0	0	0	0	3
OG0024681	0	3	0	0	0	0	0	3
OG0024682	0	2	0	1	0	0	0	3
OG0024683	0	3	0	0	0	0	0	3
OG0024684	0	3	0	0	0	0	0	3
OG0024685	0	2	0	0	1	0	0	3
OG0024686	0	3	0	0	0	0	0	3
OG0024687	0	2	0	1	0	0	0	3
OG0024688	0	3	0	0	0	0	0	3
OG0024689	0	3	0	0	0	0	0	3
OG0024690	0	3	0	0	0	0	0	3
OG0024691	0	2	0	0	0	0	1	3
OG0024692	0	3	0	0	0	0	0	3
OG0024693	0	2	0	0	1	0	0	3
OG0024694	0	1	0	0	0	1	1	3
OG0024695	0	3	0	0	0	0	0	3
OG0024696	0	2	0	0	1	0	0	3
OG0024697	0	2	0	1	0	0	0	3
OG0024698	0	3	0	0	0	0	0	3
OG0024699	0	2	0	0	0	0	1	3
OG0024700	0	3	0	0	0	0	0	3
OG0024701	0	2	0	1	0	0	0	3
OG0024702	0	3	0	0	0	0	0	3
OG0024703	0	2	0	0	1	0	0	3
OG0024704	0	2	0	0	1	0	0	3
OG0024705	0	2	1	0	0	0	0	3
OG0024706	0	3	0	0	0	0	0	3
OG0024707	0	3	0	0	0	0	0	3
OG0024708	0	2	0	0	0	0	1	3
OG0024709	0	3	0	0	0	0	0	3
OG0024710	0	3	0	0	0	0	0	3
OG0024711	0	3	0	0	0	0	0	3
OG0024712	0	3	0	0	0	0	0	3
OG0024713	0	3	0	0	0	0	0	3
OG0024714	0	3	0	0	0	0	0	3
OG0024715	0	3	0	0	0	0	0	3
OG0024716	0	3	0	0	0	0	0	3
OG0024717	0	3	0	0	0	0	0	3
OG0024718	0	3	0	0	0	0	0	3
OG0024719	0	3	0	0	0	0	0	3
OG0024720	0	3	0	0	0	0	0	3
OG0024721	0	3	0	0	0	0	0	3
OG0024722	0	1	1	0	0	0	1	3
OG0024723	0	2	0	0	1	0	0	3
OG0024724	0	1	1	0	1	0	0	3
OG0024725	0	1	2	0	0	0	0	3
OG0024726	0	1	0	0	2	0	0	3
OG0024727	0	3	0	0	0	0	0	3
OG0024728	0	3	0	0	0	0	0	3
OG0024729	0	3	0	0	0	0	0	3
OG0024730	0	2	0	1	0	0	0	3
OG0024731	0	3	0	0	0	0	0	3
OG0024732	0	3	0	0	0	0	0	3
OG0024733	0	3	0	0	0	0	0	3
OG0024734	0	2	0	1	0	0	0	3
OG0024735	0	2	0	1	0	0	0	3
OG0024736	0	2	0	1	0	0	0	3
OG0024737	0	3	0	0	0	0	0	3
OG0024738	0	3	0	0	0	0	0	3
OG0024739	0	3	0	0	0	0	0	3
OG0024740	0	3	0	0	0	0	0	3
OG0024741	0	3	0	0	0	0	0	3
OG0024742	0	3	0	0	0	0	0	3
OG0024743	0	3	0	0	0	0	0	3
OG0024744	0	3	0	0	0	0	0	3
OG0024745	0	3	0	0	0	0	0	3
OG0024746	0	2	1	0	0	0	0	3
OG0024747	0	1	0	2	0	0	0	3
OG0024748	0	3	0	0	0	0	0	3
OG0024749	0	1	0	1	1	0	0	3
OG0024750	0	3	0	0	0	0	0	3
OG0024751	0	3	0	0	0	0	0	3
OG0024752	0	1	0	0	0	1	1	3
OG0024753	0	2	0	0	1	0	0	3
OG0024754	0	3	0	0	0	0	0	3
OG0024755	0	2	1	0	0	0	0	3
OG0024756	0	2	0	0	0	0	1	3
OG0024757	0	3	0	0	0	0	0	3
OG0024758	0	3	0	0	0	0	0	3
OG0024759	0	1	1	0	0	0	1	3
OG0024760	0	1	0	0	0	0	2	3
OG0024761	0	3	0	0	0	0	0	3
OG0024762	0	3	0	0	0	0	0	3
OG0024763	0	2	0	0	1	0	0	3
OG0024764	0	3	0	0	0	0	0	3
OG0024765	0	3	0	0	0	0	0	3
OG0024766	0	3	0	0	0	0	0	3
OG0024767	0	2	0	1	0	0	0	3
OG0024768	0	3	0	0	0	0	0	3
OG0024769	0	3	0	0	0	0	0	3
OG0024770	0	3	0	0	0	0	0	3
OG0024771	0	3	0	0	0	0	0	3
OG0024772	0	2	0	1	0	0	0	3
OG0024773	0	3	0	0	0	0	0	3
OG0024774	0	3	0	0	0	0	0	3
OG0024775	0	2	0	0	0	1	0	3
OG0024776	0	2	0	0	0	0	1	3
OG0024777	0	3	0	0	0	0	0	3
OG0024778	0	3	0	0	0	0	0	3
OG0024779	0	3	0	0	0	0	0	3
OG0024780	0	3	0	0	0	0	0	3
OG0024781	0	3	0	0	0	0	0	3
OG0024782	0	3	0	0	0	0	0	3
OG0024783	0	1	1	0	0	0	1	3
OG0024784	0	3	0	0	0	0	0	3
OG0024785	0	3	0	0	0	0	0	3
OG0024786	0	2	0	0	1	0	0	3
OG0024787	0	3	0	0	0	0	0	3
OG0024788	0	3	0	0	0	0	0	3
OG0024789	0	3	0	0	0	0	0	3
OG0024790	0	1	0	0	0	1	1	3
OG0024791	0	1	0	0	2	0	0	3
OG0024792	0	2	0	0	1	0	0	3
OG0024793	0	2	0	0	1	0	0	3
OG0024794	0	3	0	0	0	0	0	3
OG0024795	0	3	0	0	0	0	0	3
OG0024796	0	3	0	0	0	0	0	3
OG0024797	0	3	0	0	0	0	0	3
OG0024798	0	1	0	0	2	0	0	3
OG0024799	0	3	0	0	0	0	0	3
OG0024800	0	1	0	0	2	0	0	3
OG0024801	0	3	0	0	0	0	0	3
OG0024802	0	3	0	0	0	0	0	3
OG0024803	0	3	0	0	0	0	0	3
OG0024804	0	3	0	0	0	0	0	3
OG0024805	0	3	0	0	0	0	0	3
OG0024806	0	1	0	0	2	0	0	3
OG0024807	0	3	0	0	0	0	0	3
OG0024808	0	2	0	0	0	1	0	3
OG0024809	0	3	0	0	0	0	0	3
OG0024810	0	3	0	0	0	0	0	3
OG0024811	0	3	0	0	0	0	0	3
OG0024812	0	2	0	0	1	0	0	3
OG0024813	0	1	1	0	0	0	1	3
OG0024814	0	3	0	0	0	0	0	3
OG0024815	0	3	0	0	0	0	0	3
OG0024816	0	3	0	0	0	0	0	3
OG0024817	0	2	0	1	0	0	0	3
OG0024818	0	3	0	0	0	0	0	3
OG0024819	0	2	0	0	1	0	0	3
OG0024820	0	2	0	0	0	0	1	3
OG0024821	0	3	0	0	0	0	0	3
OG0024822	0	3	0	0	0	0	0	3
OG0024823	0	3	0	0	0	0	0	3
OG0024824	0	3	0	0	0	0	0	3
OG0024825	0	2	0	1	0	0	0	3
OG0024826	0	2	0	0	1	0	0	3
OG0024827	0	1	0	0	0	1	1	3
OG0024828	0	1	0	0	0	0	2	3
OG0024829	0	2	0	0	0	1	0	3
OG0024830	0	2	1	0	0	0	0	3
OG0024831	0	2	0	0	0	0	1	3
OG0024832	0	3	0	0	0	0	0	3
OG0024833	0	2	0	1	0	0	0	3
OG0024834	0	3	0	0	0	0	0	3
OG0024835	0	2	0	1	0	0	0	3
OG0024836	0	2	0	1	0	0	0	3
OG0024837	0	3	0	0	0	0	0	3
OG0024838	0	3	0	0	0	0	0	3
OG0024839	0	3	0	0	0	0	0	3
OG0024840	0	3	0	0	0	0	0	3
OG0024841	0	1	1	0	0	0	1	3
OG0024842	0	3	0	0	0	0	0	3
OG0024843	0	3	0	0	0	0	0	3
OG0024844	0	3	0	0	0	0	0	3
OG0024845	0	3	0	0	0	0	0	3
OG0024846	0	2	0	0	0	0	1	3
OG0024847	0	3	0	0	0	0	0	3
OG0024848	0	2	0	0	1	0	0	3
OG0024849	0	3	0	0	0	0	0	3
OG0024850	0	3	0	0	0	0	0	3
OG0024851	0	3	0	0	0	0	0	3
OG0024852	0	3	0	0	0	0	0	3
OG0024853	0	2	0	1	0	0	0	3
OG0024854	0	2	0	0	0	0	1	3
OG0024855	0	2	0	0	0	0	1	3
OG0024856	0	2	0	1	0	0	0	3
OG0024857	0	2	0	1	0	0	0	3
OG0024858	0	3	0	0	0	0	0	3
OG0024859	0	3	0	0	0	0	0	3
OG0024860	0	2	0	1	0	0	0	3
OG0024861	0	3	0	0	0	0	0	3
OG0024862	0	2	0	0	1	0	0	3
OG0024863	0	3	0	0	0	0	0	3
OG0024864	0	3	0	0	0	0	0	3
OG0024865	0	3	0	0	0	0	0	3
OG0024866	0	3	0	0	0	0	0	3
OG0024867	0	3	0	0	0	0	0	3
OG0024868	0	3	0	0	0	0	0	3
OG0024869	0	3	0	0	0	0	0	3
OG0024870	0	2	1	0	0	0	0	3
OG0024871	0	2	1	0	0	0	0	3
OG0024872	0	1	0	0	2	0	0	3
OG0024873	0	2	0	1	0	0	0	3
OG0024874	0	3	0	0	0	0	0	3
OG0024875	0	2	1	0	0	0	0	3
OG0024876	0	2	1	0	0	0	0	3
OG0024877	0	3	0	0	0	0	0	3
OG0024878	0	3	0	0	0	0	0	3
OG0024879	0	2	1	0	0	0	0	3
OG0024880	0	3	0	0	0	0	0	3
OG0024881	0	2	1	0	0	0	0	3
OG0024882	0	3	0	0	0	0	0	3
OG0024883	0	3	0	0	0	0	0	3
OG0024884	0	2	0	0	0	0	1	3
OG0024885	0	2	0	0	1	0	0	3
OG0024886	0	3	0	0	0	0	0	3
OG0024887	0	3	0	0	0	0	0	3
OG0024888	0	1	0	0	1	1	0	3
OG0024889	0	3	0	0	0	0	0	3
OG0024890	0	3	0	0	0	0	0	3
OG0024891	0	2	0	0	0	1	0	3
OG0024892	0	1	0	1	1	0	0	3
OG0024893	0	3	0	0	0	0	0	3
OG0024894	0	3	0	0	0	0	0	3
OG0024895	0	2	1	0	0	0	0	3
OG0024896	0	3	0	0	0	0	0	3
OG0024897	0	1	1	0	0	0	1	3
OG0024898	0	2	0	0	0	0	1	3
OG0024899	0	2	0	0	1	0	0	3
OG0024900	0	3	0	0	0	0	0	3
OG0024901	0	2	0	0	1	0	0	3
OG0024902	0	3	0	0	0	0	0	3
OG0024903	0	3	0	0	0	0	0	3
OG0024904	0	1	0	1	0	1	0	3
OG0024905	0	3	0	0	0	0	0	3
OG0024906	0	3	0	0	0	0	0	3
OG0024907	0	3	0	0	0	0	0	3
OG0024908	0	2	0	0	1	0	0	3
OG0024909	0	3	0	0	0	0	0	3
OG0024910	0	2	0	0	1	0	0	3
OG0024911	0	3	0	0	0	0	0	3
OG0024912	0	3	0	0	0	0	0	3
OG0024913	0	3	0	0	0	0	0	3
OG0024914	0	2	0	1	0	0	0	3
OG0024915	0	2	0	0	1	0	0	3
OG0024916	0	3	0	0	0	0	0	3
OG0024917	0	2	0	0	1	0	0	3
OG0024918	0	3	0	0	0	0	0	3
OG0024919	0	3	0	0	0	0	0	3
OG0024920	0	2	0	0	1	0	0	3
OG0024921	0	3	0	0	0	0	0	3
OG0024922	0	1	1	0	0	0	1	3
OG0024923	0	2	0	1	0	0	0	3
OG0024924	0	1	1	0	0	0	1	3
OG0024925	0	3	0	0	0	0	0	3
OG0024926	0	3	0	0	0	0	0	3
OG0024927	0	3	0	0	0	0	0	3
OG0024928	0	2	0	0	1	0	0	3
OG0024929	0	1	0	0	2	0	0	3
OG0024930	0	2	1	0	0	0	0	3
OG0024931	0	3	0	0	0	0	0	3
OG0024932	0	3	0	0	0	0	0	3
OG0024933	0	3	0	0	0	0	0	3
OG0024934	0	3	0	0	0	0	0	3
OG0024935	0	3	0	0	0	0	0	3
OG0024936	0	3	0	0	0	0	0	3
OG0024937	0	3	0	0	0	0	0	3
OG0024938	0	3	0	0	0	0	0	3
OG0024939	0	2	0	0	0	0	1	3
OG0024940	0	2	1	0	0	0	0	3
OG0024941	0	2	0	1	0	0	0	3
OG0024942	0	3	0	0	0	0	0	3
OG0024943	0	3	0	0	0	0	0	3
OG0024944	0	2	0	0	1	0	0	3
OG0024945	0	2	0	1	0	0	0	3
OG0024946	0	3	0	0	0	0	0	3
OG0024947	0	3	0	0	0	0	0	3
OG0024948	0	2	1	0	0	0	0	3
OG0024949	0	3	0	0	0	0	0	3
OG0024950	0	3	0	0	0	0	0	3
OG0024951	0	3	0	0	0	0	0	3
OG0024952	0	3	0	0	0	0	0	3
OG0024953	0	1	0	1	0	0	1	3
OG0024954	0	3	0	0	0	0	0	3
OG0024955	0	3	0	0	0	0	0	3
OG0024956	0	3	0	0	0	0	0	3
OG0024957	0	2	0	0	0	1	0	3
OG0024958	0	3	0	0	0	0	0	3
OG0024959	0	2	1	0	0	0	0	3
OG0024960	0	3	0	0	0	0	0	3
OG0024961	0	3	0	0	0	0	0	3
OG0024962	0	3	0	0	0	0	0	3
OG0024963	0	3	0	0	0	0	0	3
OG0024964	0	2	0	1	0	0	0	3
OG0024965	0	3	0	0	0	0	0	3
OG0024966	0	3	0	0	0	0	0	3
OG0024967	0	1	0	0	0	1	1	3
OG0024968	0	3	0	0	0	0	0	3
OG0024969	0	1	0	1	0	0	1	3
OG0024970	0	3	0	0	0	0	0	3
OG0024971	0	2	0	0	0	0	1	3
OG0024972	0	2	0	0	0	0	1	3
OG0024973	0	3	0	0	0	0	0	3
OG0024974	0	2	0	0	0	0	1	3
OG0024975	0	3	0	0	0	0	0	3
OG0024976	0	2	0	1	0	0	0	3
OG0024977	0	2	0	1	0	0	0	3
OG0024978	0	3	0	0	0	0	0	3
OG0024979	0	3	0	0	0	0	0	3
OG0024980	0	2	0	0	0	0	1	3
OG0024981	0	3	0	0	0	0	0	3
OG0024982	0	3	0	0	0	0	0	3
OG0024983	0	3	0	0	0	0	0	3
OG0024984	0	2	0	0	1	0	0	3
OG0024985	0	1	0	1	1	0	0	3
OG0024986	0	2	1	0	0	0	0	3
OG0024987	0	2	0	1	0	0	0	3
OG0024988	0	3	0	0	0	0	0	3
OG0024989	0	2	0	0	0	0	1	3
OG0024990	0	1	0	1	0	1	0	3
OG0024991	0	2	0	1	0	0	0	3
OG0024992	0	2	1	0	0	0	0	3
OG0024993	0	1	0	1	0	1	0	3
OG0024994	0	2	1	0	0	0	0	3
OG0024995	0	3	0	0	0	0	0	3
OG0024996	0	1	0	0	0	0	2	3
OG0024997	0	3	0	0	0	0	0	3
OG0024998	0	3	0	0	0	0	0	3
OG0024999	0	3	0	0	0	0	0	3
OG0025000	0	2	1	0	0	0	0	3
OG0025001	0	3	0	0	0	0	0	3
OG0025002	0	3	0	0	0	0	0	3
OG0025003	0	3	0	0	0	0	0	3
OG0025004	0	3	0	0	0	0	0	3
OG0025005	0	1	0	0	0	0	2	3
OG0025006	0	3	0	0	0	0	0	3
OG0025007	0	1	0	0	0	1	1	3
OG0025008	0	3	0	0	0	0	0	3
OG0025009	0	3	0	0	0	0	0	3
OG0025010	0	2	0	1	0	0	0	3
OG0025011	0	3	0	0	0	0	0	3
OG0025012	0	3	0	0	0	0	0	3
OG0025013	0	2	0	1	0	0	0	3
OG0025014	0	2	0	1	0	0	0	3
OG0025015	0	3	0	0	0	0	0	3
OG0025016	0	3	0	0	0	0	0	3
OG0025017	0	3	0	0	0	0	0	3
OG0025018	0	1	0	0	0	1	1	3
OG0025019	0	1	0	0	0	1	1	3
OG0025020	0	3	0	0	0	0	0	3
OG0025021	0	2	0	0	1	0	0	3
OG0025022	0	1	0	0	0	1	1	3
OG0025023	0	3	0	0	0	0	0	3
OG0025024	0	3	0	0	0	0	0	3
OG0025025	0	3	0	0	0	0	0	3
OG0025026	0	2	0	0	0	0	1	3
OG0025027	0	3	0	0	0	0	0	3
OG0025028	0	3	0	0	0	0	0	3
OG0025029	0	1	1	0	0	0	1	3
OG0025030	0	3	0	0	0	0	0	3
OG0025031	0	3	0	0	0	0	0	3
OG0025032	0	3	0	0	0	0	0	3
OG0025033	0	3	0	0	0	0	0	3
OG0025034	0	3	0	0	0	0	0	3
OG0025035	0	2	0	0	0	0	1	3
OG0025036	0	1	0	0	0	1	1	3
OG0025037	0	3	0	0	0	0	0	3
OG0025038	0	3	0	0	0	0	0	3
OG0025039	0	2	0	0	1	0	0	3
OG0025040	0	3	0	0	0	0	0	3
OG0025041	0	3	0	0	0	0	0	3
OG0025042	0	2	0	1	0	0	0	3
OG0025043	0	2	0	0	0	0	1	3
OG0025044	0	2	0	0	0	0	1	3
OG0025045	0	3	0	0	0	0	0	3
OG0025046	0	2	0	0	0	0	1	3
OG0025047	0	3	0	0	0	0	0	3
OG0025048	0	2	0	0	0	0	1	3
OG0025049	0	2	0	0	1	0	0	3
OG0025050	0	3	0	0	0	0	0	3
OG0025051	0	3	0	0	0	0	0	3
OG0025052	0	3	0	0	0	0	0	3
OG0025053	0	3	0	0	0	0	0	3
OG0025054	0	2	0	0	0	0	1	3
OG0025055	0	3	0	0	0	0	0	3
OG0025056	0	2	0	1	0	0	0	3
OG0025057	0	3	0	0	0	0	0	3
OG0025058	0	3	0	0	0	0	0	3
OG0025059	0	2	1	0	0	0	0	3
OG0025060	0	3	0	0	0	0	0	3
OG0025061	0	3	0	0	0	0	0	3
OG0025062	0	3	0	0	0	0	0	3
OG0025063	0	3	0	0	0	0	0	3
OG0025064	0	3	0	0	0	0	0	3
OG0025065	0	3	0	0	0	0	0	3
OG0025066	0	1	0	0	0	1	1	3
OG0025067	0	3	0	0	0	0	0	3
OG0025068	0	2	0	0	1	0	0	3
OG0025069	0	1	0	0	0	0	2	3
OG0025070	0	2	1	0	0	0	0	3
OG0025071	0	3	0	0	0	0	0	3
OG0025072	0	3	0	0	0	0	0	3
OG0025073	0	3	0	0	0	0	0	3
OG0025074	0	3	0	0	0	0	0	3
OG0025075	0	2	1	0	0	0	0	3
OG0025076	0	3	0	0	0	0	0	3
OG0025077	0	2	0	0	1	0	0	3
OG0025078	0	2	0	0	0	0	1	3
OG0025079	0	3	0	0	0	0	0	3
OG0025080	0	3	0	0	0	0	0	3
OG0025081	0	3	0	0	0	0	0	3
OG0025082	0	2	0	1	0	0	0	3
OG0025083	0	1	0	1	0	0	1	3
OG0025084	0	2	0	0	0	0	1	3
OG0025085	0	2	0	1	0	0	0	3
OG0025086	0	3	0	0	0	0	0	3
OG0025087	0	3	0	0	0	0	0	3
OG0025088	0	3	0	0	0	0	0	3
OG0025089	0	2	0	1	0	0	0	3
OG0025090	0	2	0	1	0	0	0	3
OG0025091	0	2	0	1	0	0	0	3
OG0025092	0	2	0	1	0	0	0	3
OG0025093	0	2	0	1	0	0	0	3
OG0025094	0	3	0	0	0	0	0	3
OG0025095	0	3	0	0	0	0	0	3
OG0025096	0	3	0	0	0	0	0	3
OG0025097	0	2	0	1	0	0	0	3
OG0025098	0	3	0	0	0	0	0	3
OG0025099	0	2	0	0	1	0	0	3
OG0025100	0	2	0	0	1	0	0	3
OG0025101	0	3	0	0	0	0	0	3
OG0025102	0	1	0	1	0	0	1	3
OG0025103	0	2	0	0	1	0	0	3
OG0025104	0	3	0	0	0	0	0	3
OG0025105	0	2	0	0	0	0	1	3
OG0025106	0	2	0	0	1	0	0	3
OG0025107	0	1	0	0	1	0	1	3
OG0025108	0	3	0	0	0	0	0	3
OG0025109	0	2	0	0	1	0	0	3
OG0025110	0	2	0	0	0	0	1	3
OG0025111	0	3	0	0	0	0	0	3
OG0025112	0	3	0	0	0	0	0	3
OG0025113	0	1	0	0	1	0	1	3
OG0025114	0	3	0	0	0	0	0	3
OG0025115	0	3	0	0	0	0	0	3
OG0025116	0	1	0	0	0	1	1	3
OG0025117	0	3	0	0	0	0	0	3
OG0025118	0	3	0	0	0	0	0	3
OG0025119	0	1	1	0	1	0	0	3
OG0025120	0	1	1	0	0	0	1	3
OG0025121	0	1	0	0	2	0	0	3
OG0025122	0	2	0	0	1	0	0	3
OG0025123	0	3	0	0	0	0	0	3
OG0025124	0	1	0	0	2	0	0	3
OG0025125	0	1	1	0	1	0	0	3
OG0025126	0	1	0	0	0	0	2	3
OG0025127	0	3	0	0	0	0	0	3
OG0025128	0	3	0	0	0	0	0	3
OG0025129	0	1	1	0	0	0	1	3
OG0025130	0	3	0	0	0	0	0	3
OG0025131	0	3	0	0	0	0	0	3
OG0025132	0	3	0	0	0	0	0	3
OG0025133	0	2	1	0	0	0	0	3
OG0025134	0	2	0	0	0	0	1	3
OG0025135	0	2	0	0	0	0	1	3
OG0025136	0	1	0	0	0	0	2	3
OG0025137	0	2	0	0	0	0	1	3
OG0025138	0	1	0	0	0	0	2	3
OG0025139	0	3	0	0	0	0	0	3
OG0025140	0	3	0	0	0	0	0	3
OG0025141	0	2	0	1	0	0	0	3
OG0025142	0	2	1	0	0	0	0	3
OG0025143	0	3	0	0	0	0	0	3
OG0025144	0	2	0	0	1	0	0	3
OG0025145	0	2	0	0	0	0	1	3
OG0025146	0	3	0	0	0	0	0	3
OG0025147	0	3	0	0	0	0	0	3
OG0025148	0	3	0	0	0	0	0	3
OG0025149	0	3	0	0	0	0	0	3
OG0025150	0	2	0	0	1	0	0	3
OG0025151	0	3	0	0	0	0	0	3
OG0025152	0	3	0	0	0	0	0	3
OG0025153	0	3	0	0	0	0	0	3
OG0025154	0	3	0	0	0	0	0	3
OG0025155	0	1	0	0	0	1	1	3
OG0025156	0	2	0	0	1	0	0	3
OG0025157	0	3	0	0	0	0	0	3
OG0025158	0	3	0	0	0	0	0	3
OG0025159	0	3	0	0	0	0	0	3
OG0025160	0	2	0	0	0	0	1	3
OG0025161	0	2	1	0	0	0	0	3
OG0025162	0	3	0	0	0	0	0	3
OG0025163	0	3	0	0	0	0	0	3
OG0025164	0	3	0	0	0	0	0	3
OG0025165	0	3	0	0	0	0	0	3
OG0025166	0	2	0	0	0	1	0	3
OG0025167	0	2	0	0	0	0	1	3
OG0025168	0	2	0	0	0	0	1	3
OG0025169	0	3	0	0	0	0	0	3
OG0025170	0	3	0	0	0	0	0	3
OG0025171	0	3	0	0	0	0	0	3
OG0025172	0	3	0	0	0	0	0	3
OG0025173	0	2	0	0	1	0	0	3
OG0025174	0	2	0	0	1	0	0	3
OG0025175	0	1	1	0	0	0	1	3
OG0025176	0	3	0	0	0	0	0	3
OG0025177	0	3	0	0	0	0	0	3
OG0025178	0	1	0	0	0	1	1	3
OG0025179	0	3	0	0	0	0	0	3
OG0025180	0	2	0	0	0	0	1	3
OG0025181	0	3	0	0	0	0	0	3
OG0025182	0	3	0	0	0	0	0	3
OG0025183	0	3	0	0	0	0	0	3
OG0025184	0	1	1	0	1	0	0	3
OG0025185	0	3	0	0	0	0	0	3
OG0025186	0	3	0	0	0	0	0	3
OG0025187	0	3	0	0	0	0	0	3
OG0025188	0	3	0	0	0	0	0	3
OG0025189	0	1	0	0	0	0	2	3
OG0025190	0	1	2	0	0	0	0	3
OG0025191	0	3	0	0	0	0	0	3
OG0025192	0	3	0	0	0	0	0	3
OG0025193	0	1	0	0	0	1	1	3
OG0025194	0	2	0	0	1	0	0	3
OG0025195	0	3	0	0	0	0	0	3
OG0025196	0	3	0	0	0	0	0	3
OG0025197	0	3	0	0	0	0	0	3
OG0025198	0	2	0	0	1	0	0	3
OG0025199	0	2	0	0	1	0	0	3
OG0025200	0	3	0	0	0	0	0	3
OG0025201	0	2	0	0	0	0	1	3
OG0025202	0	2	0	0	0	0	1	3
OG0025203	0	2	0	0	0	0	1	3
OG0025204	0	1	0	0	1	1	0	3
OG0025205	0	1	1	1	0	0	0	3
OG0025206	0	2	0	0	0	1	0	3
OG0025207	0	3	0	0	0	0	0	3
OG0025208	0	2	0	1	0	0	0	3
OG0025209	0	2	0	1	0	0	0	3
OG0025210	0	1	0	1	1	0	0	3
OG0025211	0	3	0	0	0	0	0	3
OG0025212	0	1	1	0	0	1	0	3
OG0025213	0	2	0	1	0	0	0	3
OG0025214	0	2	0	1	0	0	0	3
OG0025215	0	1	0	0	0	1	1	3
OG0025216	0	1	1	0	0	1	0	3
OG0025217	0	2	1	0	0	0	0	3
OG0025218	0	3	0	0	0	0	0	3
OG0025219	0	2	0	0	0	0	1	3
OG0025220	0	2	0	0	0	0	1	3
OG0025221	0	2	0	0	0	0	1	3
OG0025222	0	1	1	0	0	0	1	3
OG0025223	0	3	0	0	0	0	0	3
OG0025224	0	3	0	0	0	0	0	3
OG0025225	0	3	0	0	0	0	0	3
OG0025226	0	2	0	0	0	1	0	3
OG0025227	0	1	1	1	0	0	0	3
OG0025228	0	2	0	0	1	0	0	3
OG0025229	0	3	0	0	0	0	0	3
OG0025230	0	2	0	1	0	0	0	3
OG0025231	0	1	0	0	0	0	2	3
OG0025232	0	3	0	0	0	0	0	3
OG0025233	0	3	0	0	0	0	0	3
OG0025234	0	3	0	0	0	0	0	3
OG0025235	0	3	0	0	0	0	0	3
OG0025236	0	2	0	1	0	0	0	3
OG0025237	0	2	0	1	0	0	0	3
OG0025238	0	3	0	0	0	0	0	3
OG0025239	0	3	0	0	0	0	0	3
OG0025240	0	2	0	1	0	0	0	3
OG0025241	0	3	0	0	0	0	0	3
OG0025242	0	2	0	1	0	0	0	3
OG0025243	0	2	0	0	0	0	1	3
OG0025244	0	1	0	0	0	1	1	3
OG0025245	0	3	0	0	0	0	0	3
OG0025246	0	1	0	1	0	1	0	3
OG0025247	0	2	1	0	0	0	0	3
OG0025248	0	1	0	0	0	1	1	3
OG0025249	0	1	0	1	0	1	0	3
OG0025250	0	2	0	1	0	0	0	3
OG0025251	0	3	0	0	0	0	0	3
OG0025252	0	3	0	0	0	0	0	3
OG0025253	0	2	0	0	0	1	0	3
OG0025254	0	2	0	1	0	0	0	3
OG0025255	0	1	0	1	0	0	1	3
OG0025256	0	1	0	1	0	0	1	3
OG0025257	0	2	0	1	0	0	0	3
OG0025258	0	3	0	0	0	0	0	3
OG0025259	0	1	0	1	0	1	0	3
OG0025260	0	1	1	1	0	0	0	3
OG0025261	0	2	0	1	0	0	0	3
OG0025262	0	3	0	0	0	0	0	3
OG0025263	0	3	0	0	0	0	0	3
OG0025264	0	3	0	0	0	0	0	3
OG0025265	0	3	0	0	0	0	0	3
OG0025266	0	3	0	0	0	0	0	3
OG0025267	0	3	0	0	0	0	0	3
OG0025268	0	2	0	1	0	0	0	3
OG0025269	0	2	0	1	0	0	0	3
OG0025270	0	2	0	1	0	0	0	3
OG0025271	0	2	0	1	0	0	0	3
OG0025272	0	1	0	0	0	1	1	3
OG0025273	0	3	0	0	0	0	0	3
OG0025274	0	2	0	1	0	0	0	3
OG0025275	0	2	0	1	0	0	0	3
OG0025276	0	2	0	0	1	0	0	3
OG0025277	0	2	0	1	0	0	0	3
OG0025278	0	3	0	0	0	0	0	3
OG0025279	0	1	0	1	0	1	0	3
OG0025280	0	3	0	0	0	0	0	3
OG0025281	0	3	0	0	0	0	0	3
OG0025282	0	3	0	0	0	0	0	3
OG0025283	0	1	0	0	0	0	2	3
OG0025284	0	3	0	0	0	0	0	3
OG0025285	0	3	0	0	0	0	0	3
OG0025286	0	3	0	0	0	0	0	3
OG0025287	0	2	0	1	0	0	0	3
OG0025288	0	2	0	0	0	0	1	3
OG0025289	0	3	0	0	0	0	0	3
OG0025290	0	2	0	0	0	1	0	3
OG0025291	0	2	0	1	0	0	0	3
OG0025292	0	1	0	0	0	1	1	3
OG0025293	0	3	0	0	0	0	0	3
OG0025294	0	2	0	0	0	1	0	3
OG0025295	0	3	0	0	0	0	0	3
OG0025296	0	2	0	0	0	1	0	3
OG0025297	0	1	0	2	0	0	0	3
OG0025298	0	3	0	0	0	0	0	3
OG0025299	0	3	0	0	0	0	0	3
OG0025300	0	3	0	0	0	0	0	3
OG0025301	0	3	0	0	0	0	0	3
OG0025302	0	3	0	0	0	0	0	3
OG0025303	0	3	0	0	0	0	0	3
OG0025304	0	2	0	1	0	0	0	3
OG0025305	0	3	0	0	0	0	0	3
OG0025306	0	3	0	0	0	0	0	3
OG0025307	0	2	0	0	0	0	1	3
OG0025308	0	3	0	0	0	0	0	3
OG0025309	0	2	1	0	0	0	0	3
OG0025310	0	3	0	0	0	0	0	3
OG0025311	0	3	0	0	0	0	0	3
OG0025312	0	3	0	0	0	0	0	3
OG0025313	0	2	0	1	0	0	0	3
OG0025314	0	3	0	0	0	0	0	3
OG0025315	0	2	1	0	0	0	0	3
OG0025316	0	3	0	0	0	0	0	3
OG0025317	0	2	0	0	0	0	1	3
OG0025318	0	3	0	0	0	0	0	3
OG0025319	0	3	0	0	0	0	0	3
OG0025320	0	3	0	0	0	0	0	3
OG0025321	0	3	0	0	0	0	0	3
OG0025322	0	2	1	0	0	0	0	3
OG0025323	0	2	0	1	0	0	0	3
OG0025324	0	2	0	1	0	0	0	3
OG0025325	0	3	0	0	0	0	0	3
OG0025326	0	3	0	0	0	0	0	3
OG0025327	0	3	0	0	0	0	0	3
OG0025328	0	3	0	0	0	0	0	3
OG0025329	0	2	0	0	0	0	1	3
OG0025330	0	2	0	0	0	1	0	3
OG0025331	0	3	0	0	0	0	0	3
OG0025332	0	2	0	0	1	0	0	3
OG0025333	0	2	1	0	0	0	0	3
OG0025334	0	1	0	0	0	2	0	3
OG0025335	0	1	0	0	0	0	2	3
OG0025336	0	2	1	0	0	0	0	3
OG0025337	0	2	0	0	1	0	0	3
OG0025338	0	1	0	0	1	1	0	3
OG0025339	0	1	0	0	1	1	0	3
OG0025340	0	1	0	0	0	1	1	3
OG0025341	0	1	0	0	1	0	1	3
OG0025342	0	3	0	0	0	0	0	3
OG0025343	0	3	0	0	0	0	0	3
OG0025344	0	2	0	0	1	0	0	3
OG0025345	0	2	0	1	0	0	0	3
OG0025346	0	3	0	0	0	0	0	3
OG0025347	0	3	0	0	0	0	0	3
OG0025348	0	2	0	0	1	0	0	3
OG0025349	0	2	0	0	0	0	1	3
OG0025350	0	3	0	0	0	0	0	3
OG0025351	0	1	0	0	0	0	2	3
OG0025352	0	3	0	0	0	0	0	3
OG0025353	0	3	0	0	0	0	0	3
OG0025354	0	3	0	0	0	0	0	3
OG0025355	0	2	0	1	0	0	0	3
OG0025356	0	3	0	0	0	0	0	3
OG0025357	0	2	0	1	0	0	0	3
OG0025358	0	3	0	0	0	0	0	3
OG0025359	0	3	0	0	0	0	0	3
OG0025360	0	3	0	0	0	0	0	3
OG0025361	0	1	0	0	0	0	2	3
OG0025362	0	3	0	0	0	0	0	3
OG0025363	0	3	0	0	0	0	0	3
OG0025364	0	3	0	0	0	0	0	3
OG0025365	0	3	0	0	0	0	0	3
OG0025366	0	3	0	0	0	0	0	3
OG0025367	0	3	0	0	0	0	0	3
OG0025368	0	2	0	1	0	0	0	3
OG0025369	0	2	0	0	0	1	0	3
OG0025370	0	1	1	0	1	0	0	3
OG0025371	0	2	0	1	0	0	0	3
OG0025372	0	1	0	0	0	0	2	3
OG0025373	0	3	0	0	0	0	0	3
OG0025374	0	3	0	0	0	0	0	3
OG0025375	0	3	0	0	0	0	0	3
OG0025376	0	2	1	0	0	0	0	3
OG0025377	0	2	0	0	0	0	1	3
OG0025378	0	3	0	0	0	0	0	3
OG0025379	0	1	0	1	0	0	1	3
OG0025380	0	2	0	0	0	0	1	3
OG0025381	0	3	0	0	0	0	0	3
OG0025382	0	3	0	0	0	0	0	3
OG0025383	0	1	0	0	0	0	2	3
OG0025384	0	1	0	0	0	0	2	3
OG0025385	0	3	0	0	0	0	0	3
OG0025386	0	1	0	0	0	1	1	3
OG0025387	0	2	0	0	1	0	0	3
OG0025388	0	2	0	0	0	0	1	3
OG0025389	0	1	0	0	0	1	1	3
OG0025390	0	3	0	0	0	0	0	3
OG0025391	0	1	0	0	0	1	1	3
OG0025392	0	1	0	0	0	2	0	3
OG0025393	0	2	0	0	0	1	0	3
OG0025394	0	3	0	0	0	0	0	3
OG0025395	0	3	0	0	0	0	0	3
OG0025396	0	3	0	0	0	0	0	3
OG0025397	0	2	0	0	0	0	1	3
OG0025398	0	2	0	0	1	0	0	3
OG0025399	0	2	0	0	1	0	0	3
OG0025400	0	3	0	0	0	0	0	3
OG0025401	0	3	0	0	0	0	0	3
OG0025402	0	3	0	0	0	0	0	3
OG0025403	0	1	1	0	0	0	1	3
OG0025404	0	3	0	0	0	0	0	3
OG0025405	0	2	0	1	0	0	0	3
OG0025406	0	3	0	0	0	0	0	3
OG0025407	0	3	0	0	0	0	0	3
OG0025408	0	3	0	0	0	0	0	3
OG0025409	0	1	1	1	0	0	0	3
OG0025410	0	1	1	1	0	0	0	3
OG0025411	0	1	1	1	0	0	0	3
OG0025412	0	3	0	0	0	0	0	3
OG0025413	0	1	1	1	0	0	0	3
OG0025414	0	1	0	2	0	0	0	3
OG0025415	0	3	0	0	0	0	0	3
OG0025416	0	3	0	0	0	0	0	3
OG0025417	0	1	1	1	0	0	0	3
OG0025418	0	3	0	0	0	0	0	3
OG0025419	0	3	0	0	0	0	0	3
OG0025420	0	3	0	0	0	0	0	3
OG0025421	0	3	0	0	0	0	0	3
OG0025422	0	3	0	0	0	0	0	3
OG0025423	0	2	0	1	0	0	0	3
OG0025424	0	2	0	1	0	0	0	3
OG0025425	0	2	0	1	0	0	0	3
OG0025426	0	2	0	1	0	0	0	3
OG0025427	0	2	0	1	0	0	0	3
OG0025428	0	2	0	1	0	0	0	3
OG0025429	0	1	0	0	0	1	1	3
OG0025430	0	3	0	0	0	0	0	3
OG0025431	0	1	0	2	0	0	0	3
OG0025432	0	3	0	0	0	0	0	3
OG0025433	0	1	0	0	0	0	2	3
OG0025434	0	3	0	0	0	0	0	3
OG0025435	0	2	0	0	0	0	1	3
OG0025436	0	1	0	0	0	1	1	3
OG0025437	0	1	0	0	0	0	2	3
OG0025438	0	1	0	0	0	0	2	3
OG0025439	0	1	0	0	0	0	2	3
OG0025440	0	2	1	0	0	0	0	3
OG0025441	0	2	0	0	1	0	0	3
OG0025442	0	2	0	0	0	0	1	3
OG0025443	0	2	0	1	0	0	0	3
OG0025444	0	3	0	0	0	0	0	3
OG0025445	0	3	0	0	0	0	0	3
OG0025446	0	3	0	0	0	0	0	3
OG0025447	0	3	0	0	0	0	0	3
OG0025448	0	2	0	0	1	0	0	3
OG0025449	0	3	0	0	0	0	0	3
OG0025450	0	1	1	0	1	0	0	3
OG0025451	0	2	0	0	1	0	0	3
OG0025452	0	3	0	0	0	0	0	3
OG0025453	0	2	0	0	1	0	0	3
OG0025454	0	2	0	0	0	1	0	3
OG0025455	0	2	0	0	1	0	0	3
OG0025456	0	3	0	0	0	0	0	3
OG0025457	0	1	0	0	1	0	1	3
OG0025458	0	3	0	0	0	0	0	3
OG0025459	0	2	0	0	0	0	1	3
OG0025460	0	1	2	0	0	0	0	3
OG0025461	0	3	0	0	0	0	0	3
OG0025462	0	1	0	0	0	0	2	3
OG0025463	0	3	0	0	0	0	0	3
OG0025464	0	2	0	0	0	0	1	3
OG0025465	0	3	0	0	0	0	0	3
OG0025466	0	3	0	0	0	0	0	3
OG0025467	0	3	0	0	0	0	0	3
OG0025468	0	2	0	0	0	0	1	3
OG0025469	0	3	0	0	0	0	0	3
OG0025470	0	1	0	1	0	1	0	3
OG0025471	0	3	0	0	0	0	0	3
OG0025472	0	2	0	1	0	0	0	3
OG0025473	0	1	1	1	0	0	0	3
OG0025474	0	1	0	0	0	0	2	3
OG0025475	0	1	0	0	0	0	2	3
OG0025476	0	2	0	0	1	0	0	3
OG0025477	0	1	1	1	0	0	0	3
OG0025478	0	2	0	0	0	0	1	3
OG0025479	0	3	0	0	0	0	0	3
OG0025480	0	2	0	1	0	0	0	3
OG0025481	0	2	0	0	0	0	1	3
OG0025482	0	1	0	0	0	0	2	3
OG0025483	0	2	0	0	0	0	1	3
OG0025484	0	2	0	0	0	0	1	3
OG0025485	0	3	0	0	0	0	0	3
OG0025486	0	2	0	0	1	0	0	3
OG0025487	0	2	0	0	0	0	1	3
OG0025488	0	3	0	0	0	0	0	3
OG0025489	0	3	0	0	0	0	0	3
OG0025490	0	3	0	0	0	0	0	3
OG0025491	0	3	0	0	0	0	0	3
OG0025492	0	2	0	0	0	0	1	3
OG0025493	0	2	0	0	0	0	1	3
OG0025494	0	3	0	0	0	0	0	3
OG0025495	0	2	0	0	0	0	1	3
OG0025496	0	3	0	0	0	0	0	3
OG0025497	0	2	0	1	0	0	0	3
OG0025498	0	1	2	0	0	0	0	3
OG0025499	0	1	2	0	0	0	0	3
OG0025500	0	3	0	0	0	0	0	3
OG0025501	0	3	0	0	0	0	0	3
OG0025502	0	3	0	0	0	0	0	3
OG0025503	0	2	0	0	1	0	0	3
OG0025504	0	2	0	0	1	0	0	3
OG0025505	0	1	0	0	1	1	0	3
OG0025506	0	3	0	0	0	0	0	3
OG0025507	0	2	0	0	1	0	0	3
OG0025508	0	1	0	1	0	0	1	3
OG0025509	0	1	0	0	1	1	0	3
OG0025510	0	1	0	0	0	1	1	3
OG0025511	0	3	0	0	0	0	0	3
OG0025512	0	2	0	0	1	0	0	3
OG0025513	0	3	0	0	0	0	0	3
OG0025514	0	3	0	0	0	0	0	3
OG0025515	0	2	0	0	0	0	1	3
OG0025516	0	1	0	0	0	0	2	3
OG0025517	0	3	0	0	0	0	0	3
OG0025518	0	2	0	0	0	0	1	3
OG0025519	0	2	0	0	0	0	1	3
OG0025520	0	2	0	0	1	0	0	3
OG0025521	0	2	0	0	0	1	0	3
OG0025522	0	3	0	0	0	0	0	3
OG0025523	0	2	0	0	0	0	1	3
OG0025524	0	3	0	0	0	0	0	3
OG0025525	0	2	0	0	1	0	0	3
OG0025526	0	3	0	0	0	0	0	3
OG0025527	0	3	0	0	0	0	0	3
OG0025528	0	3	0	0	0	0	0	3
OG0025529	0	3	0	0	0	0	0	3
OG0025530	0	1	0	0	1	0	1	3
OG0025531	0	1	1	0	1	0	0	3
OG0025532	0	1	2	0	0	0	0	3
OG0025533	0	3	0	0	0	0	0	3
OG0025534	0	2	0	0	0	0	1	3
OG0025535	0	3	0	0	0	0	0	3
OG0025536	0	2	1	0	0	0	0	3
OG0025537	0	2	0	0	1	0	0	3
OG0025538	0	3	0	0	0	0	0	3
OG0025539	0	3	0	0	0	0	0	3
OG0025540	0	3	0	0	0	0	0	3
OG0025541	0	3	0	0	0	0	0	3
OG0025542	0	3	0	0	0	0	0	3
OG0025543	0	2	0	0	1	0	0	3
OG0025544	0	2	1	0	0	0	0	3
OG0025545	0	2	0	0	1	0	0	3
OG0025546	0	2	0	0	1	0	0	3
OG0025547	0	2	1	0	0	0	0	3
OG0025548	0	3	0	0	0	0	0	3
OG0025549	0	3	0	0	0	0	0	3
OG0025550	0	2	1	0	0	0	0	3
OG0025551	0	2	0	0	0	0	1	3
OG0025552	0	2	0	0	0	0	1	3
OG0025553	0	2	0	1	0	0	0	3
OG0025554	0	2	0	1	0	0	0	3
OG0025555	0	3	0	0	0	0	0	3
OG0025556	0	3	0	0	0	0	0	3
OG0025557	0	3	0	0	0	0	0	3
OG0025558	0	2	0	1	0	0	0	3
OG0025559	0	2	0	1	0	0	0	3
OG0025560	0	3	0	0	0	0	0	3
OG0025561	0	3	0	0	0	0	0	3
OG0025562	0	3	0	0	0	0	0	3
OG0025563	0	2	1	0	0	0	0	3
OG0025564	0	3	0	0	0	0	0	3
OG0025565	0	3	0	0	0	0	0	3
OG0025566	0	3	0	0	0	0	0	3
OG0025567	0	2	0	0	0	1	0	3
OG0025568	0	2	0	0	0	1	0	3
OG0025569	0	3	0	0	0	0	0	3
OG0025570	0	2	0	0	1	0	0	3
OG0025571	0	2	0	0	1	0	0	3
OG0025572	0	2	0	0	0	1	0	3
OG0025573	0	3	0	0	0	0	0	3
OG0025574	0	3	0	0	0	0	0	3
OG0025575	0	1	0	1	0	1	0	3
OG0025576	0	1	0	0	2	0	0	3
OG0025577	0	2	0	1	0	0	0	3
OG0025578	0	3	0	0	0	0	0	3
OG0025579	0	1	0	0	2	0	0	3
OG0025580	0	3	0	0	0	0	0	3
OG0025581	0	1	0	0	0	0	2	3
OG0025582	0	3	0	0	0	0	0	3
OG0025583	0	3	0	0	0	0	0	3
OG0025584	0	3	0	0	0	0	0	3
OG0025585	0	2	0	0	0	0	1	3
OG0025586	0	3	0	0	0	0	0	3
OG0025587	0	3	0	0	0	0	0	3
OG0025588	0	3	0	0	0	0	0	3
OG0025589	0	3	0	0	0	0	0	3
OG0025590	0	2	0	0	0	0	1	3
OG0025591	0	2	0	0	0	0	1	3
OG0025592	0	2	1	0	0	0	0	3
OG0025593	0	3	0	0	0	0	0	3
OG0025594	0	3	0	0	0	0	0	3
OG0025595	0	2	0	1	0	0	0	3
OG0025596	0	3	0	0	0	0	0	3
OG0025597	0	2	0	1	0	0	0	3
OG0025598	0	3	0	0	0	0	0	3
OG0025599	0	3	0	0	0	0	0	3
OG0025600	0	3	0	0	0	0	0	3
OG0025601	0	3	0	0	0	0	0	3
OG0025602	0	1	0	0	1	1	0	3
OG0025603	0	3	0	0	0	0	0	3
OG0025604	0	3	0	0	0	0	0	3
OG0025605	0	3	0	0	0	0	0	3
OG0025606	0	3	0	0	0	0	0	3
OG0025607	0	2	0	0	0	0	1	3
OG0025608	0	2	0	1	0	0	0	3
OG0025609	0	3	0	0	0	0	0	3
OG0025610	0	3	0	0	0	0	0	3
OG0025611	0	1	0	0	0	0	2	3
OG0025612	0	3	0	0	0	0	0	3
OG0025613	0	2	0	0	0	0	1	3
OG0025614	0	2	0	0	0	0	1	3
OG0025615	0	1	1	0	1	0	0	3
OG0025616	0	2	0	0	1	0	0	3
OG0025617	0	3	0	0	0	0	0	3
OG0025618	0	3	0	0	0	0	0	3
OG0025619	0	1	1	0	0	0	1	3
OG0025620	0	2	0	0	0	0	1	3
OG0025621	0	3	0	0	0	0	0	3
OG0025622	0	2	0	0	0	0	1	3
OG0025623	0	2	1	0	0	0	0	3
OG0025624	0	1	1	0	0	0	1	3
OG0025625	0	1	0	0	1	0	1	3
OG0025626	0	1	0	0	1	0	1	3
OG0025627	0	2	0	1	0	0	0	3
OG0025628	0	3	0	0	0	0	0	3
OG0025629	0	3	0	0	0	0	0	3
OG0025630	0	2	0	0	0	0	1	3
OG0025631	0	1	0	0	2	0	0	3
OG0025632	0	2	0	1	0	0	0	3
OG0025633	0	1	1	1	0	0	0	3
OG0025634	0	2	0	0	0	0	1	3
OG0025635	0	2	0	1	0	0	0	3
OG0025636	0	3	0	0	0	0	0	3
OG0025637	0	3	0	0	0	0	0	3
OG0025638	0	1	0	1	1	0	0	3
OG0025639	0	1	0	0	0	1	1	3
OG0025640	0	1	0	0	0	1	1	3
OG0025641	0	1	2	0	0	0	0	3
OG0025642	0	1	0	0	1	1	0	3
OG0025643	0	1	0	0	1	1	0	3
OG0025644	0	3	0	0	0	0	0	3
OG0025645	0	2	0	0	1	0	0	3
OG0025646	0	1	0	0	1	0	1	3
OG0025647	0	2	0	0	0	1	0	3
OG0025648	0	3	0	0	0	0	0	3
OG0025649	0	1	0	0	2	0	0	3
OG0025650	0	2	0	0	1	0	0	3
OG0025651	0	3	0	0	0	0	0	3
OG0025652	0	1	0	0	2	0	0	3
OG0025653	0	1	0	0	0	1	1	3
OG0025654	0	3	0	0	0	0	0	3
OG0025655	0	2	0	0	1	0	0	3
OG0025656	0	2	0	0	0	0	1	3
OG0025657	0	3	0	0	0	0	0	3
OG0025658	0	2	0	0	0	1	0	3
OG0025659	0	3	0	0	0	0	0	3
OG0025660	0	2	0	1	0	0	0	3
OG0025661	0	2	1	0	0	0	0	3
OG0025662	0	2	0	0	0	0	1	3
OG0025663	0	2	0	0	0	1	0	3
OG0025664	0	1	0	2	0	0	0	3
OG0025665	0	3	0	0	0	0	0	3
OG0025666	0	3	0	0	0	0	0	3
OG0025667	0	3	0	0	0	0	0	3
OG0025668	0	2	0	0	0	0	1	3
OG0025669	0	3	0	0	0	0	0	3
OG0025670	0	2	0	1	0	0	0	3
OG0025671	0	2	0	0	1	0	0	3
OG0025672	0	3	0	0	0	0	0	3
OG0025673	0	3	0	0	0	0	0	3
OG0025674	0	3	0	0	0	0	0	3
OG0025675	0	2	1	0	0	0	0	3
OG0025676	0	1	1	1	0	0	0	3
OG0025677	0	3	0	0	0	0	0	3
OG0025678	0	2	0	0	0	1	0	3
OG0025679	0	2	1	0	0	0	0	3
OG0025680	0	3	0	0	0	0	0	3
OG0025681	0	2	0	1	0	0	0	3
OG0025682	0	2	1	0	0	0	0	3
OG0025683	0	2	0	0	1	0	0	3
OG0025684	0	3	0	0	0	0	0	3
OG0025685	0	3	0	0	0	0	0	3
OG0025686	0	2	0	1	0	0	0	3
OG0025687	0	3	0	0	0	0	0	3
OG0025688	0	3	0	0	0	0	0	3
OG0025689	0	1	1	1	0	0	0	3
OG0025690	0	3	0	0	0	0	0	3
OG0025691	0	2	0	1	0	0	0	3
OG0025692	0	1	0	0	0	0	2	3
OG0025693	0	1	0	1	1	0	0	3
OG0025694	0	3	0	0	0	0	0	3
OG0025695	0	1	0	1	1	0	0	3
OG0025696	0	1	0	0	1	1	0	3
OG0025697	0	2	0	0	1	0	0	3
OG0025698	0	3	0	0	0	0	0	3
OG0025699	0	3	0	0	0	0	0	3
OG0025700	0	1	0	0	2	0	0	3
OG0025701	0	1	1	0	0	0	1	3
OG0025702	0	1	0	1	0	0	1	3
OG0025703	0	2	0	1	0	0	0	3
OG0025704	0	2	0	1	0	0	0	3
OG0025705	0	3	0	0	0	0	0	3
OG0025706	0	3	0	0	0	0	0	3
OG0025707	0	3	0	0	0	0	0	3
OG0025708	0	3	0	0	0	0	0	3
OG0025709	0	2	0	1	0	0	0	3
OG0025710	0	3	0	0	0	0	0	3
OG0025711	0	3	0	0	0	0	0	3
OG0025712	0	3	0	0	0	0	0	3
OG0025713	0	3	0	0	0	0	0	3
OG0025714	0	1	0	1	0	0	1	3
OG0025715	0	3	0	0	0	0	0	3
OG0025716	0	3	0	0	0	0	0	3
OG0025717	0	3	0	0	0	0	0	3
OG0025718	0	1	1	0	0	1	0	3
OG0025719	0	3	0	0	0	0	0	3
OG0025720	0	1	0	0	0	0	2	3
OG0025721	0	1	1	0	0	1	0	3
OG0025722	0	1	1	0	0	0	1	3
OG0025723	0	1	0	1	0	0	1	3
OG0025724	0	1	0	2	0	0	0	3
OG0025725	0	2	0	1	0	0	0	3
OG0025726	0	1	0	1	1	0	0	3
OG0025727	0	3	0	0	0	0	0	3
OG0025728	0	2	0	1	0	0	0	3
OG0025729	0	1	1	0	0	0	1	3
OG0025730	0	1	1	1	0	0	0	3
OG0025731	0	3	0	0	0	0	0	3
OG0025732	0	3	0	0	0	0	0	3
OG0025733	0	2	0	0	0	0	1	3
OG0025734	0	1	0	1	0	1	0	3
OG0025735	0	1	0	0	1	1	0	3
OG0025736	0	3	0	0	0	0	0	3
OG0025737	0	2	0	0	0	0	1	3
OG0025738	0	2	0	1	0	0	0	3
OG0025739	0	3	0	0	0	0	0	3
OG0025740	0	1	1	1	0	0	0	3
OG0025741	0	2	0	0	0	0	1	3
OG0025742	0	3	0	0	0	0	0	3
OG0025743	0	3	0	0	0	0	0	3
OG0025744	0	2	0	1	0	0	0	3
OG0025745	0	2	1	0	0	0	0	3
OG0025746	0	1	1	0	0	0	1	3
OG0025747	0	1	0	0	0	0	2	3
OG0025748	0	2	0	1	0	0	0	3
OG0025749	0	1	0	0	0	1	1	3
OG0025750	0	2	0	1	0	0	0	3
OG0025751	0	2	0	1	0	0	0	3
OG0025752	0	3	0	0	0	0	0	3
OG0025753	0	2	0	0	0	0	1	3
OG0025754	0	2	0	0	0	0	1	3
OG0025755	0	2	0	0	1	0	0	3
OG0025756	0	1	0	1	0	1	0	3
OG0025757	0	3	0	0	0	0	0	3
OG0025758	0	2	0	0	1	0	0	3
OG0025759	0	1	0	0	0	0	2	3
OG0025760	0	1	0	0	0	0	2	3
OG0025761	0	3	0	0	0	0	0	3
OG0025762	0	2	0	0	0	0	1	3
OG0025763	0	1	1	0	0	0	1	3
OG0025764	0	1	0	1	0	1	0	3
OG0025765	0	2	0	1	0	0	0	3
OG0025766	0	3	0	0	0	0	0	3
OG0025767	0	3	0	0	0	0	0	3
OG0025768	0	3	0	0	0	0	0	3
OG0025769	0	1	1	0	1	0	0	3
OG0025770	0	2	0	0	1	0	0	3
OG0025771	0	1	0	0	1	0	1	3
OG0025772	0	3	0	0	0	0	0	3
OG0025773	0	3	0	0	0	0	0	3
OG0025774	0	2	0	0	0	1	0	3
OG0025775	0	3	0	0	0	0	0	3
OG0025776	0	2	0	0	1	0	0	3
OG0025777	0	2	0	0	0	0	1	3
OG0025778	0	1	1	1	0	0	0	3
OG0025779	0	1	0	0	1	0	1	3
OG0025780	0	1	0	0	0	1	1	3
OG0025781	0	3	0	0	0	0	0	3
OG0025782	0	2	0	0	0	0	1	3
OG0025783	0	3	0	0	0	0	0	3
OG0025784	0	2	0	1	0	0	0	3
OG0025785	0	2	0	1	0	0	0	3
OG0025786	0	1	0	0	0	1	1	3
OG0025787	0	1	0	1	0	0	1	3
OG0025788	0	3	0	0	0	0	0	3
OG0025789	0	2	0	0	0	0	1	3
OG0025790	0	3	0	0	0	0	0	3
OG0025791	0	2	0	0	0	0	1	3
OG0025792	0	2	0	0	1	0	0	3
OG0025793	0	2	1	0	0	0	0	3
OG0025794	0	2	0	1	0	0	0	3
OG0025795	0	2	0	1	0	0	0	3
OG0025796	0	2	0	1	0	0	0	3
OG0025797	0	2	0	1	0	0	0	3
OG0025798	0	3	0	0	0	0	0	3
OG0025799	0	1	0	1	0	0	1	3
OG0025800	0	2	0	0	1	0	0	3
OG0025801	0	1	0	0	0	1	1	3
OG0025802	0	2	0	1	0	0	0	3
OG0025803	0	3	0	0	0	0	0	3
OG0025804	0	3	0	0	0	0	0	3
OG0025805	0	3	0	0	0	0	0	3
OG0025806	0	2	1	0	0	0	0	3
OG0025807	0	1	0	0	1	1	0	3
OG0025808	0	3	0	0	0	0	0	3
OG0025809	0	2	0	0	0	0	1	3
OG0025810	0	3	0	0	0	0	0	3
OG0025811	0	3	0	0	0	0	0	3
OG0025812	0	3	0	0	0	0	0	3
OG0025813	0	3	0	0	0	0	0	3
OG0025814	0	3	0	0	0	0	0	3
OG0025815	0	2	0	0	0	0	1	3
OG0025816	0	3	0	0	0	0	0	3
OG0025817	0	3	0	0	0	0	0	3
OG0025818	0	2	0	0	0	0	1	3
OG0025819	0	2	0	0	0	0	1	3
OG0025820	0	1	1	0	1	0	0	3
OG0025821	0	3	0	0	0	0	0	3
OG0025822	0	3	0	0	0	0	0	3
OG0025823	0	3	0	0	0	0	0	3
OG0025824	0	2	0	0	0	0	1	3
OG0025825	0	3	0	0	0	0	0	3
OG0025826	0	3	0	0	0	0	0	3
OG0025827	0	2	0	0	1	0	0	3
OG0025828	0	1	0	0	1	0	1	3
OG0025829	0	2	0	0	1	0	0	3
OG0025830	0	2	0	0	0	0	1	3
OG0025831	0	2	0	0	1	0	0	3
OG0025832	0	3	0	0	0	0	0	3
OG0025833	0	3	0	0	0	0	0	3
OG0025834	0	2	1	0	0	0	0	3
OG0025835	0	1	0	0	0	0	2	3
OG0025836	0	2	1	0	0	0	0	3
OG0025837	0	2	0	0	1	0	0	3
OG0025838	0	3	0	0	0	0	0	3
OG0025839	0	2	0	0	0	0	1	3
OG0025840	0	1	0	1	1	0	0	3
OG0025841	0	3	0	0	0	0	0	3
OG0025842	0	3	0	0	0	0	0	3
OG0025843	0	3	0	0	0	0	0	3
OG0025844	0	2	0	0	0	0	1	3
OG0025845	0	3	0	0	0	0	0	3
OG0025846	0	2	0	0	1	0	0	3
OG0025847	0	1	0	2	0	0	0	3
OG0025848	0	1	1	0	0	0	1	3
OG0025849	0	3	0	0	0	0	0	3
OG0025850	0	3	0	0	0	0	0	3
OG0025851	0	3	0	0	0	0	0	3
OG0025852	0	1	0	0	0	1	1	3
OG0025853	0	2	0	0	1	0	0	3
OG0025854	0	1	0	0	0	0	2	3
OG0025855	0	1	0	0	0	0	2	3
OG0025856	0	1	0	0	0	0	2	3
OG0025857	0	2	0	0	0	0	1	3
OG0025858	0	1	0	1	1	0	0	3
OG0025859	0	1	1	0	0	0	1	3
OG0025860	0	1	0	0	1	0	1	3
OG0025861	0	3	0	0	0	0	0	3
OG0025862	0	2	0	0	0	0	1	3
OG0025863	0	3	0	0	0	0	0	3
OG0025864	0	2	0	0	0	1	0	3
OG0025865	0	1	0	0	1	1	0	3
OG0025866	0	3	0	0	0	0	0	3
OG0025867	0	1	0	0	1	0	1	3
OG0025868	0	2	0	0	1	0	0	3
OG0025869	0	1	0	1	1	0	0	3
OG0025870	0	1	0	0	0	1	1	3
OG0025871	0	1	1	0	1	0	0	3
OG0025872	0	2	0	0	0	0	1	3
OG0025873	0	1	1	0	0	0	1	3
OG0025874	0	2	1	0	0	0	0	3
OG0025875	0	3	0	0	0	0	0	3
OG0025876	0	2	0	1	0	0	0	3
OG0025877	0	2	1	0	0	0	0	3
OG0025878	0	3	0	0	0	0	0	3
OG0025879	0	2	0	1	0	0	0	3
OG0025880	0	2	0	1	0	0	0	3
OG0025881	0	2	1	0	0	0	0	3
OG0025882	0	3	0	0	0	0	0	3
OG0025883	0	1	0	0	0	0	2	3
OG0025884	0	1	0	1	1	0	0	3
OG0025885	0	1	1	0	0	0	1	3
OG0025886	0	2	0	1	0	0	0	3
OG0025887	0	1	0	0	2	0	0	3
OG0025888	0	2	1	0	0	0	0	3
OG0025889	0	2	0	0	1	0	0	3
OG0025890	0	2	0	1	0	0	0	3
OG0025891	0	2	0	0	1	0	0	3
OG0025892	0	1	1	0	1	0	0	3
OG0025893	0	2	0	0	1	0	0	3
OG0025894	0	2	0	0	1	0	0	3
OG0025895	0	2	0	0	1	0	0	3
OG0025896	0	3	0	0	0	0	0	3
OG0025897	0	3	0	0	0	0	0	3
OG0025898	0	3	0	0	0	0	0	3
OG0025899	0	2	0	1	0	0	0	3
OG0025900	0	1	0	1	0	1	0	3
OG0025901	0	3	0	0	0	0	0	3
OG0025902	0	2	0	1	0	0	0	3
OG0025903	0	3	0	0	0	0	0	3
OG0025904	0	1	0	1	0	1	0	3
OG0025905	0	2	0	1	0	0	0	3
OG0025906	0	3	0	0	0	0	0	3
OG0025907	0	3	0	0	0	0	0	3
OG0025908	0	3	0	0	0	0	0	3
OG0025909	0	2	0	0	0	0	1	3
OG0025910	0	2	0	0	0	0	1	3
OG0025911	0	1	0	1	1	0	0	3
OG0025912	0	2	0	0	0	0	1	3
OG0025913	0	2	0	0	1	0	0	3
OG0025914	0	3	0	0	0	0	0	3
OG0025915	0	3	0	0	0	0	0	3
OG0025916	0	2	1	0	0	0	0	3
OG0025917	0	3	0	0	0	0	0	3
OG0025918	0	2	0	0	0	0	1	3
OG0025919	0	1	0	0	0	0	2	3
OG0025920	0	1	0	0	0	1	1	3
OG0025921	0	3	0	0	0	0	0	3
OG0025922	0	1	0	1	0	0	1	3
OG0025923	0	3	0	0	0	0	0	3
OG0025924	0	1	0	0	1	0	1	3
OG0025925	0	3	0	0	0	0	0	3
OG0025926	0	1	0	0	0	1	1	3
OG0025927	0	3	0	0	0	0	0	3
OG0025928	0	2	0	0	0	0	1	3
OG0025929	0	1	0	0	0	0	2	3
OG0025930	0	1	1	0	0	0	1	3
OG0025931	0	1	1	1	0	0	0	3
OG0025932	0	3	0	0	0	0	0	3
OG0025933	0	2	0	1	0	0	0	3
OG0025934	0	1	1	0	0	0	1	3
OG0025935	0	1	0	1	0	0	1	3
OG0025936	0	1	0	0	2	0	0	3
OG0025937	0	2	0	0	1	0	0	3
OG0025938	0	2	0	0	0	0	1	3
OG0025939	0	2	0	0	0	1	0	3
OG0025940	0	1	0	0	0	2	0	3
OG0025941	0	3	0	0	0	0	0	3
OG0025942	0	1	0	0	0	1	1	3
OG0025943	0	1	0	0	0	0	2	3
OG0025944	0	2	0	0	1	0	0	3
OG0025945	0	1	0	2	0	0	0	3
OG0025946	0	1	0	0	0	1	1	3
OG0025947	0	2	0	1	0	0	0	3
OG0025948	0	2	0	0	1	0	0	3
OG0025949	0	3	0	0	0	0	0	3
OG0025950	0	2	0	0	0	0	1	3
OG0025951	0	1	0	0	0	0	2	3
OG0025952	0	1	0	0	0	1	1	3
OG0025953	0	1	0	1	1	0	0	3
OG0025954	0	2	0	1	0	0	0	3
OG0025955	0	1	0	0	1	1	0	3
OG0025956	0	1	1	0	0	0	1	3
OG0025957	0	1	0	0	1	1	0	3
OG0025958	0	1	0	0	0	1	1	3
OG0025959	0	1	0	0	0	1	1	3
OG0025960	0	1	1	0	0	0	1	3
OG0025961	0	1	0	0	1	1	0	3
OG0025962	0	1	0	0	2	0	0	3
OG0025963	0	3	0	0	0	0	0	3
OG0025964	0	1	2	0	0	0	0	3
OG0025965	0	1	1	0	0	0	1	3
OG0025966	0	1	1	0	0	0	1	3
OG0025967	0	2	0	0	1	0	0	3
OG0025968	0	1	2	0	0	0	0	3
OG0025969	0	1	0	0	1	0	1	3
OG0025970	0	2	0	0	1	0	0	3
OG0025971	0	2	0	0	1	0	0	3
OG0025972	0	1	0	1	1	0	0	3
OG0025973	0	1	0	0	2	0	0	3
OG0025974	0	1	0	1	1	0	0	3
OG0025975	0	1	0	0	0	1	1	3
OG0025976	0	1	1	0	0	1	0	3
OG0025977	0	2	0	0	1	0	0	3
OG0025978	0	2	0	0	1	0	0	3
OG0025979	0	3	0	0	0	0	0	3
OG0025980	0	1	0	0	0	0	2	3
OG0025981	0	2	0	0	1	0	0	3
OG0025982	0	1	2	0	0	0	0	3
OG0025983	0	1	0	0	0	1	1	3
OG0025984	0	3	0	0	0	0	0	3
OG0025985	0	1	1	0	0	0	1	3
OG0025986	0	3	0	0	0	0	0	3
OG0025987	0	1	0	1	0	1	0	3
OG0025988	0	3	0	0	0	0	0	3
OG0025989	0	1	1	0	1	0	0	3
OG0025990	0	1	1	0	1	0	0	3
OG0025991	0	1	1	0	0	0	1	3
OG0025992	0	1	0	0	2	0	0	3
OG0025993	0	1	0	0	2	0	0	3
OG0025994	0	1	0	0	0	1	1	3
OG0025995	0	3	0	0	0	0	0	3
OG0025996	0	1	0	0	1	0	1	3
OG0025997	0	2	0	0	1	0	0	3
OG0025998	0	3	0	0	0	0	0	3
OG0025999	0	2	0	1	0	0	0	3
OG0026000	0	2	0	0	0	0	1	3
OG0026001	0	1	0	0	0	1	1	3
OG0026002	0	1	0	0	0	0	2	3
OG0026003	0	2	0	1	0	0	0	3
OG0026004	0	1	0	0	1	0	1	3
OG0026005	0	3	0	0	0	0	0	3
OG0026006	0	1	0	0	0	0	2	3
OG0026007	0	1	0	0	0	0	2	3
OG0026008	0	1	1	0	1	0	0	3
OG0026009	0	1	1	0	1	0	0	3
OG0026010	0	1	0	1	0	0	1	3
OG0026011	0	1	0	0	0	0	2	3
OG0026012	0	1	0	0	1	1	0	3
OG0026013	0	2	0	0	1	0	0	3
OG0026014	0	3	0	0	0	0	0	3
OG0026015	0	2	0	0	1	0	0	3
OG0026016	0	1	1	0	0	0	1	3
OG0026017	0	1	0	0	0	0	2	3
OG0026018	0	1	0	0	2	0	0	3
OG0026019	0	3	0	0	0	0	0	3
OG0026020	0	2	0	0	0	1	0	3
OG0026021	0	1	0	2	0	0	0	3
OG0026022	0	1	1	1	0	0	0	3
OG0026023	0	2	0	1	0	0	0	3
OG0026024	0	1	0	1	1	0	0	3
OG0026025	0	1	0	0	1	1	0	3
OG0026026	0	3	0	0	0	0	0	3
OG0026027	0	1	0	0	1	1	0	3
OG0026028	0	3	0	0	0	0	0	3
OG0026029	0	1	0	0	0	1	1	3
OG0026030	0	1	0	0	1	1	0	3
OG0026031	0	1	0	0	1	0	1	3
OG0026032	0	1	1	0	0	1	0	3
OG0026033	0	1	0	0	2	0	0	3
OG0026034	0	1	0	0	1	0	1	3
OG0026035	0	1	0	1	0	0	1	3
OG0026036	0	1	0	0	0	0	2	3
OG0026037	0	1	0	0	1	0	1	3
OG0026038	0	1	1	0	0	1	0	3
OG0026039	0	1	0	0	1	1	0	3
OG0026040	0	1	0	0	0	1	1	3
OG0026041	0	3	0	0	0	0	0	3
OG0026042	0	1	0	0	1	1	0	3
OG0026043	0	1	1	0	0	0	1	3
OG0026044	0	3	0	0	0	0	0	3
OG0026045	0	2	0	0	1	0	0	3
OG0026046	0	3	0	0	0	0	0	3
OG0026047	0	1	0	0	0	1	1	3
OG0026048	0	3	0	0	0	0	0	3
OG0026049	0	3	0	0	0	0	0	3
OG0026050	0	1	0	1	1	0	0	3
OG0026051	0	1	2	0	0	0	0	3
OG0026052	0	1	1	0	0	0	1	3
OG0026053	0	1	0	0	1	0	1	3
OG0026054	0	1	0	0	1	0	1	3
OG0026055	0	2	1	0	0	0	0	3
OG0026056	0	1	1	0	0	0	1	3
OG0026057	0	2	0	1	0	0	0	3
OG0026058	0	1	0	0	2	0	0	3
OG0026059	0	1	0	0	0	1	1	3
OG0026060	0	2	1	0	0	0	0	3
OG0026061	0	2	0	1	0	0	0	3
OG0026062	0	2	0	0	1	0	0	3
OG0026063	0	1	0	0	1	1	0	3
OG0026064	0	2	0	0	1	0	0	3
OG0026065	0	1	0	1	0	1	0	3
OG0026066	0	1	0	1	0	1	0	3
OG0026067	0	1	0	0	0	0	2	3
OG0026068	0	1	1	0	0	1	0	3
OG0026069	0	2	0	0	0	1	0	3
OG0026070	0	1	1	1	0	0	0	3
OG0026071	0	1	0	1	0	0	1	3
OG0026072	0	1	0	1	1	0	0	3
OG0026073	0	2	0	0	0	0	1	3
OG0026074	0	1	0	1	1	0	0	3
OG0026075	0	1	1	0	0	0	1	3
OG0026076	0	2	1	0	0	0	0	3
OG0026077	0	3	0	0	0	0	0	3
OG0026078	0	1	0	1	0	1	0	3
OG0026079	0	1	0	0	0	0	2	3
OG0026080	0	3	0	0	0	0	0	3
OG0026081	0	2	0	0	0	0	1	3
OG0026082	0	1	0	1	1	0	0	3
OG0026083	0	2	1	0	0	0	0	3
OG0026084	0	3	0	0	0	0	0	3
OG0026085	0	3	0	0	0	0	0	3
OG0026086	0	2	0	1	0	0	0	3
OG0026087	0	2	0	1	0	0	0	3
OG0026088	0	1	0	0	0	1	1	3
OG0026089	0	3	0	0	0	0	0	3
OG0026090	0	1	0	0	1	1	0	3
OG0026091	0	1	0	1	1	0	0	3
OG0026092	0	1	0	1	1	0	0	3
OG0026093	0	1	0	1	1	0	0	3
OG0026094	0	3	0	0	0	0	0	3
OG0026095	0	2	0	0	0	0	1	3
OG0026096	0	1	0	0	1	0	1	3
OG0026097	0	3	0	0	0	0	0	3
OG0026098	0	2	1	0	0	0	0	3
OG0026099	0	2	0	0	0	1	0	3
OG0026100	0	1	0	0	2	0	0	3
OG0026101	0	2	0	0	0	0	1	3
OG0026102	0	1	0	0	1	1	0	3
OG0026103	0	1	0	0	0	1	1	3
OG0026104	0	2	0	1	0	0	0	3
OG0026105	0	3	0	0	0	0	0	3
OG0026106	0	1	0	1	0	1	0	3
OG0026107	0	1	0	1	0	1	0	3
OG0026108	0	1	0	0	0	0	2	3
OG0026109	0	1	1	0	0	0	1	3
OG0026110	0	1	0	0	0	0	2	3
OG0026111	0	1	0	0	0	1	1	3
OG0026112	0	1	0	1	0	0	1	3
OG0026113	0	1	0	0	0	1	1	3
OG0026114	0	1	0	0	0	1	1	3
OG0026115	0	3	0	0	0	0	0	3
OG0026116	0	1	0	1	0	0	1	3
OG0026117	0	1	0	1	1	0	0	3
OG0026118	0	2	0	0	0	0	1	3
OG0026119	0	1	0	1	1	0	0	3
OG0026120	0	1	0	0	0	0	2	3
OG0026121	0	1	0	2	0	0	0	3
OG0026122	0	1	0	0	0	0	2	3
OG0026123	0	1	1	0	1	0	0	3
OG0026124	0	1	0	0	0	0	2	3
OG0026125	0	1	0	0	0	0	2	3
OG0026126	0	1	0	0	1	0	1	3
OG0026127	0	1	0	0	2	0	0	3
OG0026128	0	2	0	0	0	1	0	3
OG0026129	0	1	1	0	0	0	1	3
OG0026130	0	1	0	0	0	1	1	3
OG0026131	0	1	0	0	0	1	1	3
OG0026132	0	1	1	1	0	0	0	3
OG0026133	0	2	0	1	0	0	0	3
OG0026134	0	1	0	1	0	0	1	3
OG0026135	0	1	0	0	0	1	1	3
OG0026136	0	1	0	0	0	1	1	3
OG0026137	0	1	0	0	0	0	2	3
OG0026138	0	1	0	2	0	0	0	3
OG0026139	0	1	0	0	0	1	1	3
OG0026140	0	1	0	0	1	1	0	3
OG0026141	0	1	1	1	0	0	0	3
OG0026142	0	1	0	0	0	1	1	3
OG0026143	0	1	0	0	1	0	1	3
OG0026144	0	1	0	0	0	0	2	3
OG0026145	0	1	1	1	0	0	0	3
OG0026146	0	0	3	0	0	0	0	3
OG0026147	0	0	3	0	0	0	0	3
OG0026148	0	0	2	0	1	0	0	3
OG0026149	0	0	1	0	0	0	2	3
OG0026150	0	0	3	0	0	0	0	3
OG0026151	0	0	1	1	0	1	0	3
OG0026152	0	0	3	0	0	0	0	3
OG0026153	0	0	1	0	0	1	1	3
OG0026154	0	0	3	0	0	0	0	3
OG0026155	0	0	3	0	0	0	0	3
OG0026156	0	0	1	1	0	0	1	3
OG0026157	0	0	2	0	0	0	1	3
OG0026158	0	0	3	0	0	0	0	3
OG0026159	0	0	3	0	0	0	0	3
OG0026160	0	0	3	0	0	0	0	3
OG0026161	0	0	1	1	0	0	1	3
OG0026162	0	0	1	0	0	0	2	3
OG0026163	0	0	1	0	0	0	2	3
OG0026164	0	0	2	0	0	0	1	3
OG0026165	0	0	1	0	0	1	1	3
OG0026166	0	0	1	0	0	0	2	3
OG0026167	0	0	1	1	0	0	1	3
OG0026168	0	0	3	0	0	0	0	3
OG0026169	0	0	3	0	0	0	0	3
OG0026170	0	0	1	0	0	0	2	3
OG0026171	0	0	2	0	0	0	1	3
OG0026172	0	0	1	0	0	0	2	3
OG0026173	0	0	3	0	0	0	0	3
OG0026174	0	0	1	0	0	1	1	3
OG0026175	0	0	1	0	0	0	2	3
OG0026176	0	0	1	0	0	0	2	3
OG0026177	0	0	2	0	0	0	1	3
OG0026178	0	0	1	0	0	0	2	3
OG0026179	0	0	3	0	0	0	0	3
OG0026180	0	0	1	0	0	0	2	3
OG0026181	0	0	1	0	0	0	2	3
OG0026182	0	0	1	1	1	0	0	3
OG0026183	0	0	1	0	0	2	0	3
OG0026184	0	0	3	0	0	0	0	3
OG0026185	0	0	1	0	0	1	1	3
OG0026186	0	0	3	0	0	0	0	3
OG0026187	0	0	1	0	0	1	1	3
OG0026188	0	0	1	1	0	1	0	3
OG0026189	0	0	1	0	0	1	1	3
OG0026190	0	0	1	0	0	1	1	3
OG0026191	0	0	1	0	0	1	1	3
OG0026192	0	0	1	0	0	1	1	3
OG0026193	0	0	1	0	0	1	1	3
OG0026194	0	0	1	0	0	1	1	3
OG0026195	0	0	2	0	0	1	0	3
OG0026196	0	0	1	0	0	1	1	3
OG0026197	0	0	1	0	1	1	0	3
OG0026198	0	0	1	0	0	1	1	3
OG0026199	0	0	1	0	0	1	1	3
OG0026200	0	0	1	0	1	1	0	3
OG0026201	0	0	3	0	0	0	0	3
OG0026202	0	0	1	1	0	0	1	3
OG0026203	0	0	3	0	0	0	0	3
OG0026204	0	0	1	0	0	0	2	3
OG0026205	0	0	1	0	0	0	2	3
OG0026206	0	0	3	0	0	0	0	3
OG0026207	0	0	2	1	0	0	0	3
OG0026208	0	0	1	0	0	0	2	3
OG0026209	0	0	1	0	2	0	0	3
OG0026210	0	0	1	0	0	0	2	3
OG0026211	0	0	1	0	1	0	1	3
OG0026212	0	0	1	0	0	1	1	3
OG0026213	0	0	2	0	0	0	1	3
OG0026214	0	0	1	0	0	0	2	3
OG0026215	0	0	1	1	0	0	1	3
OG0026216	0	0	2	0	1	0	0	3
OG0026217	0	0	2	0	0	0	1	3
OG0026218	0	0	1	0	0	1	1	3
OG0026219	0	0	1	0	1	0	1	3
OG0026220	0	0	1	0	0	1	1	3
OG0026221	0	0	3	0	0	0	0	3
OG0026222	0	0	1	0	0	1	1	3
OG0026223	0	0	1	0	0	1	1	3
OG0026224	0	0	1	0	0	1	1	3
OG0026225	0	0	1	0	0	0	2	3
OG0026226	0	0	1	0	0	1	1	3
OG0026227	0	0	1	1	1	0	0	3
OG0026228	0	0	1	0	1	0	1	3
OG0026229	0	0	1	1	0	0	1	3
OG0026230	0	0	1	0	0	0	2	3
OG0026231	0	0	1	0	1	0	1	3
OG0026232	0	0	1	0	2	0	0	3
OG0026233	0	0	1	0	0	0	2	3
OG0026234	0	0	1	0	1	0	1	3
OG0026235	0	0	1	0	0	0	2	3
OG0026236	0	0	0	1	1	1	0	3
OG0026237	0	0	0	1	1	1	0	3
OG0026238	0	0	0	3	0	0	0	3
OG0026239	0	0	0	1	0	1	1	3
OG0026240	0	0	0	1	0	2	0	3
OG0026241	0	0	0	1	0	1	1	3
OG0026242	0	0	0	1	1	1	0	3
OG0026243	0	0	0	1	1	1	0	3
OG0026244	0	0	0	2	0	1	0	3
OG0026245	0	0	0	1	1	1	0	3
OG0026246	0	0	0	1	1	1	0	3
OG0026247	0	0	0	1	1	1	0	3
OG0026248	0	0	0	1	0	1	1	3
OG0026249	0	0	0	1	1	1	0	3
OG0026250	0	0	0	1	1	1	0	3
OG0026251	0	0	0	1	0	1	1	3
OG0026252	0	0	0	1	1	1	0	3
OG0026253	0	0	0	1	0	1	1	3
OG0026254	0	0	0	1	1	0	1	3
OG0026255	0	0	0	1	1	1	0	3
OG0026256	0	0	0	1	0	1	1	3
OG0026257	0	0	0	1	2	0	0	3
OG0026258	0	0	0	1	0	1	1	3
OG0026259	0	0	0	2	0	0	1	3
OG0026260	0	0	0	1	0	1	1	3
OG0026261	0	0	0	1	1	0	1	3
OG0026262	0	0	0	1	1	1	0	3
OG0026263	0	0	0	1	1	1	0	3
OG0026264	0	0	0	1	0	1	1	3
OG0026265	0	0	0	2	1	0	0	3
OG0026266	0	0	0	1	1	1	0	3
OG0026267	0	0	0	2	0	0	1	3
OG0026268	0	0	0	1	1	1	0	3
OG0026269	0	0	0	1	1	1	0	3
OG0026270	0	0	0	1	1	1	0	3
OG0026271	0	0	0	1	1	1	0	3
OG0026272	0	0	0	1	1	1	0	3
OG0026273	0	0	0	2	1	0	0	3
OG0026274	0	0	0	1	1	1	0	3
OG0026275	0	0	0	2	0	0	1	3
OG0026276	0	0	0	1	0	2	0	3
OG0026277	0	0	0	1	1	1	0	3
OG0026278	0	0	0	1	0	1	1	3
OG0026279	0	0	0	1	1	1	0	3
OG0026280	0	0	0	1	1	1	0	3
OG0026281	0	0	0	1	0	1	1	3
OG0026282	0	0	0	1	1	0	1	3
OG0026283	0	0	0	1	1	0	1	3
OG0026284	0	0	0	1	1	1	0	3
OG0026285	0	0	0	1	1	1	0	3
OG0026286	0	0	0	1	0	1	1	3
OG0026287	0	0	0	1	1	1	0	3
OG0026288	0	0	0	1	1	1	0	3
OG0026289	0	0	0	1	1	1	0	3
OG0026290	0	0	0	2	1	0	0	3
OG0026291	0	0	0	1	0	0	2	3
OG0026292	0	0	0	1	1	1	0	3
OG0026293	0	0	0	1	2	0	0	3
OG0026294	0	0	0	1	0	1	1	3
OG0026295	0	0	0	2	1	0	0	3
OG0026296	0	0	0	1	1	1	0	3
OG0026297	0	0	0	1	1	1	0	3
OG0026298	0	0	0	1	0	1	1	3
OG0026299	0	0	0	1	1	0	1	3
OG0026300	0	0	0	1	1	1	0	3
OG0026301	0	0	0	1	0	0	2	3
OG0026302	0	0	0	1	1	1	0	3
OG0026303	0	0	0	1	1	1	0	3
OG0026304	0	0	0	0	1	2	0	3
OG0026305	0	0	0	0	1	0	2	3
OG0026306	0	0	0	0	1	2	0	3
OG0026307	0	0	0	0	3	0	0	3
OG0026308	0	0	0	0	1	1	1	3
OG0026309	0	0	0	0	3	0	0	3
OG0026310	0	0	0	0	1	2	0	3
OG0026311	0	0	0	0	1	1	1	3
OG0026312	0	0	0	0	1	2	0	3
OG0026313	0	0	0	0	1	1	1	3
OG0026314	0	0	0	0	2	1	0	3
OG0026315	0	0	0	0	1	0	2	3
OG0026316	0	0	0	0	1	1	1	3
OG0026317	0	0	0	0	1	1	1	3
OG0026318	0	0	0	0	1	1	1	3
OG0026319	0	0	0	0	1	1	1	3
OG0026320	0	0	0	0	1	1	1	3
OG0026321	0	0	0	0	1	1	1	3
OG0026322	0	0	0	0	2	0	1	3
OG0026323	0	0	0	0	1	1	1	3
OG0026324	0	0	0	0	2	1	0	3
OG0026325	0	0	0	0	3	0	0	3
OG0026326	0	0	0	0	1	1	1	3
OG0026327	0	0	0	0	1	2	0	3
OG0026328	0	0	0	0	1	2	0	3
OG0026329	0	0	0	0	2	0	1	3
OG0026330	0	0	0	0	1	1	1	3
OG0026331	0	0	0	0	3	0	0	3
OG0026332	0	0	0	0	1	2	0	3
OG0026333	0	0	0	0	1	0	2	3
OG0026334	0	0	0	0	1	1	1	3
OG0026335	0	0	0	0	2	1	0	3
OG0026336	0	0	0	0	1	2	0	3
OG0026337	0	0	0	0	2	1	0	3
OG0026338	0	0	0	0	1	2	0	3
OG0026339	0	0	0	0	1	1	1	3
OG0026340	0	0	0	0	1	0	2	3
OG0026341	0	0	0	0	1	1	1	3
OG0026342	0	0	0	0	1	1	1	3
OG0026343	0	0	0	0	1	1	1	3
OG0026344	0	0	0	0	1	1	1	3
OG0026345	0	0	0	0	0	2	1	3
OG0026346	0	0	0	0	0	1	2	3
OG0026347	0	0	0	0	0	1	2	3
OG0026348	0	0	0	0	0	2	1	3
OG0026349	0	0	0	0	0	1	2	3
OG0026350	0	0	0	0	0	2	1	3
OG0026351	0	0	0	0	0	1	2	3
OG0026352	0	0	0	0	0	1	2	3
OG0026353	0	0	0	0	0	1	2	3
OG0026354	0	0	0	0	0	1	2	3
OG0026355	0	0	0	0	0	1	2	3
OG0026356	0	0	0	0	0	1	2	3
OG0026357	0	0	0	0	0	2	1	3
OG0026358	0	0	0	0	0	1	2	3
OG0026359	0	0	0	0	0	2	1	3
OG0026360	0	0	0	0	0	2	1	3
OG0026361	0	0	0	0	0	1	2	3
OG0026362	0	0	0	0	0	1	2	3
OG0026363	0	0	0	0	0	2	1	3
OG0026364	0	0	0	0	0	2	1	3
OG0026365	0	0	0	0	0	2	1	3
OG0026366	0	0	0	0	0	3	0	3
OG0026367	0	0	0	0	0	1	2	3
OG0026368	0	0	0	0	0	1	2	3
OG0026369	0	0	0	0	0	2	1	3
OG0026370	0	0	0	0	0	1	2	3
OG0026371	0	0	0	0	0	2	1	3
OG0026372	0	0	0	0	0	1	2	3
OG0026373	0	0	0	0	0	2	1	3
OG0026374	0	0	0	0	0	2	1	3
OG0026375	0	0	0	0	0	1	2	3
OG0026376	0	0	0	0	0	2	1	3
OG0026377	0	0	0	0	0	1	2	3
OG0026378	0	0	0	0	0	1	2	3
OG0026379	0	0	0	0	0	2	1	3
OG0026380	0	0	0	0	0	1	2	3
OG0026381	0	0	0	0	0	1	2	3
OG0026382	0	0	0	0	0	1	2	3
OG0026383	0	0	0	0	0	1	2	3
OG0026384	0	0	0	0	0	2	1	3
OG0026385	0	0	0	0	0	1	2	3
OG0026386	0	0	0	0	0	1	2	3
OG0026387	0	0	0	0	0	2	1	3
OG0026388	0	0	0	0	0	2	1	3
OG0026389	0	0	0	0	0	1	2	3
OG0026390	0	0	0	0	0	1	2	3
OG0026391	0	0	0	0	0	2	1	3
OG0026392	0	0	0	0	0	1	2	3
OG0026393	0	0	0	0	0	2	1	3
OG0026394	0	0	0	0	0	1	2	3
OG0026395	0	0	0	0	0	1	2	3
OG0026396	0	0	0	0	0	1	2	3
OG0026397	0	0	0	0	0	2	1	3
OG0026398	0	0	0	0	0	0	3	3
OG0026399	0	0	0	0	0	0	3	3
OG0026400	0	0	0	0	0	0	3	3
OG0026401	0	0	0	0	0	0	3	3
OG0026402	0	0	0	0	0	0	3	3
OG0026403	0	0	0	0	0	0	3	3
OG0026404	0	0	0	0	0	0	3	3
OG0026405	0	0	0	0	0	0	3	3
OG0026406	0	0	0	0	0	0	3	3
OG0026407	0	0	0	0	0	0	3	3
OG0026408	0	0	0	0	0	0	3	3
OG0026409	0	0	0	0	0	0	3	3
OG0026410	0	0	0	0	0	0	3	3
OG0026411	0	0	0	0	0	0	3	3
OG0026412	0	0	0	0	0	0	3	3
OG0026413	0	0	0	0	0	0	3	3
OG0026414	0	0	0	0	0	0	3	3
OG0026415	0	0	0	0	0	0	3	3
OG0026416	0	0	0	0	0	0	3	3
OG0026417	0	0	0	0	0	0	3	3
OG0026418	0	0	0	0	0	0	3	3
OG0026419	0	0	0	0	0	0	3	3
OG0026420	0	0	0	0	0	0	3	3
OG0026421	0	0	0	0	0	0	3	3
OG0026422	0	0	0	0	0	0	3	3
OG0026423	0	0	0	0	0	0	3	3
OG0026424	0	0	0	0	0	0	3	3
OG0026425	0	0	0	0	0	0	3	3
OG0026426	0	0	0	0	0	0	3	3
OG0026427	0	0	0	0	0	0	3	3
OG0026428	0	0	0	0	0	0	3	3
OG0026429	0	0	0	0	0	0	3	3
OG0026430	0	0	0	0	0	0	3	3
OG0026431	0	0	0	0	0	0	3	3
OG0026432	0	0	0	0	0	0	3	3
OG0026433	0	0	0	0	0	0	3	3
OG0026434	0	0	0	0	0	0	3	3
OG0026435	0	0	0	0	0	0	3	3
OG0026436	0	0	0	0	0	0	3	3
OG0026437	0	0	0	0	0	0	3	3
OG0026438	0	0	0	0	0	0	3	3
OG0026439	0	0	0	0	0	0	3	3
OG0026440	0	0	0	0	0	0	3	3
OG0026441	0	0	0	0	0	0	3	3
OG0026442	0	0	0	0	0	0	3	3
OG0026443	0	0	0	0	0	0	3	3
OG0026444	0	0	0	0	0	0	3	3
OG0026445	0	0	0	0	0	0	3	3
OG0026446	0	0	0	0	0	0	3	3
OG0026447	2	0	0	0	0	0	0	2
OG0026448	1	0	0	0	0	0	1	2
OG0026449	2	0	0	0	0	0	0	2
OG0026450	2	0	0	0	0	0	0	2
OG0026451	2	0	0	0	0	0	0	2
OG0026452	2	0	0	0	0	0	0	2
OG0026453	1	0	0	0	1	0	0	2
OG0026454	2	0	0	0	0	0	0	2
OG0026455	2	0	0	0	0	0	0	2
OG0026456	2	0	0	0	0	0	0	2
OG0026457	2	0	0	0	0	0	0	2
OG0026458	2	0	0	0	0	0	0	2
OG0026459	1	0	1	0	0	0	0	2
OG0026460	2	0	0	0	0	0	0	2
OG0026461	2	0	0	0	0	0	0	2
OG0026462	2	0	0	0	0	0	0	2
OG0026463	2	0	0	0	0	0	0	2
OG0026464	2	0	0	0	0	0	0	2
OG0026465	2	0	0	0	0	0	0	2
OG0026466	2	0	0	0	0	0	0	2
OG0026467	2	0	0	0	0	0	0	2
OG0026468	2	0	0	0	0	0	0	2
OG0026469	2	0	0	0	0	0	0	2
OG0026470	2	0	0	0	0	0	0	2
OG0026471	1	1	0	0	0	0	0	2
OG0026472	2	0	0	0	0	0	0	2
OG0026473	2	0	0	0	0	0	0	2
OG0026474	2	0	0	0	0	0	0	2
OG0026475	1	0	0	0	0	1	0	2
OG0026476	2	0	0	0	0	0	0	2
OG0026477	2	0	0	0	0	0	0	2
OG0026478	2	0	0	0	0	0	0	2
OG0026479	2	0	0	0	0	0	0	2
OG0026480	2	0	0	0	0	0	0	2
OG0026481	2	0	0	0	0	0	0	2
OG0026482	2	0	0	0	0	0	0	2
OG0026483	2	0	0	0	0	0	0	2
OG0026484	2	0	0	0	0	0	0	2
OG0026485	2	0	0	0	0	0	0	2
OG0026486	2	0	0	0	0	0	0	2
OG0026487	2	0	0	0	0	0	0	2
OG0026488	2	0	0	0	0	0	0	2
OG0026489	2	0	0	0	0	0	0	2
OG0026490	2	0	0	0	0	0	0	2
OG0026491	2	0	0	0	0	0	0	2
OG0026492	2	0	0	0	0	0	0	2
OG0026493	2	0	0	0	0	0	0	2
OG0026494	2	0	0	0	0	0	0	2
OG0026495	2	0	0	0	0	0	0	2
OG0026496	2	0	0	0	0	0	0	2
OG0026497	2	0	0	0	0	0	0	2
OG0026498	2	0	0	0	0	0	0	2
OG0026499	2	0	0	0	0	0	0	2
OG0026500	2	0	0	0	0	0	0	2
OG0026501	2	0	0	0	0	0	0	2
OG0026502	2	0	0	0	0	0	0	2
OG0026503	2	0	0	0	0	0	0	2
OG0026504	2	0	0	0	0	0	0	2
OG0026505	2	0	0	0	0	0	0	2
OG0026506	2	0	0	0	0	0	0	2
OG0026507	2	0	0	0	0	0	0	2
OG0026508	2	0	0	0	0	0	0	2
OG0026509	2	0	0	0	0	0	0	2
OG0026510	2	0	0	0	0	0	0	2
OG0026511	2	0	0	0	0	0	0	2
OG0026512	2	0	0	0	0	0	0	2
OG0026513	2	0	0	0	0	0	0	2
OG0026514	2	0	0	0	0	0	0	2
OG0026515	2	0	0	0	0	0	0	2
OG0026516	2	0	0	0	0	0	0	2
OG0026517	2	0	0	0	0	0	0	2
OG0026518	2	0	0	0	0	0	0	2
OG0026519	2	0	0	0	0	0	0	2
OG0026520	2	0	0	0	0	0	0	2
OG0026521	2	0	0	0	0	0	0	2
OG0026522	2	0	0	0	0	0	0	2
OG0026523	2	0	0	0	0	0	0	2
OG0026524	2	0	0	0	0	0	0	2
OG0026525	2	0	0	0	0	0	0	2
OG0026526	2	0	0	0	0	0	0	2
OG0026527	2	0	0	0	0	0	0	2
OG0026528	2	0	0	0	0	0	0	2
OG0026529	2	0	0	0	0	0	0	2
OG0026530	2	0	0	0	0	0	0	2
OG0026531	2	0	0	0	0	0	0	2
OG0026532	2	0	0	0	0	0	0	2
OG0026533	1	0	1	0	0	0	0	2
OG0026534	2	0	0	0	0	0	0	2
OG0026535	2	0	0	0	0	0	0	2
OG0026536	1	1	0	0	0	0	0	2
OG0026537	2	0	0	0	0	0	0	2
OG0026538	2	0	0	0	0	0	0	2
OG0026539	2	0	0	0	0	0	0	2
OG0026540	2	0	0	0	0	0	0	2
OG0026541	2	0	0	0	0	0	0	2
OG0026542	2	0	0	0	0	0	0	2
OG0026543	2	0	0	0	0	0	0	2
OG0026544	2	0	0	0	0	0	0	2
OG0026545	2	0	0	0	0	0	0	2
OG0026546	1	0	0	0	1	0	0	2
OG0026547	2	0	0	0	0	0	0	2
OG0026548	2	0	0	0	0	0	0	2
OG0026549	2	0	0	0	0	0	0	2
OG0026550	2	0	0	0	0	0	0	2
OG0026551	2	0	0	0	0	0	0	2
OG0026552	2	0	0	0	0	0	0	2
OG0026553	2	0	0	0	0	0	0	2
OG0026554	2	0	0	0	0	0	0	2
OG0026555	1	0	0	0	0	0	1	2
OG0026556	2	0	0	0	0	0	0	2
OG0026557	2	0	0	0	0	0	0	2
OG0026558	2	0	0	0	0	0	0	2
OG0026559	2	0	0	0	0	0	0	2
OG0026560	2	0	0	0	0	0	0	2
OG0026561	2	0	0	0	0	0	0	2
OG0026562	2	0	0	0	0	0	0	2
OG0026563	2	0	0	0	0	0	0	2
OG0026564	2	0	0	0	0	0	0	2
OG0026565	2	0	0	0	0	0	0	2
OG0026566	1	1	0	0	0	0	0	2
OG0026567	2	0	0	0	0	0	0	2
OG0026568	2	0	0	0	0	0	0	2
OG0026569	1	0	1	0	0	0	0	2
OG0026570	2	0	0	0	0	0	0	2
OG0026571	2	0	0	0	0	0	0	2
OG0026572	2	0	0	0	0	0	0	2
OG0026573	2	0	0	0	0	0	0	2
OG0026574	2	0	0	0	0	0	0	2
OG0026575	2	0	0	0	0	0	0	2
OG0026576	2	0	0	0	0	0	0	2
OG0026577	2	0	0	0	0	0	0	2
OG0026578	2	0	0	0	0	0	0	2
OG0026579	2	0	0	0	0	0	0	2
OG0026580	2	0	0	0	0	0	0	2
OG0026581	2	0	0	0	0	0	0	2
OG0026582	1	0	0	0	1	0	0	2
OG0026583	1	1	0	0	0	0	0	2
OG0026584	2	0	0	0	0	0	0	2
OG0026585	2	0	0	0	0	0	0	2
OG0026586	2	0	0	0	0	0	0	2
OG0026587	2	0	0	0	0	0	0	2
OG0026588	2	0	0	0	0	0	0	2
OG0026589	2	0	0	0	0	0	0	2
OG0026590	2	0	0	0	0	0	0	2
OG0026591	2	0	0	0	0	0	0	2
OG0026592	1	1	0	0	0	0	0	2
OG0026593	1	1	0	0	0	0	0	2
OG0026594	2	0	0	0	0	0	0	2
OG0026595	2	0	0	0	0	0	0	2
OG0026596	2	0	0	0	0	0	0	2
OG0026597	2	0	0	0	0	0	0	2
OG0026598	2	0	0	0	0	0	0	2
OG0026599	2	0	0	0	0	0	0	2
OG0026600	2	0	0	0	0	0	0	2
OG0026601	2	0	0	0	0	0	0	2
OG0026602	2	0	0	0	0	0	0	2
OG0026603	2	0	0	0	0	0	0	2
OG0026604	2	0	0	0	0	0	0	2
OG0026605	2	0	0	0	0	0	0	2
OG0026606	2	0	0	0	0	0	0	2
OG0026607	2	0	0	0	0	0	0	2
OG0026608	2	0	0	0	0	0	0	2
OG0026609	2	0	0	0	0	0	0	2
OG0026610	2	0	0	0	0	0	0	2
OG0026611	2	0	0	0	0	0	0	2
OG0026612	2	0	0	0	0	0	0	2
OG0026613	1	0	1	0	0	0	0	2
OG0026614	2	0	0	0	0	0	0	2
OG0026615	1	1	0	0	0	0	0	2
OG0026616	2	0	0	0	0	0	0	2
OG0026617	2	0	0	0	0	0	0	2
OG0026618	1	1	0	0	0	0	0	2
OG0026619	2	0	0	0	0	0	0	2
OG0026620	2	0	0	0	0	0	0	2
OG0026621	1	0	0	0	0	0	1	2
OG0026622	2	0	0	0	0	0	0	2
OG0026623	2	0	0	0	0	0	0	2
OG0026624	2	0	0	0	0	0	0	2
OG0026625	2	0	0	0	0	0	0	2
OG0026626	2	0	0	0	0	0	0	2
OG0026627	2	0	0	0	0	0	0	2
OG0026628	2	0	0	0	0	0	0	2
OG0026629	2	0	0	0	0	0	0	2
OG0026630	2	0	0	0	0	0	0	2
OG0026631	2	0	0	0	0	0	0	2
OG0026632	2	0	0	0	0	0	0	2
OG0026633	1	1	0	0	0	0	0	2
OG0026634	2	0	0	0	0	0	0	2
OG0026635	2	0	0	0	0	0	0	2
OG0026636	2	0	0	0	0	0	0	2
OG0026637	2	0	0	0	0	0	0	2
OG0026638	2	0	0	0	0	0	0	2
OG0026639	2	0	0	0	0	0	0	2
OG0026640	2	0	0	0	0	0	0	2
OG0026641	1	0	0	0	0	0	1	2
OG0026642	1	1	0	0	0	0	0	2
OG0026643	2	0	0	0	0	0	0	2
OG0026644	2	0	0	0	0	0	0	2
OG0026645	2	0	0	0	0	0	0	2
OG0026646	2	0	0	0	0	0	0	2
OG0026647	2	0	0	0	0	0	0	2
OG0026648	2	0	0	0	0	0	0	2
OG0026649	2	0	0	0	0	0	0	2
OG0026650	2	0	0	0	0	0	0	2
OG0026651	2	0	0	0	0	0	0	2
OG0026652	2	0	0	0	0	0	0	2
OG0026653	2	0	0	0	0	0	0	2
OG0026654	2	0	0	0	0	0	0	2
OG0026655	2	0	0	0	0	0	0	2
OG0026656	2	0	0	0	0	0	0	2
OG0026657	2	0	0	0	0	0	0	2
OG0026658	2	0	0	0	0	0	0	2
OG0026659	2	0	0	0	0	0	0	2
OG0026660	2	0	0	0	0	0	0	2
OG0026661	2	0	0	0	0	0	0	2
OG0026662	2	0	0	0	0	0	0	2
OG0026663	2	0	0	0	0	0	0	2
OG0026664	2	0	0	0	0	0	0	2
OG0026665	2	0	0	0	0	0	0	2
OG0026666	2	0	0	0	0	0	0	2
OG0026667	2	0	0	0	0	0	0	2
OG0026668	2	0	0	0	0	0	0	2
OG0026669	2	0	0	0	0	0	0	2
OG0026670	2	0	0	0	0	0	0	2
OG0026671	2	0	0	0	0	0	0	2
OG0026672	2	0	0	0	0	0	0	2
OG0026673	2	0	0	0	0	0	0	2
OG0026674	2	0	0	0	0	0	0	2
OG0026675	2	0	0	0	0	0	0	2
OG0026676	2	0	0	0	0	0	0	2
OG0026677	2	0	0	0	0	0	0	2
OG0026678	2	0	0	0	0	0	0	2
OG0026679	2	0	0	0	0	0	0	2
OG0026680	1	0	1	0	0	0	0	2
OG0026681	2	0	0	0	0	0	0	2
OG0026682	2	0	0	0	0	0	0	2
OG0026683	2	0	0	0	0	0	0	2
OG0026684	2	0	0	0	0	0	0	2
OG0026685	2	0	0	0	0	0	0	2
OG0026686	1	0	0	0	0	1	0	2
OG0026687	1	0	1	0	0	0	0	2
OG0026688	2	0	0	0	0	0	0	2
OG0026689	2	0	0	0	0	0	0	2
OG0026690	2	0	0	0	0	0	0	2
OG0026691	2	0	0	0	0	0	0	2
OG0026692	2	0	0	0	0	0	0	2
OG0026693	2	0	0	0	0	0	0	2
OG0026694	1	1	0	0	0	0	0	2
OG0026695	1	0	1	0	0	0	0	2
OG0026696	1	0	1	0	0	0	0	2
OG0026697	2	0	0	0	0	0	0	2
OG0026698	2	0	0	0	0	0	0	2
OG0026699	2	0	0	0	0	0	0	2
OG0026700	1	1	0	0	0	0	0	2
OG0026701	2	0	0	0	0	0	0	2
OG0026702	2	0	0	0	0	0	0	2
OG0026703	2	0	0	0	0	0	0	2
OG0026704	2	0	0	0	0	0	0	2
OG0026705	2	0	0	0	0	0	0	2
OG0026706	2	0	0	0	0	0	0	2
OG0026707	2	0	0	0	0	0	0	2
OG0026708	2	0	0	0	0	0	0	2
OG0026709	2	0	0	0	0	0	0	2
OG0026710	2	0	0	0	0	0	0	2
OG0026711	2	0	0	0	0	0	0	2
OG0026712	2	0	0	0	0	0	0	2
OG0026713	1	1	0	0	0	0	0	2
OG0026714	2	0	0	0	0	0	0	2
OG0026715	1	1	0	0	0	0	0	2
OG0026716	2	0	0	0	0	0	0	2
OG0026717	2	0	0	0	0	0	0	2
OG0026718	2	0	0	0	0	0	0	2
OG0026719	2	0	0	0	0	0	0	2
OG0026720	2	0	0	0	0	0	0	2
OG0026721	2	0	0	0	0	0	0	2
OG0026722	2	0	0	0	0	0	0	2
OG0026723	2	0	0	0	0	0	0	2
OG0026724	2	0	0	0	0	0	0	2
OG0026725	2	0	0	0	0	0	0	2
OG0026726	2	0	0	0	0	0	0	2
OG0026727	2	0	0	0	0	0	0	2
OG0026728	1	1	0	0	0	0	0	2
OG0026729	2	0	0	0	0	0	0	2
OG0026730	2	0	0	0	0	0	0	2
OG0026731	2	0	0	0	0	0	0	2
OG0026732	2	0	0	0	0	0	0	2
OG0026733	2	0	0	0	0	0	0	2
OG0026734	2	0	0	0	0	0	0	2
OG0026735	2	0	0	0	0	0	0	2
OG0026736	2	0	0	0	0	0	0	2
OG0026737	2	0	0	0	0	0	0	2
OG0026738	2	0	0	0	0	0	0	2
OG0026739	2	0	0	0	0	0	0	2
OG0026740	1	1	0	0	0	0	0	2
OG0026741	2	0	0	0	0	0	0	2
OG0026742	2	0	0	0	0	0	0	2
OG0026743	2	0	0	0	0	0	0	2
OG0026744	2	0	0	0	0	0	0	2
OG0026745	2	0	0	0	0	0	0	2
OG0026746	2	0	0	0	0	0	0	2
OG0026747	1	1	0	0	0	0	0	2
OG0026748	1	1	0	0	0	0	0	2
OG0026749	2	0	0	0	0	0	0	2
OG0026750	2	0	0	0	0	0	0	2
OG0026751	2	0	0	0	0	0	0	2
OG0026752	2	0	0	0	0	0	0	2
OG0026753	2	0	0	0	0	0	0	2
OG0026754	2	0	0	0	0	0	0	2
OG0026755	2	0	0	0	0	0	0	2
OG0026756	2	0	0	0	0	0	0	2
OG0026757	2	0	0	0	0	0	0	2
OG0026758	2	0	0	0	0	0	0	2
OG0026759	2	0	0	0	0	0	0	2
OG0026760	2	0	0	0	0	0	0	2
OG0026761	2	0	0	0	0	0	0	2
OG0026762	2	0	0	0	0	0	0	2
OG0026763	2	0	0	0	0	0	0	2
OG0026764	2	0	0	0	0	0	0	2
OG0026765	2	0	0	0	0	0	0	2
OG0026766	2	0	0	0	0	0	0	2
OG0026767	2	0	0	0	0	0	0	2
OG0026768	2	0	0	0	0	0	0	2
OG0026769	2	0	0	0	0	0	0	2
OG0026770	1	1	0	0	0	0	0	2
OG0026771	2	0	0	0	0	0	0	2
OG0026772	2	0	0	0	0	0	0	2
OG0026773	2	0	0	0	0	0	0	2
OG0026774	2	0	0	0	0	0	0	2
OG0026775	2	0	0	0	0	0	0	2
OG0026776	2	0	0	0	0	0	0	2
OG0026777	2	0	0	0	0	0	0	2
OG0026778	2	0	0	0	0	0	0	2
OG0026779	1	1	0	0	0	0	0	2
OG0026780	2	0	0	0	0	0	0	2
OG0026781	2	0	0	0	0	0	0	2
OG0026782	1	1	0	0	0	0	0	2
OG0026783	2	0	0	0	0	0	0	2
OG0026784	1	0	0	0	1	0	0	2
OG0026785	2	0	0	0	0	0	0	2
OG0026786	2	0	0	0	0	0	0	2
OG0026787	2	0	0	0	0	0	0	2
OG0026788	2	0	0	0	0	0	0	2
OG0026789	1	1	0	0	0	0	0	2
OG0026790	2	0	0	0	0	0	0	2
OG0026791	2	0	0	0	0	0	0	2
OG0026792	2	0	0	0	0	0	0	2
OG0026793	2	0	0	0	0	0	0	2
OG0026794	2	0	0	0	0	0	0	2
OG0026795	2	0	0	0	0	0	0	2
OG0026796	2	0	0	0	0	0	0	2
OG0026797	1	0	1	0	0	0	0	2
OG0026798	2	0	0	0	0	0	0	2
OG0026799	2	0	0	0	0	0	0	2
OG0026800	1	1	0	0	0	0	0	2
OG0026801	2	0	0	0	0	0	0	2
OG0026802	2	0	0	0	0	0	0	2
OG0026803	2	0	0	0	0	0	0	2
OG0026804	1	1	0	0	0	0	0	2
OG0026805	2	0	0	0	0	0	0	2
OG0026806	1	0	0	0	0	1	0	2
OG0026807	2	0	0	0	0	0	0	2
OG0026808	2	0	0	0	0	0	0	2
OG0026809	2	0	0	0	0	0	0	2
OG0026810	2	0	0	0	0	0	0	2
OG0026811	2	0	0	0	0	0	0	2
OG0026812	2	0	0	0	0	0	0	2
OG0026813	2	0	0	0	0	0	0	2
OG0026814	2	0	0	0	0	0	0	2
OG0026815	1	0	0	0	0	0	1	2
OG0026816	2	0	0	0	0	0	0	2
OG0026817	2	0	0	0	0	0	0	2
OG0026818	2	0	0	0	0	0	0	2
OG0026819	2	0	0	0	0	0	0	2
OG0026820	2	0	0	0	0	0	0	2
OG0026821	2	0	0	0	0	0	0	2
OG0026822	2	0	0	0	0	0	0	2
OG0026823	2	0	0	0	0	0	0	2
OG0026824	2	0	0	0	0	0	0	2
OG0026825	1	1	0	0	0	0	0	2
OG0026826	2	0	0	0	0	0	0	2
OG0026827	2	0	0	0	0	0	0	2
OG0026828	2	0	0	0	0	0	0	2
OG0026829	2	0	0	0	0	0	0	2
OG0026830	1	0	0	0	0	0	1	2
OG0026831	2	0	0	0	0	0	0	2
OG0026832	2	0	0	0	0	0	0	2
OG0026833	2	0	0	0	0	0	0	2
OG0026834	2	0	0	0	0	0	0	2
OG0026835	2	0	0	0	0	0	0	2
OG0026836	2	0	0	0	0	0	0	2
OG0026837	2	0	0	0	0	0	0	2
OG0026838	2	0	0	0	0	0	0	2
OG0026839	2	0	0	0	0	0	0	2
OG0026840	2	0	0	0	0	0	0	2
OG0026841	1	1	0	0	0	0	0	2
OG0026842	2	0	0	0	0	0	0	2
OG0026843	2	0	0	0	0	0	0	2
OG0026844	1	0	0	0	1	0	0	2
OG0026845	2	0	0	0	0	0	0	2
OG0026846	1	1	0	0	0	0	0	2
OG0026847	2	0	0	0	0	0	0	2
OG0026848	2	0	0	0	0	0	0	2
OG0026849	1	1	0	0	0	0	0	2
OG0026850	2	0	0	0	0	0	0	2
OG0026851	2	0	0	0	0	0	0	2
OG0026852	2	0	0	0	0	0	0	2
OG0026853	2	0	0	0	0	0	0	2
OG0026854	2	0	0	0	0	0	0	2
OG0026855	2	0	0	0	0	0	0	2
OG0026856	2	0	0	0	0	0	0	2
OG0026857	2	0	0	0	0	0	0	2
OG0026858	1	1	0	0	0	0	0	2
OG0026859	2	0	0	0	0	0	0	2
OG0026860	2	0	0	0	0	0	0	2
OG0026861	1	0	0	0	1	0	0	2
OG0026862	2	0	0	0	0	0	0	2
OG0026863	2	0	0	0	0	0	0	2
OG0026864	2	0	0	0	0	0	0	2
OG0026865	2	0	0	0	0	0	0	2
OG0026866	2	0	0	0	0	0	0	2
OG0026867	2	0	0	0	0	0	0	2
OG0026868	1	1	0	0	0	0	0	2
OG0026869	2	0	0	0	0	0	0	2
OG0026870	2	0	0	0	0	0	0	2
OG0026871	2	0	0	0	0	0	0	2
OG0026872	2	0	0	0	0	0	0	2
OG0026873	1	1	0	0	0	0	0	2
OG0026874	2	0	0	0	0	0	0	2
OG0026875	2	0	0	0	0	0	0	2
OG0026876	1	1	0	0	0	0	0	2
OG0026877	2	0	0	0	0	0	0	2
OG0026878	2	0	0	0	0	0	0	2
OG0026879	2	0	0	0	0	0	0	2
OG0026880	2	0	0	0	0	0	0	2
OG0026881	1	0	0	1	0	0	0	2
OG0026882	2	0	0	0	0	0	0	2
OG0026883	2	0	0	0	0	0	0	2
OG0026884	2	0	0	0	0	0	0	2
OG0026885	2	0	0	0	0	0	0	2
OG0026886	2	0	0	0	0	0	0	2
OG0026887	2	0	0	0	0	0	0	2
OG0026888	2	0	0	0	0	0	0	2
OG0026889	2	0	0	0	0	0	0	2
OG0026890	2	0	0	0	0	0	0	2
OG0026891	2	0	0	0	0	0	0	2
OG0026892	2	0	0	0	0	0	0	2
OG0026893	2	0	0	0	0	0	0	2
OG0026894	2	0	0	0	0	0	0	2
OG0026895	2	0	0	0	0	0	0	2
OG0026896	2	0	0	0	0	0	0	2
OG0026897	2	0	0	0	0	0	0	2
OG0026898	2	0	0	0	0	0	0	2
OG0026899	2	0	0	0	0	0	0	2
OG0026900	2	0	0	0	0	0	0	2
OG0026901	2	0	0	0	0	0	0	2
OG0026902	2	0	0	0	0	0	0	2
OG0026903	2	0	0	0	0	0	0	2
OG0026904	2	0	0	0	0	0	0	2
OG0026905	2	0	0	0	0	0	0	2
OG0026906	2	0	0	0	0	0	0	2
OG0026907	2	0	0	0	0	0	0	2
OG0026908	2	0	0	0	0	0	0	2
OG0026909	2	0	0	0	0	0	0	2
OG0026910	2	0	0	0	0	0	0	2
OG0026911	2	0	0	0	0	0	0	2
OG0026912	2	0	0	0	0	0	0	2
OG0026913	2	0	0	0	0	0	0	2
OG0026914	2	0	0	0	0	0	0	2
OG0026915	2	0	0	0	0	0	0	2
OG0026916	1	1	0	0	0	0	0	2
OG0026917	2	0	0	0	0	0	0	2
OG0026918	2	0	0	0	0	0	0	2
OG0026919	2	0	0	0	0	0	0	2
OG0026920	2	0	0	0	0	0	0	2
OG0026921	2	0	0	0	0	0	0	2
OG0026922	2	0	0	0	0	0	0	2
OG0026923	2	0	0	0	0	0	0	2
OG0026924	2	0	0	0	0	0	0	2
OG0026925	2	0	0	0	0	0	0	2
OG0026926	2	0	0	0	0	0	0	2
OG0026927	2	0	0	0	0	0	0	2
OG0026928	2	0	0	0	0	0	0	2
OG0026929	2	0	0	0	0	0	0	2
OG0026930	2	0	0	0	0	0	0	2
OG0026931	2	0	0	0	0	0	0	2
OG0026932	2	0	0	0	0	0	0	2
OG0026933	2	0	0	0	0	0	0	2
OG0026934	2	0	0	0	0	0	0	2
OG0026935	2	0	0	0	0	0	0	2
OG0026936	2	0	0	0	0	0	0	2
OG0026937	2	0	0	0	0	0	0	2
OG0026938	2	0	0	0	0	0	0	2
OG0026939	2	0	0	0	0	0	0	2
OG0026940	2	0	0	0	0	0	0	2
OG0026941	2	0	0	0	0	0	0	2
OG0026942	2	0	0	0	0	0	0	2
OG0026943	2	0	0	0	0	0	0	2
OG0026944	2	0	0	0	0	0	0	2
OG0026945	2	0	0	0	0	0	0	2
OG0026946	1	0	1	0	0	0	0	2
OG0026947	2	0	0	0	0	0	0	2
OG0026948	1	0	0	1	0	0	0	2
OG0026949	1	1	0	0	0	0	0	2
OG0026950	2	0	0	0	0	0	0	2
OG0026951	2	0	0	0	0	0	0	2
OG0026952	2	0	0	0	0	0	0	2
OG0026953	2	0	0	0	0	0	0	2
OG0026954	2	0	0	0	0	0	0	2
OG0026955	2	0	0	0	0	0	0	2
OG0026956	1	0	0	0	0	0	1	2
OG0026957	2	0	0	0	0	0	0	2
OG0026958	2	0	0	0	0	0	0	2
OG0026959	2	0	0	0	0	0	0	2
OG0026960	2	0	0	0	0	0	0	2
OG0026961	2	0	0	0	0	0	0	2
OG0026962	2	0	0	0	0	0	0	2
OG0026963	2	0	0	0	0	0	0	2
OG0026964	2	0	0	0	0	0	0	2
OG0026965	2	0	0	0	0	0	0	2
OG0026966	2	0	0	0	0	0	0	2
OG0026967	2	0	0	0	0	0	0	2
OG0026968	1	0	1	0	0	0	0	2
OG0026969	2	0	0	0	0	0	0	2
OG0026970	2	0	0	0	0	0	0	2
OG0026971	2	0	0	0	0	0	0	2
OG0026972	1	1	0	0	0	0	0	2
OG0026973	2	0	0	0	0	0	0	2
OG0026974	2	0	0	0	0	0	0	2
OG0026975	2	0	0	0	0	0	0	2
OG0026976	1	1	0	0	0	0	0	2
OG0026977	2	0	0	0	0	0	0	2
OG0026978	2	0	0	0	0	0	0	2
OG0026979	2	0	0	0	0	0	0	2
OG0026980	2	0	0	0	0	0	0	2
OG0026981	1	0	1	0	0	0	0	2
OG0026982	1	0	0	0	1	0	0	2
OG0026983	2	0	0	0	0	0	0	2
OG0026984	2	0	0	0	0	0	0	2
OG0026985	2	0	0	0	0	0	0	2
OG0026986	2	0	0	0	0	0	0	2
OG0026987	2	0	0	0	0	0	0	2
OG0026988	2	0	0	0	0	0	0	2
OG0026989	2	0	0	0	0	0	0	2
OG0026990	2	0	0	0	0	0	0	2
OG0026991	2	0	0	0	0	0	0	2
OG0026992	2	0	0	0	0	0	0	2
OG0026993	2	0	0	0	0	0	0	2
OG0026994	2	0	0	0	0	0	0	2
OG0026995	2	0	0	0	0	0	0	2
OG0026996	2	0	0	0	0	0	0	2
OG0026997	2	0	0	0	0	0	0	2
OG0026998	2	0	0	0	0	0	0	2
OG0026999	1	1	0	0	0	0	0	2
OG0027000	2	0	0	0	0	0	0	2
OG0027001	2	0	0	0	0	0	0	2
OG0027002	2	0	0	0	0	0	0	2
OG0027003	2	0	0	0	0	0	0	2
OG0027004	2	0	0	0	0	0	0	2
OG0027005	2	0	0	0	0	0	0	2
OG0027006	2	0	0	0	0	0	0	2
OG0027007	2	0	0	0	0	0	0	2
OG0027008	2	0	0	0	0	0	0	2
OG0027009	2	0	0	0	0	0	0	2
OG0027010	2	0	0	0	0	0	0	2
OG0027011	2	0	0	0	0	0	0	2
OG0027012	1	0	0	0	0	0	1	2
OG0027013	2	0	0	0	0	0	0	2
OG0027014	2	0	0	0	0	0	0	2
OG0027015	2	0	0	0	0	0	0	2
OG0027016	2	0	0	0	0	0	0	2
OG0027017	2	0	0	0	0	0	0	2
OG0027018	2	0	0	0	0	0	0	2
OG0027019	2	0	0	0	0	0	0	2
OG0027020	2	0	0	0	0	0	0	2
OG0027021	2	0	0	0	0	0	0	2
OG0027022	2	0	0	0	0	0	0	2
OG0027023	2	0	0	0	0	0	0	2
OG0027024	2	0	0	0	0	0	0	2
OG0027025	1	1	0	0	0	0	0	2
OG0027026	2	0	0	0	0	0	0	2
OG0027027	2	0	0	0	0	0	0	2
OG0027028	2	0	0	0	0	0	0	2
OG0027029	2	0	0	0	0	0	0	2
OG0027030	2	0	0	0	0	0	0	2
OG0027031	2	0	0	0	0	0	0	2
OG0027032	2	0	0	0	0	0	0	2
OG0027033	2	0	0	0	0	0	0	2
OG0027034	1	0	0	1	0	0	0	2
OG0027035	1	1	0	0	0	0	0	2
OG0027036	1	0	0	0	1	0	0	2
OG0027037	1	1	0	0	0	0	0	2
OG0027038	2	0	0	0	0	0	0	2
OG0027039	2	0	0	0	0	0	0	2
OG0027040	2	0	0	0	0	0	0	2
OG0027041	2	0	0	0	0	0	0	2
OG0027042	2	0	0	0	0	0	0	2
OG0027043	2	0	0	0	0	0	0	2
OG0027044	2	0	0	0	0	0	0	2
OG0027045	2	0	0	0	0	0	0	2
OG0027046	2	0	0	0	0	0	0	2
OG0027047	2	0	0	0	0	0	0	2
OG0027048	2	0	0	0	0	0	0	2
OG0027049	2	0	0	0	0	0	0	2
OG0027050	2	0	0	0	0	0	0	2
OG0027051	2	0	0	0	0	0	0	2
OG0027052	2	0	0	0	0	0	0	2
OG0027053	2	0	0	0	0	0	0	2
OG0027054	2	0	0	0	0	0	0	2
OG0027055	2	0	0	0	0	0	0	2
OG0027056	2	0	0	0	0	0	0	2
OG0027057	1	0	0	1	0	0	0	2
OG0027058	2	0	0	0	0	0	0	2
OG0027059	1	1	0	0	0	0	0	2
OG0027060	2	0	0	0	0	0	0	2
OG0027061	2	0	0	0	0	0	0	2
OG0027062	2	0	0	0	0	0	0	2
OG0027063	2	0	0	0	0	0	0	2
OG0027064	2	0	0	0	0	0	0	2
OG0027065	2	0	0	0	0	0	0	2
OG0027066	2	0	0	0	0	0	0	2
OG0027067	2	0	0	0	0	0	0	2
OG0027068	2	0	0	0	0	0	0	2
OG0027069	2	0	0	0	0	0	0	2
OG0027070	2	0	0	0	0	0	0	2
OG0027071	2	0	0	0	0	0	0	2
OG0027072	2	0	0	0	0	0	0	2
OG0027073	1	1	0	0	0	0	0	2
OG0027074	2	0	0	0	0	0	0	2
OG0027075	2	0	0	0	0	0	0	2
OG0027076	2	0	0	0	0	0	0	2
OG0027077	2	0	0	0	0	0	0	2
OG0027078	2	0	0	0	0	0	0	2
OG0027079	2	0	0	0	0	0	0	2
OG0027080	2	0	0	0	0	0	0	2
OG0027081	1	0	1	0	0	0	0	2
OG0027082	2	0	0	0	0	0	0	2
OG0027083	2	0	0	0	0	0	0	2
OG0027084	2	0	0	0	0	0	0	2
OG0027085	2	0	0	0	0	0	0	2
OG0027086	1	0	0	1	0	0	0	2
OG0027087	2	0	0	0	0	0	0	2
OG0027088	2	0	0	0	0	0	0	2
OG0027089	1	1	0	0	0	0	0	2
OG0027090	2	0	0	0	0	0	0	2
OG0027091	2	0	0	0	0	0	0	2
OG0027092	1	1	0	0	0	0	0	2
OG0027093	2	0	0	0	0	0	0	2
OG0027094	1	1	0	0	0	0	0	2
OG0027095	2	0	0	0	0	0	0	2
OG0027096	2	0	0	0	0	0	0	2
OG0027097	2	0	0	0	0	0	0	2
OG0027098	2	0	0	0	0	0	0	2
OG0027099	2	0	0	0	0	0	0	2
OG0027100	2	0	0	0	0	0	0	2
OG0027101	2	0	0	0	0	0	0	2
OG0027102	2	0	0	0	0	0	0	2
OG0027103	2	0	0	0	0	0	0	2
OG0027104	2	0	0	0	0	0	0	2
OG0027105	2	0	0	0	0	0	0	2
OG0027106	2	0	0	0	0	0	0	2
OG0027107	2	0	0	0	0	0	0	2
OG0027108	2	0	0	0	0	0	0	2
OG0027109	2	0	0	0	0	0	0	2
OG0027110	1	1	0	0	0	0	0	2
OG0027111	2	0	0	0	0	0	0	2
OG0027112	1	1	0	0	0	0	0	2
OG0027113	1	1	0	0	0	0	0	2
OG0027114	2	0	0	0	0	0	0	2
OG0027115	2	0	0	0	0	0	0	2
OG0027116	2	0	0	0	0	0	0	2
OG0027117	2	0	0	0	0	0	0	2
OG0027118	2	0	0	0	0	0	0	2
OG0027119	2	0	0	0	0	0	0	2
OG0027120	2	0	0	0	0	0	0	2
OG0027121	1	1	0	0	0	0	0	2
OG0027122	1	1	0	0	0	0	0	2
OG0027123	2	0	0	0	0	0	0	2
OG0027124	2	0	0	0	0	0	0	2
OG0027125	2	0	0	0	0	0	0	2
OG0027126	2	0	0	0	0	0	0	2
OG0027127	1	1	0	0	0	0	0	2
OG0027128	2	0	0	0	0	0	0	2
OG0027129	1	1	0	0	0	0	0	2
OG0027130	2	0	0	0	0	0	0	2
OG0027131	2	0	0	0	0	0	0	2
OG0027132	2	0	0	0	0	0	0	2
OG0027133	2	0	0	0	0	0	0	2
OG0027134	1	1	0	0	0	0	0	2
OG0027135	2	0	0	0	0	0	0	2
OG0027136	2	0	0	0	0	0	0	2
OG0027137	1	1	0	0	0	0	0	2
OG0027138	2	0	0	0	0	0	0	2
OG0027139	1	1	0	0	0	0	0	2
OG0027140	2	0	0	0	0	0	0	2
OG0027141	2	0	0	0	0	0	0	2
OG0027142	2	0	0	0	0	0	0	2
OG0027143	2	0	0	0	0	0	0	2
OG0027144	2	0	0	0	0	0	0	2
OG0027145	2	0	0	0	0	0	0	2
OG0027146	2	0	0	0	0	0	0	2
OG0027147	2	0	0	0	0	0	0	2
OG0027148	1	1	0	0	0	0	0	2
OG0027149	1	0	0	0	0	0	1	2
OG0027150	1	1	0	0	0	0	0	2
OG0027151	1	1	0	0	0	0	0	2
OG0027152	2	0	0	0	0	0	0	2
OG0027153	2	0	0	0	0	0	0	2
OG0027154	1	1	0	0	0	0	0	2
OG0027155	1	1	0	0	0	0	0	2
OG0027156	2	0	0	0	0	0	0	2
OG0027157	2	0	0	0	0	0	0	2
OG0027158	2	0	0	0	0	0	0	2
OG0027159	2	0	0	0	0	0	0	2
OG0027160	2	0	0	0	0	0	0	2
OG0027161	2	0	0	0	0	0	0	2
OG0027162	1	0	0	0	0	0	1	2
OG0027163	2	0	0	0	0	0	0	2
OG0027164	1	1	0	0	0	0	0	2
OG0027165	1	0	0	0	0	0	1	2
OG0027166	2	0	0	0	0	0	0	2
OG0027167	2	0	0	0	0	0	0	2
OG0027168	2	0	0	0	0	0	0	2
OG0027169	2	0	0	0	0	0	0	2
OG0027170	1	1	0	0	0	0	0	2
OG0027171	1	1	0	0	0	0	0	2
OG0027172	2	0	0	0	0	0	0	2
OG0027173	1	1	0	0	0	0	0	2
OG0027174	2	0	0	0	0	0	0	2
OG0027175	2	0	0	0	0	0	0	2
OG0027176	2	0	0	0	0	0	0	2
OG0027177	1	1	0	0	0	0	0	2
OG0027178	2	0	0	0	0	0	0	2
OG0027179	1	0	1	0	0	0	0	2
OG0027180	2	0	0	0	0	0	0	2
OG0027181	2	0	0	0	0	0	0	2
OG0027182	1	0	1	0	0	0	0	2
OG0027183	2	0	0	0	0	0	0	2
OG0027184	2	0	0	0	0	0	0	2
OG0027185	2	0	0	0	0	0	0	2
OG0027186	1	0	1	0	0	0	0	2
OG0027187	2	0	0	0	0	0	0	2
OG0027188	2	0	0	0	0	0	0	2
OG0027189	2	0	0	0	0	0	0	2
OG0027190	2	0	0	0	0	0	0	2
OG0027191	2	0	0	0	0	0	0	2
OG0027192	2	0	0	0	0	0	0	2
OG0027193	1	0	1	0	0	0	0	2
OG0027194	2	0	0	0	0	0	0	2
OG0027195	1	1	0	0	0	0	0	2
OG0027196	2	0	0	0	0	0	0	2
OG0027197	2	0	0	0	0	0	0	2
OG0027198	2	0	0	0	0	0	0	2
OG0027199	1	0	0	0	0	0	1	2
OG0027200	2	0	0	0	0	0	0	2
OG0027201	1	1	0	0	0	0	0	2
OG0027202	1	1	0	0	0	0	0	2
OG0027203	2	0	0	0	0	0	0	2
OG0027204	1	1	0	0	0	0	0	2
OG0027205	2	0	0	0	0	0	0	2
OG0027206	2	0	0	0	0	0	0	2
OG0027207	2	0	0	0	0	0	0	2
OG0027208	2	0	0	0	0	0	0	2
OG0027209	1	1	0	0	0	0	0	2
OG0027210	2	0	0	0	0	0	0	2
OG0027211	2	0	0	0	0	0	0	2
OG0027212	1	1	0	0	0	0	0	2
OG0027213	2	0	0	0	0	0	0	2
OG0027214	2	0	0	0	0	0	0	2
OG0027215	2	0	0	0	0	0	0	2
OG0027216	2	0	0	0	0	0	0	2
OG0027217	2	0	0	0	0	0	0	2
OG0027218	2	0	0	0	0	0	0	2
OG0027219	2	0	0	0	0	0	0	2
OG0027220	1	1	0	0	0	0	0	2
OG0027221	1	0	1	0	0	0	0	2
OG0027222	1	1	0	0	0	0	0	2
OG0027223	2	0	0	0	0	0	0	2
OG0027224	2	0	0	0	0	0	0	2
OG0027225	2	0	0	0	0	0	0	2
OG0027226	2	0	0	0	0	0	0	2
OG0027227	1	0	0	0	1	0	0	2
OG0027228	2	0	0	0	0	0	0	2
OG0027229	1	1	0	0	0	0	0	2
OG0027230	2	0	0	0	0	0	0	2
OG0027231	2	0	0	0	0	0	0	2
OG0027232	2	0	0	0	0	0	0	2
OG0027233	2	0	0	0	0	0	0	2
OG0027234	1	1	0	0	0	0	0	2
OG0027235	2	0	0	0	0	0	0	2
OG0027236	1	1	0	0	0	0	0	2
OG0027237	2	0	0	0	0	0	0	2
OG0027238	1	0	1	0	0	0	0	2
OG0027239	2	0	0	0	0	0	0	2
OG0027240	2	0	0	0	0	0	0	2
OG0027241	2	0	0	0	0	0	0	2
OG0027242	1	0	0	1	0	0	0	2
OG0027243	2	0	0	0	0	0	0	2
OG0027244	2	0	0	0	0	0	0	2
OG0027245	2	0	0	0	0	0	0	2
OG0027246	2	0	0	0	0	0	0	2
OG0027247	2	0	0	0	0	0	0	2
OG0027248	1	0	0	1	0	0	0	2
OG0027249	1	1	0	0	0	0	0	2
OG0027250	2	0	0	0	0	0	0	2
OG0027251	2	0	0	0	0	0	0	2
OG0027252	2	0	0	0	0	0	0	2
OG0027253	2	0	0	0	0	0	0	2
OG0027254	2	0	0	0	0	0	0	2
OG0027255	1	1	0	0	0	0	0	2
OG0027256	1	0	0	0	0	0	1	2
OG0027257	1	0	0	0	1	0	0	2
OG0027258	1	1	0	0	0	0	0	2
OG0027259	2	0	0	0	0	0	0	2
OG0027260	2	0	0	0	0	0	0	2
OG0027261	1	1	0	0	0	0	0	2
OG0027262	2	0	0	0	0	0	0	2
OG0027263	1	1	0	0	0	0	0	2
OG0027264	1	0	1	0	0	0	0	2
OG0027265	2	0	0	0	0	0	0	2
OG0027266	1	1	0	0	0	0	0	2
OG0027267	2	0	0	0	0	0	0	2
OG0027268	1	0	0	0	0	0	1	2
OG0027269	1	1	0	0	0	0	0	2
OG0027270	2	0	0	0	0	0	0	2
OG0027271	2	0	0	0	0	0	0	2
OG0027272	2	0	0	0	0	0	0	2
OG0027273	1	0	0	0	0	0	1	2
OG0027274	1	0	0	0	0	0	1	2
OG0027275	2	0	0	0	0	0	0	2
OG0027276	2	0	0	0	0	0	0	2
OG0027277	1	0	0	0	0	0	1	2
OG0027278	1	0	1	0	0	0	0	2
OG0027279	2	0	0	0	0	0	0	2
OG0027280	1	0	0	0	0	0	1	2
OG0027281	2	0	0	0	0	0	0	2
OG0027282	1	1	0	0	0	0	0	2
OG0027283	2	0	0	0	0	0	0	2
OG0027284	1	1	0	0	0	0	0	2
OG0027285	1	1	0	0	0	0	0	2
OG0027286	2	0	0	0	0	0	0	2
OG0027287	1	0	1	0	0	0	0	2
OG0027288	2	0	0	0	0	0	0	2
OG0027289	1	1	0	0	0	0	0	2
OG0027290	1	0	0	0	0	0	1	2
OG0027291	2	0	0	0	0	0	0	2
OG0027292	1	1	0	0	0	0	0	2
OG0027293	1	0	1	0	0	0	0	2
OG0027294	2	0	0	0	0	0	0	2
OG0027295	2	0	0	0	0	0	0	2
OG0027296	1	1	0	0	0	0	0	2
OG0027297	2	0	0	0	0	0	0	2
OG0027298	1	0	0	1	0	0	0	2
OG0027299	2	0	0	0	0	0	0	2
OG0027300	1	0	1	0	0	0	0	2
OG0027301	2	0	0	0	0	0	0	2
OG0027302	1	1	0	0	0	0	0	2
OG0027303	1	0	0	0	0	1	0	2
OG0027304	1	1	0	0	0	0	0	2
OG0027305	1	1	0	0	0	0	0	2
OG0027306	1	1	0	0	0	0	0	2
OG0027307	2	0	0	0	0	0	0	2
OG0027308	1	0	0	1	0	0	0	2
OG0027309	2	0	0	0	0	0	0	2
OG0027310	1	0	0	0	0	1	0	2
OG0027311	1	0	0	1	0	0	0	2
OG0027312	2	0	0	0	0	0	0	2
OG0027313	1	1	0	0	0	0	0	2
OG0027314	1	1	0	0	0	0	0	2
OG0027315	1	1	0	0	0	0	0	2
OG0027316	1	0	0	0	0	0	1	2
OG0027317	1	1	0	0	0	0	0	2
OG0027318	1	0	1	0	0	0	0	2
OG0027319	2	0	0	0	0	0	0	2
OG0027320	1	1	0	0	0	0	0	2
OG0027321	1	1	0	0	0	0	0	2
OG0027322	1	0	0	0	0	1	0	2
OG0027323	1	0	1	0	0	0	0	2
OG0027324	1	1	0	0	0	0	0	2
OG0027325	0	2	0	0	0	0	0	2
OG0027326	0	2	0	0	0	0	0	2
OG0027327	0	2	0	0	0	0	0	2
OG0027328	0	2	0	0	0	0	0	2
OG0027329	0	2	0	0	0	0	0	2
OG0027330	0	2	0	0	0	0	0	2
OG0027331	0	1	0	1	0	0	0	2
OG0027332	0	2	0	0	0	0	0	2
OG0027333	0	1	0	0	0	0	1	2
OG0027334	0	2	0	0	0	0	0	2
OG0027335	0	2	0	0	0	0	0	2
OG0027336	0	2	0	0	0	0	0	2
OG0027337	0	1	0	0	1	0	0	2
OG0027338	0	2	0	0	0	0	0	2
OG0027339	0	2	0	0	0	0	0	2
OG0027340	0	2	0	0	0	0	0	2
OG0027341	0	2	0	0	0	0	0	2
OG0027342	0	2	0	0	0	0	0	2
OG0027343	0	2	0	0	0	0	0	2
OG0027344	0	2	0	0	0	0	0	2
OG0027345	0	2	0	0	0	0	0	2
OG0027346	0	2	0	0	0	0	0	2
OG0027347	0	2	0	0	0	0	0	2
OG0027348	0	2	0	0	0	0	0	2
OG0027349	0	2	0	0	0	0	0	2
OG0027350	0	2	0	0	0	0	0	2
OG0027351	0	2	0	0	0	0	0	2
OG0027352	0	2	0	0	0	0	0	2
OG0027353	0	2	0	0	0	0	0	2
OG0027354	0	2	0	0	0	0	0	2
OG0027355	0	2	0	0	0	0	0	2
OG0027356	0	2	0	0	0	0	0	2
OG0027357	0	2	0	0	0	0	0	2
OG0027358	0	1	1	0	0	0	0	2
OG0027359	0	2	0	0	0	0	0	2
OG0027360	0	2	0	0	0	0	0	2
OG0027361	0	2	0	0	0	0	0	2
OG0027362	0	2	0	0	0	0	0	2
OG0027363	0	2	0	0	0	0	0	2
OG0027364	0	2	0	0	0	0	0	2
OG0027365	0	2	0	0	0	0	0	2
OG0027366	0	2	0	0	0	0	0	2
OG0027367	0	2	0	0	0	0	0	2
OG0027368	0	2	0	0	0	0	0	2
OG0027369	0	2	0	0	0	0	0	2
OG0027370	0	2	0	0	0	0	0	2
OG0027371	0	2	0	0	0	0	0	2
OG0027372	0	2	0	0	0	0	0	2
OG0027373	0	1	0	0	1	0	0	2
OG0027374	0	2	0	0	0	0	0	2
OG0027375	0	2	0	0	0	0	0	2
OG0027376	0	2	0	0	0	0	0	2
OG0027377	0	2	0	0	0	0	0	2
OG0027378	0	2	0	0	0	0	0	2
OG0027379	0	1	0	0	1	0	0	2
OG0027380	0	2	0	0	0	0	0	2
OG0027381	0	2	0	0	0	0	0	2
OG0027382	0	2	0	0	0	0	0	2
OG0027383	0	2	0	0	0	0	0	2
OG0027384	0	2	0	0	0	0	0	2
OG0027385	0	2	0	0	0	0	0	2
OG0027386	0	2	0	0	0	0	0	2
OG0027387	0	2	0	0	0	0	0	2
OG0027388	0	2	0	0	0	0	0	2
OG0027389	0	2	0	0	0	0	0	2
OG0027390	0	2	0	0	0	0	0	2
OG0027391	0	2	0	0	0	0	0	2
OG0027392	0	2	0	0	0	0	0	2
OG0027393	0	2	0	0	0	0	0	2
OG0027394	0	2	0	0	0	0	0	2
OG0027395	0	2	0	0	0	0	0	2
OG0027396	0	1	0	0	1	0	0	2
OG0027397	0	2	0	0	0	0	0	2
OG0027398	0	2	0	0	0	0	0	2
OG0027399	0	2	0	0	0	0	0	2
OG0027400	0	2	0	0	0	0	0	2
OG0027401	0	2	0	0	0	0	0	2
OG0027402	0	2	0	0	0	0	0	2
OG0027403	0	2	0	0	0	0	0	2
OG0027404	0	2	0	0	0	0	0	2
OG0027405	0	2	0	0	0	0	0	2
OG0027406	0	1	0	0	1	0	0	2
OG0027407	0	2	0	0	0	0	0	2
OG0027408	0	1	0	1	0	0	0	2
OG0027409	0	2	0	0	0	0	0	2
OG0027410	0	2	0	0	0	0	0	2
OG0027411	0	2	0	0	0	0	0	2
OG0027412	0	2	0	0	0	0	0	2
OG0027413	0	2	0	0	0	0	0	2
OG0027414	0	2	0	0	0	0	0	2
OG0027415	0	2	0	0	0	0	0	2
OG0027416	0	1	0	1	0	0	0	2
OG0027417	0	2	0	0	0	0	0	2
OG0027418	0	2	0	0	0	0	0	2
OG0027419	0	1	1	0	0	0	0	2
OG0027420	0	1	0	0	1	0	0	2
OG0027421	0	1	0	0	1	0	0	2
OG0027422	0	2	0	0	0	0	0	2
OG0027423	0	2	0	0	0	0	0	2
OG0027424	0	2	0	0	0	0	0	2
OG0027425	0	2	0	0	0	0	0	2
OG0027426	0	1	0	0	0	1	0	2
OG0027427	0	2	0	0	0	0	0	2
OG0027428	0	1	0	0	0	0	1	2
OG0027429	0	2	0	0	0	0	0	2
OG0027430	0	2	0	0	0	0	0	2
OG0027431	0	2	0	0	0	0	0	2
OG0027432	0	2	0	0	0	0	0	2
OG0027433	0	2	0	0	0	0	0	2
OG0027434	0	2	0	0	0	0	0	2
OG0027435	0	2	0	0	0	0	0	2
OG0027436	0	1	0	0	1	0	0	2
OG0027437	0	2	0	0	0	0	0	2
OG0027438	0	2	0	0	0	0	0	2
OG0027439	0	2	0	0	0	0	0	2
OG0027440	0	2	0	0	0	0	0	2
OG0027441	0	2	0	0	0	0	0	2
OG0027442	0	2	0	0	0	0	0	2
OG0027443	0	1	0	1	0	0	0	2
OG0027444	0	2	0	0	0	0	0	2
OG0027445	0	2	0	0	0	0	0	2
OG0027446	0	2	0	0	0	0	0	2
OG0027447	0	2	0	0	0	0	0	2
OG0027448	0	1	0	0	1	0	0	2
OG0027449	0	2	0	0	0	0	0	2
OG0027450	0	2	0	0	0	0	0	2
OG0027451	0	2	0	0	0	0	0	2
OG0027452	0	2	0	0	0	0	0	2
OG0027453	0	2	0	0	0	0	0	2
OG0027454	0	1	0	1	0	0	0	2
OG0027455	0	2	0	0	0	0	0	2
OG0027456	0	2	0	0	0	0	0	2
OG0027457	0	2	0	0	0	0	0	2
OG0027458	0	2	0	0	0	0	0	2
OG0027459	0	2	0	0	0	0	0	2
OG0027460	0	2	0	0	0	0	0	2
OG0027461	0	2	0	0	0	0	0	2
OG0027462	0	2	0	0	0	0	0	2
OG0027463	0	2	0	0	0	0	0	2
OG0027464	0	1	0	1	0	0	0	2
OG0027465	0	2	0	0	0	0	0	2
OG0027466	0	2	0	0	0	0	0	2
OG0027467	0	2	0	0	0	0	0	2
OG0027468	0	2	0	0	0	0	0	2
OG0027469	0	2	0	0	0	0	0	2
OG0027470	0	2	0	0	0	0	0	2
OG0027471	0	1	0	0	1	0	0	2
OG0027472	0	2	0	0	0	0	0	2
OG0027473	0	1	0	1	0	0	0	2
OG0027474	0	2	0	0	0	0	0	2
OG0027475	0	1	0	1	0	0	0	2
OG0027476	0	2	0	0	0	0	0	2
OG0027477	0	1	0	1	0	0	0	2
OG0027478	0	2	0	0	0	0	0	2
OG0027479	0	2	0	0	0	0	0	2
OG0027480	0	2	0	0	0	0	0	2
OG0027481	0	2	0	0	0	0	0	2
OG0027482	0	2	0	0	0	0	0	2
OG0027483	0	2	0	0	0	0	0	2
OG0027484	0	2	0	0	0	0	0	2
OG0027485	0	2	0	0	0	0	0	2
OG0027486	0	2	0	0	0	0	0	2
OG0027487	0	2	0	0	0	0	0	2
OG0027488	0	2	0	0	0	0	0	2
OG0027489	0	2	0	0	0	0	0	2
OG0027490	0	2	0	0	0	0	0	2
OG0027491	0	1	1	0	0	0	0	2
OG0027492	0	2	0	0	0	0	0	2
OG0027493	0	2	0	0	0	0	0	2
OG0027494	0	2	0	0	0	0	0	2
OG0027495	0	2	0	0	0	0	0	2
OG0027496	0	2	0	0	0	0	0	2
OG0027497	0	2	0	0	0	0	0	2
OG0027498	0	2	0	0	0	0	0	2
OG0027499	0	2	0	0	0	0	0	2
OG0027500	0	2	0	0	0	0	0	2
OG0027501	0	2	0	0	0	0	0	2
OG0027502	0	2	0	0	0	0	0	2
OG0027503	0	2	0	0	0	0	0	2
OG0027504	0	2	0	0	0	0	0	2
OG0027505	0	2	0	0	0	0	0	2
OG0027506	0	1	0	0	1	0	0	2
OG0027507	0	2	0	0	0	0	0	2
OG0027508	0	1	0	0	0	1	0	2
OG0027509	0	1	0	0	0	0	1	2
OG0027510	0	2	0	0	0	0	0	2
OG0027511	0	1	0	0	1	0	0	2
OG0027512	0	2	0	0	0	0	0	2
OG0027513	0	2	0	0	0	0	0	2
OG0027514	0	2	0	0	0	0	0	2
OG0027515	0	1	0	0	1	0	0	2
OG0027516	0	2	0	0	0	0	0	2
OG0027517	0	2	0	0	0	0	0	2
OG0027518	0	1	0	0	0	0	1	2
OG0027519	0	1	1	0	0	0	0	2
OG0027520	0	1	0	0	0	0	1	2
OG0027521	0	1	0	0	1	0	0	2
OG0027522	0	2	0	0	0	0	0	2
OG0027523	0	1	0	0	1	0	0	2
OG0027524	0	2	0	0	0	0	0	2
OG0027525	0	2	0	0	0	0	0	2
OG0027526	0	2	0	0	0	0	0	2
OG0027527	0	1	0	0	1	0	0	2
OG0027528	0	2	0	0	0	0	0	2
OG0027529	0	2	0	0	0	0	0	2
OG0027530	0	2	0	0	0	0	0	2
OG0027531	0	1	0	0	1	0	0	2
OG0027532	0	2	0	0	0	0	0	2
OG0027533	0	1	0	0	1	0	0	2
OG0027534	0	2	0	0	0	0	0	2
OG0027535	0	2	0	0	0	0	0	2
OG0027536	0	2	0	0	0	0	0	2
OG0027537	0	2	0	0	0	0	0	2
OG0027538	0	2	0	0	0	0	0	2
OG0027539	0	2	0	0	0	0	0	2
OG0027540	0	2	0	0	0	0	0	2
OG0027541	0	2	0	0	0	0	0	2
OG0027542	0	1	0	0	1	0	0	2
OG0027543	0	2	0	0	0	0	0	2
OG0027544	0	2	0	0	0	0	0	2
OG0027545	0	2	0	0	0	0	0	2
OG0027546	0	2	0	0	0	0	0	2
OG0027547	0	1	0	0	1	0	0	2
OG0027548	0	2	0	0	0	0	0	2
OG0027549	0	2	0	0	0	0	0	2
OG0027550	0	1	0	0	0	1	0	2
OG0027551	0	2	0	0	0	0	0	2
OG0027552	0	2	0	0	0	0	0	2
OG0027553	0	2	0	0	0	0	0	2
OG0027554	0	2	0	0	0	0	0	2
OG0027555	0	2	0	0	0	0	0	2
OG0027556	0	2	0	0	0	0	0	2
OG0027557	0	2	0	0	0	0	0	2
OG0027558	0	2	0	0	0	0	0	2
OG0027559	0	2	0	0	0	0	0	2
OG0027560	0	2	0	0	0	0	0	2
OG0027561	0	2	0	0	0	0	0	2
OG0027562	0	2	0	0	0	0	0	2
OG0027563	0	2	0	0	0	0	0	2
OG0027564	0	1	0	0	0	0	1	2
OG0027565	0	2	0	0	0	0	0	2
OG0027566	0	2	0	0	0	0	0	2
OG0027567	0	2	0	0	0	0	0	2
OG0027568	0	2	0	0	0	0	0	2
OG0027569	0	2	0	0	0	0	0	2
OG0027570	0	2	0	0	0	0	0	2
OG0027571	0	1	0	1	0	0	0	2
OG0027572	0	2	0	0	0	0	0	2
OG0027573	0	1	0	0	1	0	0	2
OG0027574	0	1	1	0	0	0	0	2
OG0027575	0	1	0	1	0	0	0	2
OG0027576	0	2	0	0	0	0	0	2
OG0027577	0	1	0	1	0	0	0	2
OG0027578	0	2	0	0	0	0	0	2
OG0027579	0	2	0	0	0	0	0	2
OG0027580	0	2	0	0	0	0	0	2
OG0027581	0	1	0	1	0	0	0	2
OG0027582	0	2	0	0	0	0	0	2
OG0027583	0	1	0	1	0	0	0	2
OG0027584	0	2	0	0	0	0	0	2
OG0027585	0	2	0	0	0	0	0	2
OG0027586	0	2	0	0	0	0	0	2
OG0027587	0	2	0	0	0	0	0	2
OG0027588	0	2	0	0	0	0	0	2
OG0027589	0	1	0	1	0	0	0	2
OG0027590	0	1	0	0	0	1	0	2
OG0027591	0	2	0	0	0	0	0	2
OG0027592	0	1	0	1	0	0	0	2
OG0027593	0	2	0	0	0	0	0	2
OG0027594	0	2	0	0	0	0	0	2
OG0027595	0	2	0	0	0	0	0	2
OG0027596	0	1	0	1	0	0	0	2
OG0027597	0	1	0	1	0	0	0	2
OG0027598	0	1	0	1	0	0	0	2
OG0027599	0	1	0	1	0	0	0	2
OG0027600	0	1	0	1	0	0	0	2
OG0027601	0	2	0	0	0	0	0	2
OG0027602	0	2	0	0	0	0	0	2
OG0027603	0	2	0	0	0	0	0	2
OG0027604	0	2	0	0	0	0	0	2
OG0027605	0	2	0	0	0	0	0	2
OG0027606	0	2	0	0	0	0	0	2
OG0027607	0	1	0	0	0	1	0	2
OG0027608	0	2	0	0	0	0	0	2
OG0027609	0	2	0	0	0	0	0	2
OG0027610	0	2	0	0	0	0	0	2
OG0027611	0	1	0	1	0	0	0	2
OG0027612	0	2	0	0	0	0	0	2
OG0027613	0	1	1	0	0	0	0	2
OG0027614	0	2	0	0	0	0	0	2
OG0027615	0	2	0	0	0	0	0	2
OG0027616	0	2	0	0	0	0	0	2
OG0027617	0	2	0	0	0	0	0	2
OG0027618	0	2	0	0	0	0	0	2
OG0027619	0	2	0	0	0	0	0	2
OG0027620	0	2	0	0	0	0	0	2
OG0027621	0	2	0	0	0	0	0	2
OG0027622	0	1	0	0	0	0	1	2
OG0027623	0	2	0	0	0	0	0	2
OG0027624	0	1	0	0	1	0	0	2
OG0027625	0	2	0	0	0	0	0	2
OG0027626	0	1	0	0	0	0	1	2
OG0027627	0	2	0	0	0	0	0	2
OG0027628	0	1	0	0	0	0	1	2
OG0027629	0	2	0	0	0	0	0	2
OG0027630	0	2	0	0	0	0	0	2
OG0027631	0	2	0	0	0	0	0	2
OG0027632	0	2	0	0	0	0	0	2
OG0027633	0	2	0	0	0	0	0	2
OG0027634	0	2	0	0	0	0	0	2
OG0027635	0	2	0	0	0	0	0	2
OG0027636	0	2	0	0	0	0	0	2
OG0027637	0	2	0	0	0	0	0	2
OG0027638	0	2	0	0	0	0	0	2
OG0027639	0	2	0	0	0	0	0	2
OG0027640	0	2	0	0	0	0	0	2
OG0027641	0	2	0	0	0	0	0	2
OG0027642	0	2	0	0	0	0	0	2
OG0027643	0	2	0	0	0	0	0	2
OG0027644	0	1	0	0	1	0	0	2
OG0027645	0	2	0	0	0	0	0	2
OG0027646	0	2	0	0	0	0	0	2
OG0027647	0	2	0	0	0	0	0	2
OG0027648	0	1	0	1	0	0	0	2
OG0027649	0	2	0	0	0	0	0	2
OG0027650	0	2	0	0	0	0	0	2
OG0027651	0	1	0	0	1	0	0	2
OG0027652	0	2	0	0	0	0	0	2
OG0027653	0	1	0	1	0	0	0	2
OG0027654	0	2	0	0	0	0	0	2
OG0027655	0	2	0	0	0	0	0	2
OG0027656	0	2	0	0	0	0	0	2
OG0027657	0	2	0	0	0	0	0	2
OG0027658	0	2	0	0	0	0	0	2
OG0027659	0	1	0	0	1	0	0	2
OG0027660	0	2	0	0	0	0	0	2
OG0027661	0	2	0	0	0	0	0	2
OG0027662	0	2	0	0	0	0	0	2
OG0027663	0	2	0	0	0	0	0	2
OG0027664	0	2	0	0	0	0	0	2
OG0027665	0	2	0	0	0	0	0	2
OG0027666	0	2	0	0	0	0	0	2
OG0027667	0	1	0	0	0	1	0	2
OG0027668	0	2	0	0	0	0	0	2
OG0027669	0	2	0	0	0	0	0	2
OG0027670	0	2	0	0	0	0	0	2
OG0027671	0	2	0	0	0	0	0	2
OG0027672	0	2	0	0	0	0	0	2
OG0027673	0	2	0	0	0	0	0	2
OG0027674	0	2	0	0	0	0	0	2
OG0027675	0	2	0	0	0	0	0	2
OG0027676	0	2	0	0	0	0	0	2
OG0027677	0	2	0	0	0	0	0	2
OG0027678	0	2	0	0	0	0	0	2
OG0027679	0	2	0	0	0	0	0	2
OG0027680	0	2	0	0	0	0	0	2
OG0027681	0	2	0	0	0	0	0	2
OG0027682	0	2	0	0	0	0	0	2
OG0027683	0	2	0	0	0	0	0	2
OG0027684	0	2	0	0	0	0	0	2
OG0027685	0	2	0	0	0	0	0	2
OG0027686	0	1	0	1	0	0	0	2
OG0027687	0	1	0	0	0	0	1	2
OG0027688	0	1	0	0	1	0	0	2
OG0027689	0	1	0	0	1	0	0	2
OG0027690	0	2	0	0	0	0	0	2
OG0027691	0	2	0	0	0	0	0	2
OG0027692	0	2	0	0	0	0	0	2
OG0027693	0	2	0	0	0	0	0	2
OG0027694	0	2	0	0	0	0	0	2
OG0027695	0	2	0	0	0	0	0	2
OG0027696	0	2	0	0	0	0	0	2
OG0027697	0	1	0	0	1	0	0	2
OG0027698	0	1	1	0	0	0	0	2
OG0027699	0	2	0	0	0	0	0	2
OG0027700	0	2	0	0	0	0	0	2
OG0027701	0	2	0	0	0	0	0	2
OG0027702	0	2	0	0	0	0	0	2
OG0027703	0	2	0	0	0	0	0	2
OG0027704	0	2	0	0	0	0	0	2
OG0027705	0	1	0	0	1	0	0	2
OG0027706	0	2	0	0	0	0	0	2
OG0027707	0	2	0	0	0	0	0	2
OG0027708	0	2	0	0	0	0	0	2
OG0027709	0	1	0	0	1	0	0	2
OG0027710	0	2	0	0	0	0	0	2
OG0027711	0	2	0	0	0	0	0	2
OG0027712	0	1	0	0	0	0	1	2
OG0027713	0	2	0	0	0	0	0	2
OG0027714	0	2	0	0	0	0	0	2
OG0027715	0	2	0	0	0	0	0	2
OG0027716	0	2	0	0	0	0	0	2
OG0027717	0	1	0	0	1	0	0	2
OG0027718	0	1	0	0	0	0	1	2
OG0027719	0	1	0	0	1	0	0	2
OG0027720	0	1	0	0	1	0	0	2
OG0027721	0	2	0	0	0	0	0	2
OG0027722	0	1	0	0	0	1	0	2
OG0027723	0	1	0	1	0	0	0	2
OG0027724	0	2	0	0	0	0	0	2
OG0027725	0	1	0	0	1	0	0	2
OG0027726	0	1	0	0	1	0	0	2
OG0027727	0	1	0	1	0	0	0	2
OG0027728	0	1	0	0	1	0	0	2
OG0027729	0	2	0	0	0	0	0	2
OG0027730	0	1	0	0	0	1	0	2
OG0027731	0	1	0	0	1	0	0	2
OG0027732	0	1	0	0	1	0	0	2
OG0027733	0	2	0	0	0	0	0	2
OG0027734	0	2	0	0	0	0	0	2
OG0027735	0	2	0	0	0	0	0	2
OG0027736	0	2	0	0	0	0	0	2
OG0027737	0	1	0	0	1	0	0	2
OG0027738	0	1	0	1	0	0	0	2
OG0027739	0	1	1	0	0	0	0	2
OG0027740	0	2	0	0	0	0	0	2
OG0027741	0	2	0	0	0	0	0	2
OG0027742	0	2	0	0	0	0	0	2
OG0027743	0	2	0	0	0	0	0	2
OG0027744	0	2	0	0	0	0	0	2
OG0027745	0	2	0	0	0	0	0	2
OG0027746	0	2	0	0	0	0	0	2
OG0027747	0	2	0	0	0	0	0	2
OG0027748	0	2	0	0	0	0	0	2
OG0027749	0	2	0	0	0	0	0	2
OG0027750	0	1	1	0	0	0	0	2
OG0027751	0	1	0	0	1	0	0	2
OG0027752	0	1	0	0	0	0	1	2
OG0027753	0	2	0	0	0	0	0	2
OG0027754	0	1	0	0	1	0	0	2
OG0027755	0	1	0	0	1	0	0	2
OG0027756	0	1	0	0	1	0	0	2
OG0027757	0	1	0	0	1	0	0	2
OG0027758	0	2	0	0	0	0	0	2
OG0027759	0	2	0	0	0	0	0	2
OG0027760	0	2	0	0	0	0	0	2
OG0027761	0	2	0	0	0	0	0	2
OG0027762	0	2	0	0	0	0	0	2
OG0027763	0	2	0	0	0	0	0	2
OG0027764	0	2	0	0	0	0	0	2
OG0027765	0	1	0	0	1	0	0	2
OG0027766	0	2	0	0	0	0	0	2
OG0027767	0	2	0	0	0	0	0	2
OG0027768	0	2	0	0	0	0	0	2
OG0027769	0	2	0	0	0	0	0	2
OG0027770	0	2	0	0	0	0	0	2
OG0027771	0	1	0	0	1	0	0	2
OG0027772	0	1	0	0	1	0	0	2
OG0027773	0	1	0	0	1	0	0	2
OG0027774	0	1	0	0	1	0	0	2
OG0027775	0	1	0	0	1	0	0	2
OG0027776	0	2	0	0	0	0	0	2
OG0027777	0	2	0	0	0	0	0	2
OG0027778	0	1	0	0	0	1	0	2
OG0027779	0	1	0	0	1	0	0	2
OG0027780	0	2	0	0	0	0	0	2
OG0027781	0	2	0	0	0	0	0	2
OG0027782	0	2	0	0	0	0	0	2
OG0027783	0	2	0	0	0	0	0	2
OG0027784	0	2	0	0	0	0	0	2
OG0027785	0	2	0	0	0	0	0	2
OG0027786	0	2	0	0	0	0	0	2
OG0027787	0	2	0	0	0	0	0	2
OG0027788	0	2	0	0	0	0	0	2
OG0027789	0	2	0	0	0	0	0	2
OG0027790	0	2	0	0	0	0	0	2
OG0027791	0	1	0	0	1	0	0	2
OG0027792	0	2	0	0	0	0	0	2
OG0027793	0	2	0	0	0	0	0	2
OG0027794	0	2	0	0	0	0	0	2
OG0027795	0	2	0	0	0	0	0	2
OG0027796	0	1	0	0	1	0	0	2
OG0027797	0	2	0	0	0	0	0	2
OG0027798	0	2	0	0	0	0	0	2
OG0027799	0	2	0	0	0	0	0	2
OG0027800	0	2	0	0	0	0	0	2
OG0027801	0	1	0	1	0	0	0	2
OG0027802	0	2	0	0	0	0	0	2
OG0027803	0	2	0	0	0	0	0	2
OG0027804	0	2	0	0	0	0	0	2
OG0027805	0	2	0	0	0	0	0	2
OG0027806	0	1	0	0	1	0	0	2
OG0027807	0	2	0	0	0	0	0	2
OG0027808	0	1	0	0	1	0	0	2
OG0027809	0	1	0	0	0	1	0	2
OG0027810	0	2	0	0	0	0	0	2
OG0027811	0	1	0	0	0	0	1	2
OG0027812	0	1	0	0	1	0	0	2
OG0027813	0	2	0	0	0	0	0	2
OG0027814	0	2	0	0	0	0	0	2
OG0027815	0	2	0	0	0	0	0	2
OG0027816	0	2	0	0	0	0	0	2
OG0027817	0	2	0	0	0	0	0	2
OG0027818	0	1	0	0	1	0	0	2
OG0027819	0	2	0	0	0	0	0	2
OG0027820	0	2	0	0	0	0	0	2
OG0027821	0	2	0	0	0	0	0	2
OG0027822	0	2	0	0	0	0	0	2
OG0027823	0	2	0	0	0	0	0	2
OG0027824	0	2	0	0	0	0	0	2
OG0027825	0	2	0	0	0	0	0	2
OG0027826	0	2	0	0	0	0	0	2
OG0027827	0	2	0	0	0	0	0	2
OG0027828	0	1	0	0	0	1	0	2
OG0027829	0	2	0	0	0	0	0	2
OG0027830	0	2	0	0	0	0	0	2
OG0027831	0	2	0	0	0	0	0	2
OG0027832	0	2	0	0	0	0	0	2
OG0027833	0	2	0	0	0	0	0	2
OG0027834	0	1	0	0	0	0	1	2
OG0027835	0	2	0	0	0	0	0	2
OG0027836	0	2	0	0	0	0	0	2
OG0027837	0	2	0	0	0	0	0	2
OG0027838	0	1	0	0	0	0	1	2
OG0027839	0	2	0	0	0	0	0	2
OG0027840	0	1	0	0	1	0	0	2
OG0027841	0	2	0	0	0	0	0	2
OG0027842	0	2	0	0	0	0	0	2
OG0027843	0	2	0	0	0	0	0	2
OG0027844	0	1	0	0	0	0	1	2
OG0027845	0	2	0	0	0	0	0	2
OG0027846	0	2	0	0	0	0	0	2
OG0027847	0	2	0	0	0	0	0	2
OG0027848	0	1	0	0	1	0	0	2
OG0027849	0	1	0	0	0	0	1	2
OG0027850	0	2	0	0	0	0	0	2
OG0027851	0	1	0	0	1	0	0	2
OG0027852	0	1	0	0	1	0	0	2
OG0027853	0	2	0	0	0	0	0	2
OG0027854	0	2	0	0	0	0	0	2
OG0027855	0	2	0	0	0	0	0	2
OG0027856	0	2	0	0	0	0	0	2
OG0027857	0	2	0	0	0	0	0	2
OG0027858	0	2	0	0	0	0	0	2
OG0027859	0	2	0	0	0	0	0	2
OG0027860	0	2	0	0	0	0	0	2
OG0027861	0	2	0	0	0	0	0	2
OG0027862	0	2	0	0	0	0	0	2
OG0027863	0	2	0	0	0	0	0	2
OG0027864	0	2	0	0	0	0	0	2
OG0027865	0	2	0	0	0	0	0	2
OG0027866	0	1	0	0	1	0	0	2
OG0027867	0	2	0	0	0	0	0	2
OG0027868	0	2	0	0	0	0	0	2
OG0027869	0	2	0	0	0	0	0	2
OG0027870	0	2	0	0	0	0	0	2
OG0027871	0	1	1	0	0	0	0	2
OG0027872	0	2	0	0	0	0	0	2
OG0027873	0	2	0	0	0	0	0	2
OG0027874	0	2	0	0	0	0	0	2
OG0027875	0	2	0	0	0	0	0	2
OG0027876	0	2	0	0	0	0	0	2
OG0027877	0	2	0	0	0	0	0	2
OG0027878	0	1	1	0	0	0	0	2
OG0027879	0	2	0	0	0	0	0	2
OG0027880	0	2	0	0	0	0	0	2
OG0027881	0	2	0	0	0	0	0	2
OG0027882	0	2	0	0	0	0	0	2
OG0027883	0	2	0	0	0	0	0	2
OG0027884	0	2	0	0	0	0	0	2
OG0027885	0	1	0	1	0	0	0	2
OG0027886	0	2	0	0	0	0	0	2
OG0027887	0	2	0	0	0	0	0	2
OG0027888	0	2	0	0	0	0	0	2
OG0027889	0	1	0	0	0	1	0	2
OG0027890	0	1	0	0	1	0	0	2
OG0027891	0	1	0	0	1	0	0	2
OG0027892	0	2	0	0	0	0	0	2
OG0027893	0	2	0	0	0	0	0	2
OG0027894	0	2	0	0	0	0	0	2
OG0027895	0	2	0	0	0	0	0	2
OG0027896	0	2	0	0	0	0	0	2
OG0027897	0	2	0	0	0	0	0	2
OG0027898	0	1	0	0	0	0	1	2
OG0027899	0	2	0	0	0	0	0	2
OG0027900	0	2	0	0	0	0	0	2
OG0027901	0	1	1	0	0	0	0	2
OG0027902	0	1	0	1	0	0	0	2
OG0027903	0	2	0	0	0	0	0	2
OG0027904	0	1	0	0	1	0	0	2
OG0027905	0	1	0	0	1	0	0	2
OG0027906	0	1	0	1	0	0	0	2
OG0027907	0	2	0	0	0	0	0	2
OG0027908	0	2	0	0	0	0	0	2
OG0027909	0	2	0	0	0	0	0	2
OG0027910	0	1	0	1	0	0	0	2
OG0027911	0	2	0	0	0	0	0	2
OG0027912	0	1	0	0	0	1	0	2
OG0027913	0	2	0	0	0	0	0	2
OG0027914	0	2	0	0	0	0	0	2
OG0027915	0	2	0	0	0	0	0	2
OG0027916	0	2	0	0	0	0	0	2
OG0027917	0	2	0	0	0	0	0	2
OG0027918	0	2	0	0	0	0	0	2
OG0027919	0	2	0	0	0	0	0	2
OG0027920	0	2	0	0	0	0	0	2
OG0027921	0	1	0	0	1	0	0	2
OG0027922	0	2	0	0	0	0	0	2
OG0027923	0	2	0	0	0	0	0	2
OG0027924	0	1	0	1	0	0	0	2
OG0027925	0	1	0	1	0	0	0	2
OG0027926	0	2	0	0	0	0	0	2
OG0027927	0	2	0	0	0	0	0	2
OG0027928	0	1	0	1	0	0	0	2
OG0027929	0	1	0	0	0	0	1	2
OG0027930	0	2	0	0	0	0	0	2
OG0027931	0	1	0	1	0	0	0	2
OG0027932	0	2	0	0	0	0	0	2
OG0027933	0	1	0	1	0	0	0	2
OG0027934	0	1	0	0	1	0	0	2
OG0027935	0	2	0	0	0	0	0	2
OG0027936	0	2	0	0	0	0	0	2
OG0027937	0	1	0	1	0	0	0	2
OG0027938	0	2	0	0	0	0	0	2
OG0027939	0	1	0	1	0	0	0	2
OG0027940	0	1	0	1	0	0	0	2
OG0027941	0	2	0	0	0	0	0	2
OG0027942	0	2	0	0	0	0	0	2
OG0027943	0	2	0	0	0	0	0	2
OG0027944	0	2	0	0	0	0	0	2
OG0027945	0	1	0	1	0	0	0	2
OG0027946	0	1	1	0	0	0	0	2
OG0027947	0	1	0	0	0	0	1	2
OG0027948	0	2	0	0	0	0	0	2
OG0027949	0	2	0	0	0	0	0	2
OG0027950	0	2	0	0	0	0	0	2
OG0027951	0	2	0	0	0	0	0	2
OG0027952	0	2	0	0	0	0	0	2
OG0027953	0	2	0	0	0	0	0	2
OG0027954	0	2	0	0	0	0	0	2
OG0027955	0	2	0	0	0	0	0	2
OG0027956	0	1	0	0	0	1	0	2
OG0027957	0	2	0	0	0	0	0	2
OG0027958	0	2	0	0	0	0	0	2
OG0027959	0	2	0	0	0	0	0	2
OG0027960	0	2	0	0	0	0	0	2
OG0027961	0	1	0	0	1	0	0	2
OG0027962	0	2	0	0	0	0	0	2
OG0027963	0	2	0	0	0	0	0	2
OG0027964	0	2	0	0	0	0	0	2
OG0027965	0	2	0	0	0	0	0	2
OG0027966	0	2	0	0	0	0	0	2
OG0027967	0	2	0	0	0	0	0	2
OG0027968	0	1	0	0	1	0	0	2
OG0027969	0	2	0	0	0	0	0	2
OG0027970	0	2	0	0	0	0	0	2
OG0027971	0	2	0	0	0	0	0	2
OG0027972	0	2	0	0	0	0	0	2
OG0027973	0	2	0	0	0	0	0	2
OG0027974	0	2	0	0	0	0	0	2
OG0027975	0	2	0	0	0	0	0	2
OG0027976	0	1	0	0	0	0	1	2
OG0027977	0	2	0	0	0	0	0	2
OG0027978	0	2	0	0	0	0	0	2
OG0027979	0	2	0	0	0	0	0	2
OG0027980	0	2	0	0	0	0	0	2
OG0027981	0	1	0	0	0	1	0	2
OG0027982	0	1	0	0	1	0	0	2
OG0027983	0	2	0	0	0	0	0	2
OG0027984	0	1	0	0	1	0	0	2
OG0027985	0	2	0	0	0	0	0	2
OG0027986	0	2	0	0	0	0	0	2
OG0027987	0	2	0	0	0	0	0	2
OG0027988	0	2	0	0	0	0	0	2
OG0027989	0	2	0	0	0	0	0	2
OG0027990	0	2	0	0	0	0	0	2
OG0027991	0	2	0	0	0	0	0	2
OG0027992	0	2	0	0	0	0	0	2
OG0027993	0	2	0	0	0	0	0	2
OG0027994	0	2	0	0	0	0	0	2
OG0027995	0	2	0	0	0	0	0	2
OG0027996	0	2	0	0	0	0	0	2
OG0027997	0	2	0	0	0	0	0	2
OG0027998	0	2	0	0	0	0	0	2
OG0027999	0	2	0	0	0	0	0	2
OG0028000	0	2	0	0	0	0	0	2
OG0028001	0	2	0	0	0	0	0	2
OG0028002	0	1	0	0	0	0	1	2
OG0028003	0	2	0	0	0	0	0	2
OG0028004	0	2	0	0	0	0	0	2
OG0028005	0	2	0	0	0	0	0	2
OG0028006	0	2	0	0	0	0	0	2
OG0028007	0	2	0	0	0	0	0	2
OG0028008	0	2	0	0	0	0	0	2
OG0028009	0	1	0	0	1	0	0	2
OG0028010	0	2	0	0	0	0	0	2
OG0028011	0	2	0	0	0	0	0	2
OG0028012	0	2	0	0	0	0	0	2
OG0028013	0	2	0	0	0	0	0	2
OG0028014	0	2	0	0	0	0	0	2
OG0028015	0	2	0	0	0	0	0	2
OG0028016	0	2	0	0	0	0	0	2
OG0028017	0	2	0	0	0	0	0	2
OG0028018	0	2	0	0	0	0	0	2
OG0028019	0	1	0	0	0	0	1	2
OG0028020	0	2	0	0	0	0	0	2
OG0028021	0	2	0	0	0	0	0	2
OG0028022	0	2	0	0	0	0	0	2
OG0028023	0	1	0	0	0	0	1	2
OG0028024	0	1	0	0	1	0	0	2
OG0028025	0	1	0	0	1	0	0	2
OG0028026	0	1	0	0	1	0	0	2
OG0028027	0	2	0	0	0	0	0	2
OG0028028	0	2	0	0	0	0	0	2
OG0028029	0	1	0	0	1	0	0	2
OG0028030	0	2	0	0	0	0	0	2
OG0028031	0	1	0	0	1	0	0	2
OG0028032	0	1	0	0	1	0	0	2
OG0028033	0	1	0	0	1	0	0	2
OG0028034	0	2	0	0	0	0	0	2
OG0028035	0	1	0	0	0	0	1	2
OG0028036	0	2	0	0	0	0	0	2
OG0028037	0	2	0	0	0	0	0	2
OG0028038	0	2	0	0	0	0	0	2
OG0028039	0	2	0	0	0	0	0	2
OG0028040	0	1	0	0	1	0	0	2
OG0028041	0	2	0	0	0	0	0	2
OG0028042	0	2	0	0	0	0	0	2
OG0028043	0	1	0	0	1	0	0	2
OG0028044	0	2	0	0	0	0	0	2
OG0028045	0	2	0	0	0	0	0	2
OG0028046	0	2	0	0	0	0	0	2
OG0028047	0	2	0	0	0	0	0	2
OG0028048	0	2	0	0	0	0	0	2
OG0028049	0	2	0	0	0	0	0	2
OG0028050	0	2	0	0	0	0	0	2
OG0028051	0	2	0	0	0	0	0	2
OG0028052	0	2	0	0	0	0	0	2
OG0028053	0	2	0	0	0	0	0	2
OG0028054	0	2	0	0	0	0	0	2
OG0028055	0	1	0	0	1	0	0	2
OG0028056	0	2	0	0	0	0	0	2
OG0028057	0	2	0	0	0	0	0	2
OG0028058	0	1	0	0	1	0	0	2
OG0028059	0	2	0	0	0	0	0	2
OG0028060	0	2	0	0	0	0	0	2
OG0028061	0	2	0	0	0	0	0	2
OG0028062	0	2	0	0	0	0	0	2
OG0028063	0	2	0	0	0	0	0	2
OG0028064	0	1	0	0	1	0	0	2
OG0028065	0	1	0	0	1	0	0	2
OG0028066	0	2	0	0	0	0	0	2
OG0028067	0	1	0	0	0	0	1	2
OG0028068	0	1	1	0	0	0	0	2
OG0028069	0	2	0	0	0	0	0	2
OG0028070	0	1	0	0	0	0	1	2
OG0028071	0	2	0	0	0	0	0	2
OG0028072	0	2	0	0	0	0	0	2
OG0028073	0	1	0	0	1	0	0	2
OG0028074	0	1	0	0	1	0	0	2
OG0028075	0	2	0	0	0	0	0	2
OG0028076	0	2	0	0	0	0	0	2
OG0028077	0	1	0	0	1	0	0	2
OG0028078	0	2	0	0	0	0	0	2
OG0028079	0	1	1	0	0	0	0	2
OG0028080	0	2	0	0	0	0	0	2
OG0028081	0	2	0	0	0	0	0	2
OG0028082	0	2	0	0	0	0	0	2
OG0028083	0	2	0	0	0	0	0	2
OG0028084	0	2	0	0	0	0	0	2
OG0028085	0	2	0	0	0	0	0	2
OG0028086	0	1	0	0	1	0	0	2
OG0028087	0	1	0	0	0	0	1	2
OG0028088	0	1	1	0	0	0	0	2
OG0028089	0	1	0	0	1	0	0	2
OG0028090	0	2	0	0	0	0	0	2
OG0028091	0	2	0	0	0	0	0	2
OG0028092	0	2	0	0	0	0	0	2
OG0028093	0	2	0	0	0	0	0	2
OG0028094	0	1	0	0	1	0	0	2
OG0028095	0	2	0	0	0	0	0	2
OG0028096	0	2	0	0	0	0	0	2
OG0028097	0	2	0	0	0	0	0	2
OG0028098	0	2	0	0	0	0	0	2
OG0028099	0	2	0	0	0	0	0	2
OG0028100	0	2	0	0	0	0	0	2
OG0028101	0	2	0	0	0	0	0	2
OG0028102	0	2	0	0	0	0	0	2
OG0028103	0	2	0	0	0	0	0	2
OG0028104	0	1	0	0	1	0	0	2
OG0028105	0	1	0	0	1	0	0	2
OG0028106	0	2	0	0	0	0	0	2
OG0028107	0	1	0	0	1	0	0	2
OG0028108	0	2	0	0	0	0	0	2
OG0028109	0	2	0	0	0	0	0	2
OG0028110	0	1	0	1	0	0	0	2
OG0028111	0	2	0	0	0	0	0	2
OG0028112	0	2	0	0	0	0	0	2
OG0028113	0	1	0	0	1	0	0	2
OG0028114	0	2	0	0	0	0	0	2
OG0028115	0	2	0	0	0	0	0	2
OG0028116	0	2	0	0	0	0	0	2
OG0028117	0	2	0	0	0	0	0	2
OG0028118	0	1	0	0	0	1	0	2
OG0028119	0	2	0	0	0	0	0	2
OG0028120	0	2	0	0	0	0	0	2
OG0028121	0	1	0	0	1	0	0	2
OG0028122	0	2	0	0	0	0	0	2
OG0028123	0	2	0	0	0	0	0	2
OG0028124	0	2	0	0	0	0	0	2
OG0028125	0	1	0	0	1	0	0	2
OG0028126	0	1	0	0	1	0	0	2
OG0028127	0	2	0	0	0	0	0	2
OG0028128	0	2	0	0	0	0	0	2
OG0028129	0	2	0	0	0	0	0	2
OG0028130	0	1	0	0	1	0	0	2
OG0028131	0	2	0	0	0	0	0	2
OG0028132	0	2	0	0	0	0	0	2
OG0028133	0	1	0	0	0	0	1	2
OG0028134	0	2	0	0	0	0	0	2
OG0028135	0	2	0	0	0	0	0	2
OG0028136	0	2	0	0	0	0	0	2
OG0028137	0	2	0	0	0	0	0	2
OG0028138	0	1	0	0	0	0	1	2
OG0028139	0	2	0	0	0	0	0	2
OG0028140	0	2	0	0	0	0	0	2
OG0028141	0	2	0	0	0	0	0	2
OG0028142	0	2	0	0	0	0	0	2
OG0028143	0	2	0	0	0	0	0	2
OG0028144	0	2	0	0	0	0	0	2
OG0028145	0	2	0	0	0	0	0	2
OG0028146	0	2	0	0	0	0	0	2
OG0028147	0	2	0	0	0	0	0	2
OG0028148	0	2	0	0	0	0	0	2
OG0028149	0	2	0	0	0	0	0	2
OG0028150	0	1	0	0	0	0	1	2
OG0028151	0	2	0	0	0	0	0	2
OG0028152	0	2	0	0	0	0	0	2
OG0028153	0	2	0	0	0	0	0	2
OG0028154	0	2	0	0	0	0	0	2
OG0028155	0	2	0	0	0	0	0	2
OG0028156	0	2	0	0	0	0	0	2
OG0028157	0	2	0	0	0	0	0	2
OG0028158	0	2	0	0	0	0	0	2
OG0028159	0	2	0	0	0	0	0	2
OG0028160	0	2	0	0	0	0	0	2
OG0028161	0	2	0	0	0	0	0	2
OG0028162	0	2	0	0	0	0	0	2
OG0028163	0	2	0	0	0	0	0	2
OG0028164	0	2	0	0	0	0	0	2
OG0028165	0	1	0	1	0	0	0	2
OG0028166	0	2	0	0	0	0	0	2
OG0028167	0	2	0	0	0	0	0	2
OG0028168	0	2	0	0	0	0	0	2
OG0028169	0	2	0	0	0	0	0	2
OG0028170	0	2	0	0	0	0	0	2
OG0028171	0	2	0	0	0	0	0	2
OG0028172	0	1	0	1	0	0	0	2
OG0028173	0	2	0	0	0	0	0	2
OG0028174	0	1	1	0	0	0	0	2
OG0028175	0	1	0	0	0	1	0	2
OG0028176	0	2	0	0	0	0	0	2
OG0028177	0	2	0	0	0	0	0	2
OG0028178	0	2	0	0	0	0	0	2
OG0028179	0	2	0	0	0	0	0	2
OG0028180	0	2	0	0	0	0	0	2
OG0028181	0	2	0	0	0	0	0	2
OG0028182	0	2	0	0	0	0	0	2
OG0028183	0	2	0	0	0	0	0	2
OG0028184	0	2	0	0	0	0	0	2
OG0028185	0	2	0	0	0	0	0	2
OG0028186	0	2	0	0	0	0	0	2
OG0028187	0	2	0	0	0	0	0	2
OG0028188	0	2	0	0	0	0	0	2
OG0028189	0	2	0	0	0	0	0	2
OG0028190	0	2	0	0	0	0	0	2
OG0028191	0	2	0	0	0	0	0	2
OG0028192	0	2	0	0	0	0	0	2
OG0028193	0	1	0	1	0	0	0	2
OG0028194	0	2	0	0	0	0	0	2
OG0028195	0	1	0	1	0	0	0	2
OG0028196	0	1	0	1	0	0	0	2
OG0028197	0	1	0	1	0	0	0	2
OG0028198	0	2	0	0	0	0	0	2
OG0028199	0	1	0	1	0	0	0	2
OG0028200	0	2	0	0	0	0	0	2
OG0028201	0	2	0	0	0	0	0	2
OG0028202	0	1	0	1	0	0	0	2
OG0028203	0	2	0	0	0	0	0	2
OG0028204	0	2	0	0	0	0	0	2
OG0028205	0	2	0	0	0	0	0	2
OG0028206	0	1	0	0	0	0	1	2
OG0028207	0	2	0	0	0	0	0	2
OG0028208	0	1	0	0	1	0	0	2
OG0028209	0	2	0	0	0	0	0	2
OG0028210	0	2	0	0	0	0	0	2
OG0028211	0	2	0	0	0	0	0	2
OG0028212	0	2	0	0	0	0	0	2
OG0028213	0	2	0	0	0	0	0	2
OG0028214	0	2	0	0	0	0	0	2
OG0028215	0	2	0	0	0	0	0	2
OG0028216	0	1	0	0	0	0	1	2
OG0028217	0	2	0	0	0	0	0	2
OG0028218	0	1	0	0	1	0	0	2
OG0028219	0	2	0	0	0	0	0	2
OG0028220	0	2	0	0	0	0	0	2
OG0028221	0	2	0	0	0	0	0	2
OG0028222	0	2	0	0	0	0	0	2
OG0028223	0	2	0	0	0	0	0	2
OG0028224	0	2	0	0	0	0	0	2
OG0028225	0	1	0	0	1	0	0	2
OG0028226	0	2	0	0	0	0	0	2
OG0028227	0	1	0	1	0	0	0	2
OG0028228	0	2	0	0	0	0	0	2
OG0028229	0	2	0	0	0	0	0	2
OG0028230	0	2	0	0	0	0	0	2
OG0028231	0	1	0	0	1	0	0	2
OG0028232	0	2	0	0	0	0	0	2
OG0028233	0	2	0	0	0	0	0	2
OG0028234	0	2	0	0	0	0	0	2
OG0028235	0	2	0	0	0	0	0	2
OG0028236	0	1	1	0	0	0	0	2
OG0028237	0	2	0	0	0	0	0	2
OG0028238	0	2	0	0	0	0	0	2
OG0028239	0	2	0	0	0	0	0	2
OG0028240	0	2	0	0	0	0	0	2
OG0028241	0	2	0	0	0	0	0	2
OG0028242	0	1	0	0	0	1	0	2
OG0028243	0	2	0	0	0	0	0	2
OG0028244	0	2	0	0	0	0	0	2
OG0028245	0	2	0	0	0	0	0	2
OG0028246	0	2	0	0	0	0	0	2
OG0028247	0	2	0	0	0	0	0	2
OG0028248	0	2	0	0	0	0	0	2
OG0028249	0	2	0	0	0	0	0	2
OG0028250	0	2	0	0	0	0	0	2
OG0028251	0	2	0	0	0	0	0	2
OG0028252	0	2	0	0	0	0	0	2
OG0028253	0	2	0	0	0	0	0	2
OG0028254	0	1	0	0	1	0	0	2
OG0028255	0	2	0	0	0	0	0	2
OG0028256	0	2	0	0	0	0	0	2
OG0028257	0	2	0	0	0	0	0	2
OG0028258	0	2	0	0	0	0	0	2
OG0028259	0	2	0	0	0	0	0	2
OG0028260	0	2	0	0	0	0	0	2
OG0028261	0	2	0	0	0	0	0	2
OG0028262	0	2	0	0	0	0	0	2
OG0028263	0	2	0	0	0	0	0	2
OG0028264	0	2	0	0	0	0	0	2
OG0028265	0	1	0	1	0	0	0	2
OG0028266	0	2	0	0	0	0	0	2
OG0028267	0	2	0	0	0	0	0	2
OG0028268	0	2	0	0	0	0	0	2
OG0028269	0	1	0	1	0	0	0	2
OG0028270	0	2	0	0	0	0	0	2
OG0028271	0	2	0	0	0	0	0	2
OG0028272	0	2	0	0	0	0	0	2
OG0028273	0	2	0	0	0	0	0	2
OG0028274	0	2	0	0	0	0	0	2
OG0028275	0	2	0	0	0	0	0	2
OG0028276	0	2	0	0	0	0	0	2
OG0028277	0	2	0	0	0	0	0	2
OG0028278	0	2	0	0	0	0	0	2
OG0028279	0	2	0	0	0	0	0	2
OG0028280	0	2	0	0	0	0	0	2
OG0028281	0	1	0	1	0	0	0	2
OG0028282	0	2	0	0	0	0	0	2
OG0028283	0	2	0	0	0	0	0	2
OG0028284	0	2	0	0	0	0	0	2
OG0028285	0	2	0	0	0	0	0	2
OG0028286	0	1	0	0	1	0	0	2
OG0028287	0	1	0	0	0	0	1	2
OG0028288	0	2	0	0	0	0	0	2
OG0028289	0	1	0	0	1	0	0	2
OG0028290	0	1	0	0	0	0	1	2
OG0028291	0	2	0	0	0	0	0	2
OG0028292	0	1	0	1	0	0	0	2
OG0028293	0	2	0	0	0	0	0	2
OG0028294	0	2	0	0	0	0	0	2
OG0028295	0	1	0	0	1	0	0	2
OG0028296	0	1	0	0	1	0	0	2
OG0028297	0	2	0	0	0	0	0	2
OG0028298	0	1	0	0	1	0	0	2
OG0028299	0	2	0	0	0	0	0	2
OG0028300	0	2	0	0	0	0	0	2
OG0028301	0	1	0	0	1	0	0	2
OG0028302	0	1	0	0	1	0	0	2
OG0028303	0	1	0	0	1	0	0	2
OG0028304	0	1	0	0	1	0	0	2
OG0028305	0	1	0	0	1	0	0	2
OG0028306	0	1	0	0	1	0	0	2
OG0028307	0	2	0	0	0	0	0	2
OG0028308	0	2	0	0	0	0	0	2
OG0028309	0	2	0	0	0	0	0	2
OG0028310	0	2	0	0	0	0	0	2
OG0028311	0	2	0	0	0	0	0	2
OG0028312	0	1	1	0	0	0	0	2
OG0028313	0	2	0	0	0	0	0	2
OG0028314	0	1	0	1	0	0	0	2
OG0028315	0	2	0	0	0	0	0	2
OG0028316	0	1	0	0	1	0	0	2
OG0028317	0	2	0	0	0	0	0	2
OG0028318	0	1	1	0	0	0	0	2
OG0028319	0	2	0	0	0	0	0	2
OG0028320	0	2	0	0	0	0	0	2
OG0028321	0	2	0	0	0	0	0	2
OG0028322	0	2	0	0	0	0	0	2
OG0028323	0	2	0	0	0	0	0	2
OG0028324	0	2	0	0	0	0	0	2
OG0028325	0	2	0	0	0	0	0	2
OG0028326	0	2	0	0	0	0	0	2
OG0028327	0	1	0	0	0	1	0	2
OG0028328	0	2	0	0	0	0	0	2
OG0028329	0	2	0	0	0	0	0	2
OG0028330	0	2	0	0	0	0	0	2
OG0028331	0	2	0	0	0	0	0	2
OG0028332	0	2	0	0	0	0	0	2
OG0028333	0	2	0	0	0	0	0	2
OG0028334	0	2	0	0	0	0	0	2
OG0028335	0	2	0	0	0	0	0	2
OG0028336	0	2	0	0	0	0	0	2
OG0028337	0	2	0	0	0	0	0	2
OG0028338	0	1	0	0	0	1	0	2
OG0028339	0	2	0	0	0	0	0	2
OG0028340	0	2	0	0	0	0	0	2
OG0028341	0	2	0	0	0	0	0	2
OG0028342	0	2	0	0	0	0	0	2
OG0028343	0	1	0	1	0	0	0	2
OG0028344	0	2	0	0	0	0	0	2
OG0028345	0	1	0	0	0	0	1	2
OG0028346	0	2	0	0	0	0	0	2
OG0028347	0	2	0	0	0	0	0	2
OG0028348	0	2	0	0	0	0	0	2
OG0028349	0	1	0	1	0	0	0	2
OG0028350	0	1	1	0	0	0	0	2
OG0028351	0	1	0	1	0	0	0	2
OG0028352	0	2	0	0	0	0	0	2
OG0028353	0	1	0	1	0	0	0	2
OG0028354	0	2	0	0	0	0	0	2
OG0028355	0	2	0	0	0	0	0	2
OG0028356	0	2	0	0	0	0	0	2
OG0028357	0	2	0	0	0	0	0	2
OG0028358	0	2	0	0	0	0	0	2
OG0028359	0	2	0	0	0	0	0	2
OG0028360	0	2	0	0	0	0	0	2
OG0028361	0	1	0	1	0	0	0	2
OG0028362	0	1	0	1	0	0	0	2
OG0028363	0	1	0	1	0	0	0	2
OG0028364	0	2	0	0	0	0	0	2
OG0028365	0	2	0	0	0	0	0	2
OG0028366	0	2	0	0	0	0	0	2
OG0028367	0	2	0	0	0	0	0	2
OG0028368	0	1	0	0	0	0	1	2
OG0028369	0	2	0	0	0	0	0	2
OG0028370	0	2	0	0	0	0	0	2
OG0028371	0	1	0	0	0	0	1	2
OG0028372	0	2	0	0	0	0	0	2
OG0028373	0	2	0	0	0	0	0	2
OG0028374	0	2	0	0	0	0	0	2
OG0028375	0	2	0	0	0	0	0	2
OG0028376	0	2	0	0	0	0	0	2
OG0028377	0	2	0	0	0	0	0	2
OG0028378	0	2	0	0	0	0	0	2
OG0028379	0	1	0	0	0	0	1	2
OG0028380	0	2	0	0	0	0	0	2
OG0028381	0	2	0	0	0	0	0	2
OG0028382	0	2	0	0	0	0	0	2
OG0028383	0	2	0	0	0	0	0	2
OG0028384	0	2	0	0	0	0	0	2
OG0028385	0	2	0	0	0	0	0	2
OG0028386	0	2	0	0	0	0	0	2
OG0028387	0	2	0	0	0	0	0	2
OG0028388	0	2	0	0	0	0	0	2
OG0028389	0	2	0	0	0	0	0	2
OG0028390	0	2	0	0	0	0	0	2
OG0028391	0	2	0	0	0	0	0	2
OG0028392	0	1	0	0	0	0	1	2
OG0028393	0	1	1	0	0	0	0	2
OG0028394	0	2	0	0	0	0	0	2
OG0028395	0	2	0	0	0	0	0	2
OG0028396	0	2	0	0	0	0	0	2
OG0028397	0	2	0	0	0	0	0	2
OG0028398	0	2	0	0	0	0	0	2
OG0028399	0	2	0	0	0	0	0	2
OG0028400	0	1	0	1	0	0	0	2
OG0028401	0	1	0	1	0	0	0	2
OG0028402	0	2	0	0	0	0	0	2
OG0028403	0	2	0	0	0	0	0	2
OG0028404	0	2	0	0	0	0	0	2
OG0028405	0	2	0	0	0	0	0	2
OG0028406	0	1	0	0	0	1	0	2
OG0028407	0	2	0	0	0	0	0	2
OG0028408	0	2	0	0	0	0	0	2
OG0028409	0	2	0	0	0	0	0	2
OG0028410	0	2	0	0	0	0	0	2
OG0028411	0	1	0	0	0	0	1	2
OG0028412	0	2	0	0	0	0	0	2
OG0028413	0	2	0	0	0	0	0	2
OG0028414	0	2	0	0	0	0	0	2
OG0028415	0	2	0	0	0	0	0	2
OG0028416	0	2	0	0	0	0	0	2
OG0028417	0	2	0	0	0	0	0	2
OG0028418	0	1	0	1	0	0	0	2
OG0028419	0	2	0	0	0	0	0	2
OG0028420	0	1	0	1	0	0	0	2
OG0028421	0	2	0	0	0	0	0	2
OG0028422	0	2	0	0	0	0	0	2
OG0028423	0	2	0	0	0	0	0	2
OG0028424	0	2	0	0	0	0	0	2
OG0028425	0	2	0	0	0	0	0	2
OG0028426	0	2	0	0	0	0	0	2
OG0028427	0	2	0	0	0	0	0	2
OG0028428	0	2	0	0	0	0	0	2
OG0028429	0	2	0	0	0	0	0	2
OG0028430	0	2	0	0	0	0	0	2
OG0028431	0	2	0	0	0	0	0	2
OG0028432	0	2	0	0	0	0	0	2
OG0028433	0	1	0	1	0	0	0	2
OG0028434	0	1	0	0	0	1	0	2
OG0028435	0	1	0	0	0	1	0	2
OG0028436	0	2	0	0	0	0	0	2
OG0028437	0	2	0	0	0	0	0	2
OG0028438	0	2	0	0	0	0	0	2
OG0028439	0	2	0	0	0	0	0	2
OG0028440	0	2	0	0	0	0	0	2
OG0028441	0	2	0	0	0	0	0	2
OG0028442	0	2	0	0	0	0	0	2
OG0028443	0	2	0	0	0	0	0	2
OG0028444	0	1	0	0	1	0	0	2
OG0028445	0	1	0	0	1	0	0	2
OG0028446	0	1	0	0	1	0	0	2
OG0028447	0	2	0	0	0	0	0	2
OG0028448	0	1	0	0	1	0	0	2
OG0028449	0	1	0	0	1	0	0	2
OG0028450	0	1	0	0	1	0	0	2
OG0028451	0	2	0	0	0	0	0	2
OG0028452	0	1	1	0	0	0	0	2
OG0028453	0	1	0	0	1	0	0	2
OG0028454	0	1	0	0	1	0	0	2
OG0028455	0	1	0	1	0	0	0	2
OG0028456	0	1	0	0	1	0	0	2
OG0028457	0	2	0	0	0	0	0	2
OG0028458	0	1	0	0	1	0	0	2
OG0028459	0	1	0	0	1	0	0	2
OG0028460	0	1	0	0	1	0	0	2
OG0028461	0	1	0	0	1	0	0	2
OG0028462	0	2	0	0	0	0	0	2
OG0028463	0	2	0	0	0	0	0	2
OG0028464	0	1	0	1	0	0	0	2
OG0028465	0	2	0	0	0	0	0	2
OG0028466	0	1	0	0	1	0	0	2
OG0028467	0	1	0	0	1	0	0	2
OG0028468	0	1	0	0	1	0	0	2
OG0028469	0	2	0	0	0	0	0	2
OG0028470	0	2	0	0	0	0	0	2
OG0028471	0	2	0	0	0	0	0	2
OG0028472	0	2	0	0	0	0	0	2
OG0028473	0	2	0	0	0	0	0	2
OG0028474	0	2	0	0	0	0	0	2
OG0028475	0	2	0	0	0	0	0	2
OG0028476	0	2	0	0	0	0	0	2
OG0028477	0	2	0	0	0	0	0	2
OG0028478	0	2	0	0	0	0	0	2
OG0028479	0	1	0	0	0	0	1	2
OG0028480	0	1	0	0	1	0	0	2
OG0028481	0	1	0	0	1	0	0	2
OG0028482	0	1	0	0	0	0	1	2
OG0028483	0	2	0	0	0	0	0	2
OG0028484	0	1	0	0	0	0	1	2
OG0028485	0	2	0	0	0	0	0	2
OG0028486	0	2	0	0	0	0	0	2
OG0028487	0	2	0	0	0	0	0	2
OG0028488	0	2	0	0	0	0	0	2
OG0028489	0	1	0	0	1	0	0	2
OG0028490	0	1	0	0	1	0	0	2
OG0028491	0	1	0	0	1	0	0	2
OG0028492	0	2	0	0	0	0	0	2
OG0028493	0	2	0	0	0	0	0	2
OG0028494	0	2	0	0	0	0	0	2
OG0028495	0	1	0	0	1	0	0	2
OG0028496	0	2	0	0	0	0	0	2
OG0028497	0	2	0	0	0	0	0	2
OG0028498	0	2	0	0	0	0	0	2
OG0028499	0	2	0	0	0	0	0	2
OG0028500	0	2	0	0	0	0	0	2
OG0028501	0	2	0	0	0	0	0	2
OG0028502	0	1	0	1	0	0	0	2
OG0028503	0	2	0	0	0	0	0	2
OG0028504	0	2	0	0	0	0	0	2
OG0028505	0	2	0	0	0	0	0	2
OG0028506	0	2	0	0	0	0	0	2
OG0028507	0	2	0	0	0	0	0	2
OG0028508	0	2	0	0	0	0	0	2
OG0028509	0	2	0	0	0	0	0	2
OG0028510	0	2	0	0	0	0	0	2
OG0028511	0	2	0	0	0	0	0	2
OG0028512	0	2	0	0	0	0	0	2
OG0028513	0	2	0	0	0	0	0	2
OG0028514	0	2	0	0	0	0	0	2
OG0028515	0	2	0	0	0	0	0	2
OG0028516	0	2	0	0	0	0	0	2
OG0028517	0	2	0	0	0	0	0	2
OG0028518	0	2	0	0	0	0	0	2
OG0028519	0	2	0	0	0	0	0	2
OG0028520	0	2	0	0	0	0	0	2
OG0028521	0	2	0	0	0	0	0	2
OG0028522	0	2	0	0	0	0	0	2
OG0028523	0	2	0	0	0	0	0	2
OG0028524	0	2	0	0	0	0	0	2
OG0028525	0	2	0	0	0	0	0	2
OG0028526	0	2	0	0	0	0	0	2
OG0028527	0	2	0	0	0	0	0	2
OG0028528	0	2	0	0	0	0	0	2
OG0028529	0	2	0	0	0	0	0	2
OG0028530	0	2	0	0	0	0	0	2
OG0028531	0	2	0	0	0	0	0	2
OG0028532	0	2	0	0	0	0	0	2
OG0028533	0	1	1	0	0	0	0	2
OG0028534	0	1	0	0	0	0	1	2
OG0028535	0	2	0	0	0	0	0	2
OG0028536	0	1	0	0	1	0	0	2
OG0028537	0	2	0	0	0	0	0	2
OG0028538	0	2	0	0	0	0	0	2
OG0028539	0	2	0	0	0	0	0	2
OG0028540	0	2	0	0	0	0	0	2
OG0028541	0	2	0	0	0	0	0	2
OG0028542	0	2	0	0	0	0	0	2
OG0028543	0	2	0	0	0	0	0	2
OG0028544	0	2	0	0	0	0	0	2
OG0028545	0	2	0	0	0	0	0	2
OG0028546	0	2	0	0	0	0	0	2
OG0028547	0	2	0	0	0	0	0	2
OG0028548	0	2	0	0	0	0	0	2
OG0028549	0	2	0	0	0	0	0	2
OG0028550	0	2	0	0	0	0	0	2
OG0028551	0	2	0	0	0	0	0	2
OG0028552	0	2	0	0	0	0	0	2
OG0028553	0	2	0	0	0	0	0	2
OG0028554	0	2	0	0	0	0	0	2
OG0028555	0	2	0	0	0	0	0	2
OG0028556	0	2	0	0	0	0	0	2
OG0028557	0	2	0	0	0	0	0	2
OG0028558	0	1	1	0	0	0	0	2
OG0028559	0	2	0	0	0	0	0	2
OG0028560	0	2	0	0	0	0	0	2
OG0028561	0	2	0	0	0	0	0	2
OG0028562	0	2	0	0	0	0	0	2
OG0028563	0	2	0	0	0	0	0	2
OG0028564	0	2	0	0	0	0	0	2
OG0028565	0	2	0	0	0	0	0	2
OG0028566	0	2	0	0	0	0	0	2
OG0028567	0	1	0	1	0	0	0	2
OG0028568	0	2	0	0	0	0	0	2
OG0028569	0	2	0	0	0	0	0	2
OG0028570	0	2	0	0	0	0	0	2
OG0028571	0	2	0	0	0	0	0	2
OG0028572	0	2	0	0	0	0	0	2
OG0028573	0	2	0	0	0	0	0	2
OG0028574	0	2	0	0	0	0	0	2
OG0028575	0	2	0	0	0	0	0	2
OG0028576	0	2	0	0	0	0	0	2
OG0028577	0	2	0	0	0	0	0	2
OG0028578	0	2	0	0	0	0	0	2
OG0028579	0	2	0	0	0	0	0	2
OG0028580	0	2	0	0	0	0	0	2
OG0028581	0	2	0	0	0	0	0	2
OG0028582	0	2	0	0	0	0	0	2
OG0028583	0	2	0	0	0	0	0	2
OG0028584	0	2	0	0	0	0	0	2
OG0028585	0	2	0	0	0	0	0	2
OG0028586	0	2	0	0	0	0	0	2
OG0028587	0	1	0	1	0	0	0	2
OG0028588	0	2	0	0	0	0	0	2
OG0028589	0	2	0	0	0	0	0	2
OG0028590	0	1	0	0	0	1	0	2
OG0028591	0	2	0	0	0	0	0	2
OG0028592	0	2	0	0	0	0	0	2
OG0028593	0	2	0	0	0	0	0	2
OG0028594	0	2	0	0	0	0	0	2
OG0028595	0	2	0	0	0	0	0	2
OG0028596	0	1	0	0	0	0	1	2
OG0028597	0	1	0	1	0	0	0	2
OG0028598	0	2	0	0	0	0	0	2
OG0028599	0	2	0	0	0	0	0	2
OG0028600	0	2	0	0	0	0	0	2
OG0028601	0	2	0	0	0	0	0	2
OG0028602	0	2	0	0	0	0	0	2
OG0028603	0	2	0	0	0	0	0	2
OG0028604	0	2	0	0	0	0	0	2
OG0028605	0	1	0	1	0	0	0	2
OG0028606	0	1	0	1	0	0	0	2
OG0028607	0	2	0	0	0	0	0	2
OG0028608	0	2	0	0	0	0	0	2
OG0028609	0	2	0	0	0	0	0	2
OG0028610	0	2	0	0	0	0	0	2
OG0028611	0	2	0	0	0	0	0	2
OG0028612	0	2	0	0	0	0	0	2
OG0028613	0	1	0	0	0	0	1	2
OG0028614	0	2	0	0	0	0	0	2
OG0028615	0	2	0	0	0	0	0	2
OG0028616	0	1	0	0	1	0	0	2
OG0028617	0	2	0	0	0	0	0	2
OG0028618	0	1	0	1	0	0	0	2
OG0028619	0	2	0	0	0	0	0	2
OG0028620	0	2	0	0	0	0	0	2
OG0028621	0	1	0	0	0	0	1	2
OG0028622	0	1	0	1	0	0	0	2
OG0028623	0	2	0	0	0	0	0	2
OG0028624	0	2	0	0	0	0	0	2
OG0028625	0	2	0	0	0	0	0	2
OG0028626	0	2	0	0	0	0	0	2
OG0028627	0	1	0	1	0	0	0	2
OG0028628	0	1	0	1	0	0	0	2
OG0028629	0	1	0	1	0	0	0	2
OG0028630	0	2	0	0	0	0	0	2
OG0028631	0	2	0	0	0	0	0	2
OG0028632	0	2	0	0	0	0	0	2
OG0028633	0	2	0	0	0	0	0	2
OG0028634	0	2	0	0	0	0	0	2
OG0028635	0	1	0	1	0	0	0	2
OG0028636	0	1	0	1	0	0	0	2
OG0028637	0	1	1	0	0	0	0	2
OG0028638	0	1	0	1	0	0	0	2
OG0028639	0	1	0	1	0	0	0	2
OG0028640	0	1	0	0	0	0	1	2
OG0028641	0	1	0	0	1	0	0	2
OG0028642	0	2	0	0	0	0	0	2
OG0028643	0	2	0	0	0	0	0	2
OG0028644	0	2	0	0	0	0	0	2
OG0028645	0	2	0	0	0	0	0	2
OG0028646	0	2	0	0	0	0	0	2
OG0028647	0	2	0	0	0	0	0	2
OG0028648	0	2	0	0	0	0	0	2
OG0028649	0	2	0	0	0	0	0	2
OG0028650	0	2	0	0	0	0	0	2
OG0028651	0	2	0	0	0	0	0	2
OG0028652	0	2	0	0	0	0	0	2
OG0028653	0	2	0	0	0	0	0	2
OG0028654	0	2	0	0	0	0	0	2
OG0028655	0	2	0	0	0	0	0	2
OG0028656	0	1	0	0	0	0	1	2
OG0028657	0	2	0	0	0	0	0	2
OG0028658	0	2	0	0	0	0	0	2
OG0028659	0	2	0	0	0	0	0	2
OG0028660	0	2	0	0	0	0	0	2
OG0028661	0	2	0	0	0	0	0	2
OG0028662	0	2	0	0	0	0	0	2
OG0028663	0	1	0	0	0	0	1	2
OG0028664	0	2	0	0	0	0	0	2
OG0028665	0	2	0	0	0	0	0	2
OG0028666	0	2	0	0	0	0	0	2
OG0028667	0	1	1	0	0	0	0	2
OG0028668	0	2	0	0	0	0	0	2
OG0028669	0	2	0	0	0	0	0	2
OG0028670	0	1	0	0	0	0	1	2
OG0028671	0	2	0	0	0	0	0	2
OG0028672	0	2	0	0	0	0	0	2
OG0028673	0	2	0	0	0	0	0	2
OG0028674	0	2	0	0	0	0	0	2
OG0028675	0	2	0	0	0	0	0	2
OG0028676	0	1	0	1	0	0	0	2
OG0028677	0	1	1	0	0	0	0	2
OG0028678	0	2	0	0	0	0	0	2
OG0028679	0	2	0	0	0	0	0	2
OG0028680	0	1	0	0	0	1	0	2
OG0028681	0	1	0	1	0	0	0	2
OG0028682	0	2	0	0	0	0	0	2
OG0028683	0	2	0	0	0	0	0	2
OG0028684	0	2	0	0	0	0	0	2
OG0028685	0	2	0	0	0	0	0	2
OG0028686	0	2	0	0	0	0	0	2
OG0028687	0	1	0	1	0	0	0	2
OG0028688	0	1	0	1	0	0	0	2
OG0028689	0	2	0	0	0	0	0	2
OG0028690	0	2	0	0	0	0	0	2
OG0028691	0	1	0	0	1	0	0	2
OG0028692	0	1	0	0	1	0	0	2
OG0028693	0	2	0	0	0	0	0	2
OG0028694	0	2	0	0	0	0	0	2
OG0028695	0	2	0	0	0	0	0	2
OG0028696	0	1	0	1	0	0	0	2
OG0028697	0	1	0	0	0	0	1	2
OG0028698	0	2	0	0	0	0	0	2
OG0028699	0	2	0	0	0	0	0	2
OG0028700	0	2	0	0	0	0	0	2
OG0028701	0	1	0	1	0	0	0	2
OG0028702	0	2	0	0	0	0	0	2
OG0028703	0	2	0	0	0	0	0	2
OG0028704	0	2	0	0	0	0	0	2
OG0028705	0	2	0	0	0	0	0	2
OG0028706	0	1	0	1	0	0	0	2
OG0028707	0	1	0	1	0	0	0	2
OG0028708	0	1	0	1	0	0	0	2
OG0028709	0	2	0	0	0	0	0	2
OG0028710	0	2	0	0	0	0	0	2
OG0028711	0	2	0	0	0	0	0	2
OG0028712	0	2	0	0	0	0	0	2
OG0028713	0	2	0	0	0	0	0	2
OG0028714	0	2	0	0	0	0	0	2
OG0028715	0	1	0	1	0	0	0	2
OG0028716	0	2	0	0	0	0	0	2
OG0028717	0	2	0	0	0	0	0	2
OG0028718	0	1	0	0	1	0	0	2
OG0028719	0	2	0	0	0	0	0	2
OG0028720	0	2	0	0	0	0	0	2
OG0028721	0	2	0	0	0	0	0	2
OG0028722	0	2	0	0	0	0	0	2
OG0028723	0	2	0	0	0	0	0	2
OG0028724	0	1	0	0	0	1	0	2
OG0028725	0	2	0	0	0	0	0	2
OG0028726	0	2	0	0	0	0	0	2
OG0028727	0	2	0	0	0	0	0	2
OG0028728	0	1	1	0	0	0	0	2
OG0028729	0	1	0	0	0	0	1	2
OG0028730	0	1	1	0	0	0	0	2
OG0028731	0	2	0	0	0	0	0	2
OG0028732	0	2	0	0	0	0	0	2
OG0028733	0	2	0	0	0	0	0	2
OG0028734	0	2	0	0	0	0	0	2
OG0028735	0	2	0	0	0	0	0	2
OG0028736	0	2	0	0	0	0	0	2
OG0028737	0	2	0	0	0	0	0	2
OG0028738	0	2	0	0	0	0	0	2
OG0028739	0	2	0	0	0	0	0	2
OG0028740	0	2	0	0	0	0	0	2
OG0028741	0	2	0	0	0	0	0	2
OG0028742	0	2	0	0	0	0	0	2
OG0028743	0	1	0	1	0	0	0	2
OG0028744	0	1	0	1	0	0	0	2
OG0028745	0	2	0	0	0	0	0	2
OG0028746	0	1	0	1	0	0	0	2
OG0028747	0	1	1	0	0	0	0	2
OG0028748	0	1	0	0	0	0	1	2
OG0028749	0	2	0	0	0	0	0	2
OG0028750	0	1	0	1	0	0	0	2
OG0028751	0	1	0	1	0	0	0	2
OG0028752	0	2	0	0	0	0	0	2
OG0028753	0	1	0	1	0	0	0	2
OG0028754	0	2	0	0	0	0	0	2
OG0028755	0	1	0	1	0	0	0	2
OG0028756	0	2	0	0	0	0	0	2
OG0028757	0	2	0	0	0	0	0	2
OG0028758	0	2	0	0	0	0	0	2
OG0028759	0	2	0	0	0	0	0	2
OG0028760	0	2	0	0	0	0	0	2
OG0028761	0	2	0	0	0	0	0	2
OG0028762	0	2	0	0	0	0	0	2
OG0028763	0	2	0	0	0	0	0	2
OG0028764	0	2	0	0	0	0	0	2
OG0028765	0	2	0	0	0	0	0	2
OG0028766	0	2	0	0	0	0	0	2
OG0028767	0	2	0	0	0	0	0	2
OG0028768	0	2	0	0	0	0	0	2
OG0028769	0	2	0	0	0	0	0	2
OG0028770	0	2	0	0	0	0	0	2
OG0028771	0	1	0	0	1	0	0	2
OG0028772	0	1	0	0	0	0	1	2
OG0028773	0	2	0	0	0	0	0	2
OG0028774	0	2	0	0	0	0	0	2
OG0028775	0	2	0	0	0	0	0	2
OG0028776	0	2	0	0	0	0	0	2
OG0028777	0	2	0	0	0	0	0	2
OG0028778	0	2	0	0	0	0	0	2
OG0028779	0	2	0	0	0	0	0	2
OG0028780	0	2	0	0	0	0	0	2
OG0028781	0	2	0	0	0	0	0	2
OG0028782	0	2	0	0	0	0	0	2
OG0028783	0	2	0	0	0	0	0	2
OG0028784	0	2	0	0	0	0	0	2
OG0028785	0	2	0	0	0	0	0	2
OG0028786	0	2	0	0	0	0	0	2
OG0028787	0	1	0	1	0	0	0	2
OG0028788	0	1	0	1	0	0	0	2
OG0028789	0	1	0	1	0	0	0	2
OG0028790	0	2	0	0	0	0	0	2
OG0028791	0	2	0	0	0	0	0	2
OG0028792	0	2	0	0	0	0	0	2
OG0028793	0	2	0	0	0	0	0	2
OG0028794	0	1	0	1	0	0	0	2
OG0028795	0	1	0	1	0	0	0	2
OG0028796	0	1	0	1	0	0	0	2
OG0028797	0	2	0	0	0	0	0	2
OG0028798	0	2	0	0	0	0	0	2
OG0028799	0	1	0	1	0	0	0	2
OG0028800	0	2	0	0	0	0	0	2
OG0028801	0	2	0	0	0	0	0	2
OG0028802	0	2	0	0	0	0	0	2
OG0028803	0	2	0	0	0	0	0	2
OG0028804	0	2	0	0	0	0	0	2
OG0028805	0	1	0	1	0	0	0	2
OG0028806	0	1	0	1	0	0	0	2
OG0028807	0	1	0	1	0	0	0	2
OG0028808	0	2	0	0	0	0	0	2
OG0028809	0	2	0	0	0	0	0	2
OG0028810	0	1	0	1	0	0	0	2
OG0028811	0	2	0	0	0	0	0	2
OG0028812	0	1	0	0	1	0	0	2
OG0028813	0	1	0	0	0	0	1	2
OG0028814	0	2	0	0	0	0	0	2
OG0028815	0	2	0	0	0	0	0	2
OG0028816	0	2	0	0	0	0	0	2
OG0028817	0	1	0	0	0	0	1	2
OG0028818	0	2	0	0	0	0	0	2
OG0028819	0	2	0	0	0	0	0	2
OG0028820	0	1	0	0	0	1	0	2
OG0028821	0	2	0	0	0	0	0	2
OG0028822	0	1	0	0	1	0	0	2
OG0028823	0	2	0	0	0	0	0	2
OG0028824	0	2	0	0	0	0	0	2
OG0028825	0	2	0	0	0	0	0	2
OG0028826	0	2	0	0	0	0	0	2
OG0028827	0	2	0	0	0	0	0	2
OG0028828	0	2	0	0	0	0	0	2
OG0028829	0	2	0	0	0	0	0	2
OG0028830	0	2	0	0	0	0	0	2
OG0028831	0	2	0	0	0	0	0	2
OG0028832	0	1	0	0	0	0	1	2
OG0028833	0	2	0	0	0	0	0	2
OG0028834	0	2	0	0	0	0	0	2
OG0028835	0	2	0	0	0	0	0	2
OG0028836	0	2	0	0	0	0	0	2
OG0028837	0	1	0	0	0	0	1	2
OG0028838	0	1	0	0	1	0	0	2
OG0028839	0	2	0	0	0	0	0	2
OG0028840	0	2	0	0	0	0	0	2
OG0028841	0	2	0	0	0	0	0	2
OG0028842	0	1	0	1	0	0	0	2
OG0028843	0	2	0	0	0	0	0	2
OG0028844	0	2	0	0	0	0	0	2
OG0028845	0	2	0	0	0	0	0	2
OG0028846	0	1	0	0	1	0	0	2
OG0028847	0	1	0	0	1	0	0	2
OG0028848	0	2	0	0	0	0	0	2
OG0028849	0	1	0	0	1	0	0	2
OG0028850	0	1	0	0	0	1	0	2
OG0028851	0	2	0	0	0	0	0	2
OG0028852	0	1	0	0	1	0	0	2
OG0028853	0	2	0	0	0	0	0	2
OG0028854	0	1	0	0	1	0	0	2
OG0028855	0	2	0	0	0	0	0	2
OG0028856	0	2	0	0	0	0	0	2
OG0028857	0	2	0	0	0	0	0	2
OG0028858	0	1	0	0	1	0	0	2
OG0028859	0	1	0	0	1	0	0	2
OG0028860	0	2	0	0	0	0	0	2
OG0028861	0	2	0	0	0	0	0	2
OG0028862	0	2	0	0	0	0	0	2
OG0028863	0	2	0	0	0	0	0	2
OG0028864	0	2	0	0	0	0	0	2
OG0028865	0	1	0	0	1	0	0	2
OG0028866	0	2	0	0	0	0	0	2
OG0028867	0	2	0	0	0	0	0	2
OG0028868	0	1	0	0	1	0	0	2
OG0028869	0	2	0	0	0	0	0	2
OG0028870	0	1	0	0	0	0	1	2
OG0028871	0	2	0	0	0	0	0	2
OG0028872	0	1	0	0	1	0	0	2
OG0028873	0	2	0	0	0	0	0	2
OG0028874	0	2	0	0	0	0	0	2
OG0028875	0	2	0	0	0	0	0	2
OG0028876	0	1	0	0	1	0	0	2
OG0028877	0	2	0	0	0	0	0	2
OG0028878	0	2	0	0	0	0	0	2
OG0028879	0	1	0	0	1	0	0	2
OG0028880	0	2	0	0	0	0	0	2
OG0028881	0	2	0	0	0	0	0	2
OG0028882	0	2	0	0	0	0	0	2
OG0028883	0	2	0	0	0	0	0	2
OG0028884	0	2	0	0	0	0	0	2
OG0028885	0	2	0	0	0	0	0	2
OG0028886	0	2	0	0	0	0	0	2
OG0028887	0	1	0	1	0	0	0	2
OG0028888	0	2	0	0	0	0	0	2
OG0028889	0	2	0	0	0	0	0	2
OG0028890	0	2	0	0	0	0	0	2
OG0028891	0	2	0	0	0	0	0	2
OG0028892	0	2	0	0	0	0	0	2
OG0028893	0	2	0	0	0	0	0	2
OG0028894	0	2	0	0	0	0	0	2
OG0028895	0	1	0	0	1	0	0	2
OG0028896	0	2	0	0	0	0	0	2
OG0028897	0	2	0	0	0	0	0	2
OG0028898	0	2	0	0	0	0	0	2
OG0028899	0	2	0	0	0	0	0	2
OG0028900	0	2	0	0	0	0	0	2
OG0028901	0	1	0	0	1	0	0	2
OG0028902	0	1	0	0	1	0	0	2
OG0028903	0	2	0	0	0	0	0	2
OG0028904	0	2	0	0	0	0	0	2
OG0028905	0	2	0	0	0	0	0	2
OG0028906	0	2	0	0	0	0	0	2
OG0028907	0	2	0	0	0	0	0	2
OG0028908	0	2	0	0	0	0	0	2
OG0028909	0	2	0	0	0	0	0	2
OG0028910	0	1	0	1	0	0	0	2
OG0028911	0	2	0	0	0	0	0	2
OG0028912	0	1	0	0	1	0	0	2
OG0028913	0	2	0	0	0	0	0	2
OG0028914	0	1	0	0	1	0	0	2
OG0028915	0	1	0	0	1	0	0	2
OG0028916	0	2	0	0	0	0	0	2
OG0028917	0	2	0	0	0	0	0	2
OG0028918	0	2	0	0	0	0	0	2
OG0028919	0	2	0	0	0	0	0	2
OG0028920	0	2	0	0	0	0	0	2
OG0028921	0	2	0	0	0	0	0	2
OG0028922	0	2	0	0	0	0	0	2
OG0028923	0	2	0	0	0	0	0	2
OG0028924	0	2	0	0	0	0	0	2
OG0028925	0	2	0	0	0	0	0	2
OG0028926	0	2	0	0	0	0	0	2
OG0028927	0	2	0	0	0	0	0	2
OG0028928	0	1	0	1	0	0	0	2
OG0028929	0	2	0	0	0	0	0	2
OG0028930	0	2	0	0	0	0	0	2
OG0028931	0	2	0	0	0	0	0	2
OG0028932	0	2	0	0	0	0	0	2
OG0028933	0	2	0	0	0	0	0	2
OG0028934	0	2	0	0	0	0	0	2
OG0028935	0	2	0	0	0	0	0	2
OG0028936	0	2	0	0	0	0	0	2
OG0028937	0	2	0	0	0	0	0	2
OG0028938	0	2	0	0	0	0	0	2
OG0028939	0	1	0	0	1	0	0	2
OG0028940	0	2	0	0	0	0	0	2
OG0028941	0	2	0	0	0	0	0	2
OG0028942	0	2	0	0	0	0	0	2
OG0028943	0	2	0	0	0	0	0	2
OG0028944	0	2	0	0	0	0	0	2
OG0028945	0	2	0	0	0	0	0	2
OG0028946	0	2	0	0	0	0	0	2
OG0028947	0	1	1	0	0	0	0	2
OG0028948	0	2	0	0	0	0	0	2
OG0028949	0	2	0	0	0	0	0	2
OG0028950	0	2	0	0	0	0	0	2
OG0028951	0	2	0	0	0	0	0	2
OG0028952	0	2	0	0	0	0	0	2
OG0028953	0	2	0	0	0	0	0	2
OG0028954	0	2	0	0	0	0	0	2
OG0028955	0	2	0	0	0	0	0	2
OG0028956	0	2	0	0	0	0	0	2
OG0028957	0	1	0	0	1	0	0	2
OG0028958	0	1	1	0	0	0	0	2
OG0028959	0	1	0	0	1	0	0	2
OG0028960	0	1	0	0	0	1	0	2
OG0028961	0	2	0	0	0	0	0	2
OG0028962	0	1	0	0	1	0	0	2
OG0028963	0	1	0	0	1	0	0	2
OG0028964	0	2	0	0	0	0	0	2
OG0028965	0	1	0	0	0	0	1	2
OG0028966	0	2	0	0	0	0	0	2
OG0028967	0	2	0	0	0	0	0	2
OG0028968	0	2	0	0	0	0	0	2
OG0028969	0	2	0	0	0	0	0	2
OG0028970	0	2	0	0	0	0	0	2
OG0028971	0	2	0	0	0	0	0	2
OG0028972	0	2	0	0	0	0	0	2
OG0028973	0	2	0	0	0	0	0	2
OG0028974	0	1	0	1	0	0	0	2
OG0028975	0	2	0	0	0	0	0	2
OG0028976	0	2	0	0	0	0	0	2
OG0028977	0	1	0	1	0	0	0	2
OG0028978	0	2	0	0	0	0	0	2
OG0028979	0	2	0	0	0	0	0	2
OG0028980	0	2	0	0	0	0	0	2
OG0028981	0	1	0	1	0	0	0	2
OG0028982	0	2	0	0	0	0	0	2
OG0028983	0	2	0	0	0	0	0	2
OG0028984	0	2	0	0	0	0	0	2
OG0028985	0	2	0	0	0	0	0	2
OG0028986	0	2	0	0	0	0	0	2
OG0028987	0	2	0	0	0	0	0	2
OG0028988	0	1	1	0	0	0	0	2
OG0028989	0	2	0	0	0	0	0	2
OG0028990	0	2	0	0	0	0	0	2
OG0028991	0	2	0	0	0	0	0	2
OG0028992	0	2	0	0	0	0	0	2
OG0028993	0	2	0	0	0	0	0	2
OG0028994	0	2	0	0	0	0	0	2
OG0028995	0	2	0	0	0	0	0	2
OG0028996	0	2	0	0	0	0	0	2
OG0028997	0	1	0	0	1	0	0	2
OG0028998	0	1	0	0	0	1	0	2
OG0028999	0	2	0	0	0	0	0	2
OG0029000	0	2	0	0	0	0	0	2
OG0029001	0	1	0	1	0	0	0	2
OG0029002	0	2	0	0	0	0	0	2
OG0029003	0	2	0	0	0	0	0	2
OG0029004	0	1	0	1	0	0	0	2
OG0029005	0	1	0	1	0	0	0	2
OG0029006	0	2	0	0	0	0	0	2
OG0029007	0	1	0	1	0	0	0	2
OG0029008	0	1	0	0	1	0	0	2
OG0029009	0	2	0	0	0	0	0	2
OG0029010	0	2	0	0	0	0	0	2
OG0029011	0	1	1	0	0	0	0	2
OG0029012	0	2	0	0	0	0	0	2
OG0029013	0	2	0	0	0	0	0	2
OG0029014	0	2	0	0	0	0	0	2
OG0029015	0	2	0	0	0	0	0	2
OG0029016	0	2	0	0	0	0	0	2
OG0029017	0	2	0	0	0	0	0	2
OG0029018	0	1	0	1	0	0	0	2
OG0029019	0	2	0	0	0	0	0	2
OG0029020	0	2	0	0	0	0	0	2
OG0029021	0	2	0	0	0	0	0	2
OG0029022	0	1	0	0	0	1	0	2
OG0029023	0	1	0	0	0	1	0	2
OG0029024	0	1	1	0	0	0	0	2
OG0029025	0	1	0	0	0	1	0	2
OG0029026	0	2	0	0	0	0	0	2
OG0029027	0	2	0	0	0	0	0	2
OG0029028	0	2	0	0	0	0	0	2
OG0029029	0	1	1	0	0	0	0	2
OG0029030	0	2	0	0	0	0	0	2
OG0029031	0	2	0	0	0	0	0	2
OG0029032	0	2	0	0	0	0	0	2
OG0029033	0	1	1	0	0	0	0	2
OG0029034	0	1	0	1	0	0	0	2
OG0029035	0	2	0	0	0	0	0	2
OG0029036	0	2	0	0	0	0	0	2
OG0029037	0	2	0	0	0	0	0	2
OG0029038	0	1	0	1	0	0	0	2
OG0029039	0	2	0	0	0	0	0	2
OG0029040	0	2	0	0	0	0	0	2
OG0029041	0	2	0	0	0	0	0	2
OG0029042	0	1	0	1	0	0	0	2
OG0029043	0	2	0	0	0	0	0	2
OG0029044	0	1	0	1	0	0	0	2
OG0029045	0	1	0	1	0	0	0	2
OG0029046	0	1	0	1	0	0	0	2
OG0029047	0	2	0	0	0	0	0	2
OG0029048	0	1	0	1	0	0	0	2
OG0029049	0	1	0	1	0	0	0	2
OG0029050	0	1	0	1	0	0	0	2
OG0029051	0	1	0	1	0	0	0	2
OG0029052	0	1	0	0	1	0	0	2
OG0029053	0	1	0	1	0	0	0	2
OG0029054	0	2	0	0	0	0	0	2
OG0029055	0	1	0	0	0	1	0	2
OG0029056	0	2	0	0	0	0	0	2
OG0029057	0	2	0	0	0	0	0	2
OG0029058	0	1	0	0	0	0	1	2
OG0029059	0	1	0	1	0	0	0	2
OG0029060	0	2	0	0	0	0	0	2
OG0029061	0	2	0	0	0	0	0	2
OG0029062	0	2	0	0	0	0	0	2
OG0029063	0	2	0	0	0	0	0	2
OG0029064	0	2	0	0	0	0	0	2
OG0029065	0	2	0	0	0	0	0	2
OG0029066	0	2	0	0	0	0	0	2
OG0029067	0	2	0	0	0	0	0	2
OG0029068	0	2	0	0	0	0	0	2
OG0029069	0	1	0	0	0	0	1	2
OG0029070	0	1	1	0	0	0	0	2
OG0029071	0	2	0	0	0	0	0	2
OG0029072	0	2	0	0	0	0	0	2
OG0029073	0	2	0	0	0	0	0	2
OG0029074	0	2	0	0	0	0	0	2
OG0029075	0	2	0	0	0	0	0	2
OG0029076	0	2	0	0	0	0	0	2
OG0029077	0	1	0	1	0	0	0	2
OG0029078	0	1	0	1	0	0	0	2
OG0029079	0	2	0	0	0	0	0	2
OG0029080	0	1	0	0	0	0	1	2
OG0029081	0	2	0	0	0	0	0	2
OG0029082	0	2	0	0	0	0	0	2
OG0029083	0	2	0	0	0	0	0	2
OG0029084	0	2	0	0	0	0	0	2
OG0029085	0	2	0	0	0	0	0	2
OG0029086	0	2	0	0	0	0	0	2
OG0029087	0	2	0	0	0	0	0	2
OG0029088	0	1	0	0	0	1	0	2
OG0029089	0	1	0	1	0	0	0	2
OG0029090	0	1	0	1	0	0	0	2
OG0029091	0	1	0	1	0	0	0	2
OG0029092	0	2	0	0	0	0	0	2
OG0029093	0	2	0	0	0	0	0	2
OG0029094	0	2	0	0	0	0	0	2
OG0029095	0	2	0	0	0	0	0	2
OG0029096	0	2	0	0	0	0	0	2
OG0029097	0	1	0	1	0	0	0	2
OG0029098	0	2	0	0	0	0	0	2
OG0029099	0	2	0	0	0	0	0	2
OG0029100	0	2	0	0	0	0	0	2
OG0029101	0	2	0	0	0	0	0	2
OG0029102	0	1	0	1	0	0	0	2
OG0029103	0	1	0	1	0	0	0	2
OG0029104	0	2	0	0	0	0	0	2
OG0029105	0	1	0	1	0	0	0	2
OG0029106	0	1	0	1	0	0	0	2
OG0029107	0	2	0	0	0	0	0	2
OG0029108	0	2	0	0	0	0	0	2
OG0029109	0	1	0	1	0	0	0	2
OG0029110	0	1	0	1	0	0	0	2
OG0029111	0	1	0	1	0	0	0	2
OG0029112	0	1	0	1	0	0	0	2
OG0029113	0	2	0	0	0	0	0	2
OG0029114	0	1	0	0	0	0	1	2
OG0029115	0	1	0	0	0	0	1	2
OG0029116	0	1	0	0	0	0	1	2
OG0029117	0	2	0	0	0	0	0	2
OG0029118	0	2	0	0	0	0	0	2
OG0029119	0	2	0	0	0	0	0	2
OG0029120	0	2	0	0	0	0	0	2
OG0029121	0	1	0	1	0	0	0	2
OG0029122	0	2	0	0	0	0	0	2
OG0029123	0	1	0	1	0	0	0	2
OG0029124	0	2	0	0	0	0	0	2
OG0029125	0	2	0	0	0	0	0	2
OG0029126	0	2	0	0	0	0	0	2
OG0029127	0	2	0	0	0	0	0	2
OG0029128	0	2	0	0	0	0	0	2
OG0029129	0	2	0	0	0	0	0	2
OG0029130	0	2	0	0	0	0	0	2
OG0029131	0	2	0	0	0	0	0	2
OG0029132	0	1	0	0	0	0	1	2
OG0029133	0	2	0	0	0	0	0	2
OG0029134	0	2	0	0	0	0	0	2
OG0029135	0	2	0	0	0	0	0	2
OG0029136	0	1	0	0	0	0	1	2
OG0029137	0	2	0	0	0	0	0	2
OG0029138	0	2	0	0	0	0	0	2
OG0029139	0	1	0	1	0	0	0	2
OG0029140	0	2	0	0	0	0	0	2
OG0029141	0	2	0	0	0	0	0	2
OG0029142	0	2	0	0	0	0	0	2
OG0029143	0	1	0	0	0	0	1	2
OG0029144	0	1	0	0	0	0	1	2
OG0029145	0	2	0	0	0	0	0	2
OG0029146	0	2	0	0	0	0	0	2
OG0029147	0	2	0	0	0	0	0	2
OG0029148	0	2	0	0	0	0	0	2
OG0029149	0	1	0	1	0	0	0	2
OG0029150	0	2	0	0	0	0	0	2
OG0029151	0	2	0	0	0	0	0	2
OG0029152	0	2	0	0	0	0	0	2
OG0029153	0	2	0	0	0	0	0	2
OG0029154	0	1	0	0	0	1	0	2
OG0029155	0	2	0	0	0	0	0	2
OG0029156	0	2	0	0	0	0	0	2
OG0029157	0	1	1	0	0	0	0	2
OG0029158	0	2	0	0	0	0	0	2
OG0029159	0	2	0	0	0	0	0	2
OG0029160	0	2	0	0	0	0	0	2
OG0029161	0	2	0	0	0	0	0	2
OG0029162	0	2	0	0	0	0	0	2
OG0029163	0	2	0	0	0	0	0	2
OG0029164	0	1	0	0	0	0	1	2
OG0029165	0	1	0	0	1	0	0	2
OG0029166	0	2	0	0	0	0	0	2
OG0029167	0	2	0	0	0	0	0	2
OG0029168	0	2	0	0	0	0	0	2
OG0029169	0	2	0	0	0	0	0	2
OG0029170	0	2	0	0	0	0	0	2
OG0029171	0	2	0	0	0	0	0	2
OG0029172	0	2	0	0	0	0	0	2
OG0029173	0	1	0	0	0	0	1	2
OG0029174	0	2	0	0	0	0	0	2
OG0029175	0	2	0	0	0	0	0	2
OG0029176	0	1	1	0	0	0	0	2
OG0029177	0	1	0	1	0	0	0	2
OG0029178	0	1	0	0	1	0	0	2
OG0029179	0	2	0	0	0	0	0	2
OG0029180	0	2	0	0	0	0	0	2
OG0029181	0	1	0	0	0	0	1	2
OG0029182	0	2	0	0	0	0	0	2
OG0029183	0	2	0	0	0	0	0	2
OG0029184	0	2	0	0	0	0	0	2
OG0029185	0	2	0	0	0	0	0	2
OG0029186	0	2	0	0	0	0	0	2
OG0029187	0	1	0	0	0	0	1	2
OG0029188	0	2	0	0	0	0	0	2
OG0029189	0	2	0	0	0	0	0	2
OG0029190	0	2	0	0	0	0	0	2
OG0029191	0	1	0	1	0	0	0	2
OG0029192	0	2	0	0	0	0	0	2
OG0029193	0	2	0	0	0	0	0	2
OG0029194	0	2	0	0	0	0	0	2
OG0029195	0	2	0	0	0	0	0	2
OG0029196	0	2	0	0	0	0	0	2
OG0029197	0	2	0	0	0	0	0	2
OG0029198	0	1	0	1	0	0	0	2
OG0029199	0	1	0	0	1	0	0	2
OG0029200	0	2	0	0	0	0	0	2
OG0029201	0	2	0	0	0	0	0	2
OG0029202	0	2	0	0	0	0	0	2
OG0029203	0	2	0	0	0	0	0	2
OG0029204	0	2	0	0	0	0	0	2
OG0029205	0	2	0	0	0	0	0	2
OG0029206	0	1	0	0	1	0	0	2
OG0029207	0	2	0	0	0	0	0	2
OG0029208	0	2	0	0	0	0	0	2
OG0029209	0	2	0	0	0	0	0	2
OG0029210	0	2	0	0	0	0	0	2
OG0029211	0	1	0	0	1	0	0	2
OG0029212	0	1	0	0	1	0	0	2
OG0029213	0	1	0	0	1	0	0	2
OG0029214	0	1	0	0	1	0	0	2
OG0029215	0	2	0	0	0	0	0	2
OG0029216	0	2	0	0	0	0	0	2
OG0029217	0	2	0	0	0	0	0	2
OG0029218	0	1	0	0	0	0	1	2
OG0029219	0	1	0	0	1	0	0	2
OG0029220	0	2	0	0	0	0	0	2
OG0029221	0	2	0	0	0	0	0	2
OG0029222	0	2	0	0	0	0	0	2
OG0029223	0	2	0	0	0	0	0	2
OG0029224	0	2	0	0	0	0	0	2
OG0029225	0	1	0	1	0	0	0	2
OG0029226	0	2	0	0	0	0	0	2
OG0029227	0	2	0	0	0	0	0	2
OG0029228	0	2	0	0	0	0	0	2
OG0029229	0	2	0	0	0	0	0	2
OG0029230	0	2	0	0	0	0	0	2
OG0029231	0	1	0	0	1	0	0	2
OG0029232	0	1	0	0	1	0	0	2
OG0029233	0	1	0	0	1	0	0	2
OG0029234	0	1	0	0	1	0	0	2
OG0029235	0	2	0	0	0	0	0	2
OG0029236	0	1	0	0	1	0	0	2
OG0029237	0	1	0	0	0	0	1	2
OG0029238	0	1	0	0	1	0	0	2
OG0029239	0	1	0	1	0	0	0	2
OG0029240	0	1	0	0	1	0	0	2
OG0029241	0	1	0	0	1	0	0	2
OG0029242	0	2	0	0	0	0	0	2
OG0029243	0	2	0	0	0	0	0	2
OG0029244	0	2	0	0	0	0	0	2
OG0029245	0	2	0	0	0	0	0	2
OG0029246	0	2	0	0	0	0	0	2
OG0029247	0	2	0	0	0	0	0	2
OG0029248	0	2	0	0	0	0	0	2
OG0029249	0	1	0	0	1	0	0	2
OG0029250	0	2	0	0	0	0	0	2
OG0029251	0	2	0	0	0	0	0	2
OG0029252	0	1	0	1	0	0	0	2
OG0029253	0	2	0	0	0	0	0	2
OG0029254	0	2	0	0	0	0	0	2
OG0029255	0	2	0	0	0	0	0	2
OG0029256	0	2	0	0	0	0	0	2
OG0029257	0	2	0	0	0	0	0	2
OG0029258	0	1	0	1	0	0	0	2
OG0029259	0	1	0	0	0	0	1	2
OG0029260	0	2	0	0	0	0	0	2
OG0029261	0	2	0	0	0	0	0	2
OG0029262	0	2	0	0	0	0	0	2
OG0029263	0	2	0	0	0	0	0	2
OG0029264	0	2	0	0	0	0	0	2
OG0029265	0	2	0	0	0	0	0	2
OG0029266	0	2	0	0	0	0	0	2
OG0029267	0	2	0	0	0	0	0	2
OG0029268	0	2	0	0	0	0	0	2
OG0029269	0	2	0	0	0	0	0	2
OG0029270	0	2	0	0	0	0	0	2
OG0029271	0	1	1	0	0	0	0	2
OG0029272	0	2	0	0	0	0	0	2
OG0029273	0	1	0	0	0	1	0	2
OG0029274	0	2	0	0	0	0	0	2
OG0029275	0	2	0	0	0	0	0	2
OG0029276	0	2	0	0	0	0	0	2
OG0029277	0	2	0	0	0	0	0	2
OG0029278	0	2	0	0	0	0	0	2
OG0029279	0	2	0	0	0	0	0	2
OG0029280	0	2	0	0	0	0	0	2
OG0029281	0	1	0	1	0	0	0	2
OG0029282	0	1	0	1	0	0	0	2
OG0029283	0	2	0	0	0	0	0	2
OG0029284	0	1	0	0	0	0	1	2
OG0029285	0	2	0	0	0	0	0	2
OG0029286	0	2	0	0	0	0	0	2
OG0029287	0	2	0	0	0	0	0	2
OG0029288	0	2	0	0	0	0	0	2
OG0029289	0	2	0	0	0	0	0	2
OG0029290	0	2	0	0	0	0	0	2
OG0029291	0	2	0	0	0	0	0	2
OG0029292	0	2	0	0	0	0	0	2
OG0029293	0	2	0	0	0	0	0	2
OG0029294	0	2	0	0	0	0	0	2
OG0029295	0	2	0	0	0	0	0	2
OG0029296	0	2	0	0	0	0	0	2
OG0029297	0	1	1	0	0	0	0	2
OG0029298	0	2	0	0	0	0	0	2
OG0029299	0	2	0	0	0	0	0	2
OG0029300	0	1	1	0	0	0	0	2
OG0029301	0	2	0	0	0	0	0	2
OG0029302	0	2	0	0	0	0	0	2
OG0029303	0	2	0	0	0	0	0	2
OG0029304	0	1	0	1	0	0	0	2
OG0029305	0	2	0	0	0	0	0	2
OG0029306	0	1	0	0	0	0	1	2
OG0029307	0	1	1	0	0	0	0	2
OG0029308	0	2	0	0	0	0	0	2
OG0029309	0	2	0	0	0	0	0	2
OG0029310	0	2	0	0	0	0	0	2
OG0029311	0	1	0	1	0	0	0	2
OG0029312	0	2	0	0	0	0	0	2
OG0029313	0	1	0	1	0	0	0	2
OG0029314	0	1	0	1	0	0	0	2
OG0029315	0	2	0	0	0	0	0	2
OG0029316	0	2	0	0	0	0	0	2
OG0029317	0	2	0	0	0	0	0	2
OG0029318	0	2	0	0	0	0	0	2
OG0029319	0	2	0	0	0	0	0	2
OG0029320	0	2	0	0	0	0	0	2
OG0029321	0	2	0	0	0	0	0	2
OG0029322	0	2	0	0	0	0	0	2
OG0029323	0	2	0	0	0	0	0	2
OG0029324	0	2	0	0	0	0	0	2
OG0029325	0	2	0	0	0	0	0	2
OG0029326	0	2	0	0	0	0	0	2
OG0029327	0	2	0	0	0	0	0	2
OG0029328	0	2	0	0	0	0	0	2
OG0029329	0	2	0	0	0	0	0	2
OG0029330	0	1	0	0	0	1	0	2
OG0029331	0	2	0	0	0	0	0	2
OG0029332	0	2	0	0	0	0	0	2
OG0029333	0	1	0	0	0	0	1	2
OG0029334	0	2	0	0	0	0	0	2
OG0029335	0	1	0	0	0	1	0	2
OG0029336	0	2	0	0	0	0	0	2
OG0029337	0	2	0	0	0	0	0	2
OG0029338	0	2	0	0	0	0	0	2
OG0029339	0	2	0	0	0	0	0	2
OG0029340	0	2	0	0	0	0	0	2
OG0029341	0	2	0	0	0	0	0	2
OG0029342	0	2	0	0	0	0	0	2
OG0029343	0	2	0	0	0	0	0	2
OG0029344	0	2	0	0	0	0	0	2
OG0029345	0	2	0	0	0	0	0	2
OG0029346	0	2	0	0	0	0	0	2
OG0029347	0	2	0	0	0	0	0	2
OG0029348	0	1	0	1	0	0	0	2
OG0029349	0	2	0	0	0	0	0	2
OG0029350	0	2	0	0	0	0	0	2
OG0029351	0	1	0	0	0	0	1	2
OG0029352	0	2	0	0	0	0	0	2
OG0029353	0	2	0	0	0	0	0	2
OG0029354	0	2	0	0	0	0	0	2
OG0029355	0	2	0	0	0	0	0	2
OG0029356	0	2	0	0	0	0	0	2
OG0029357	0	2	0	0	0	0	0	2
OG0029358	0	2	0	0	0	0	0	2
OG0029359	0	2	0	0	0	0	0	2
OG0029360	0	2	0	0	0	0	0	2
OG0029361	0	1	1	0	0	0	0	2
OG0029362	0	1	0	1	0	0	0	2
OG0029363	0	2	0	0	0	0	0	2
OG0029364	0	2	0	0	0	0	0	2
OG0029365	0	2	0	0	0	0	0	2
OG0029366	0	1	0	1	0	0	0	2
OG0029367	0	2	0	0	0	0	0	2
OG0029368	0	2	0	0	0	0	0	2
OG0029369	0	2	0	0	0	0	0	2
OG0029370	0	1	0	1	0	0	0	2
OG0029371	0	1	0	1	0	0	0	2
OG0029372	0	1	0	1	0	0	0	2
OG0029373	0	2	0	0	0	0	0	2
OG0029374	0	2	0	0	0	0	0	2
OG0029375	0	2	0	0	0	0	0	2
OG0029376	0	2	0	0	0	0	0	2
OG0029377	0	2	0	0	0	0	0	2
OG0029378	0	1	0	1	0	0	0	2
OG0029379	0	2	0	0	0	0	0	2
OG0029380	0	2	0	0	0	0	0	2
OG0029381	0	2	0	0	0	0	0	2
OG0029382	0	1	0	1	0	0	0	2
OG0029383	0	2	0	0	0	0	0	2
OG0029384	0	2	0	0	0	0	0	2
OG0029385	0	1	0	0	0	0	1	2
OG0029386	0	1	0	1	0	0	0	2
OG0029387	0	1	0	1	0	0	0	2
OG0029388	0	2	0	0	0	0	0	2
OG0029389	0	2	0	0	0	0	0	2
OG0029390	0	1	0	1	0	0	0	2
OG0029391	0	2	0	0	0	0	0	2
OG0029392	0	2	0	0	0	0	0	2
OG0029393	0	1	0	1	0	0	0	2
OG0029394	0	2	0	0	0	0	0	2
OG0029395	0	2	0	0	0	0	0	2
OG0029396	0	2	0	0	0	0	0	2
OG0029397	0	2	0	0	0	0	0	2
OG0029398	0	2	0	0	0	0	0	2
OG0029399	0	2	0	0	0	0	0	2
OG0029400	0	2	0	0	0	0	0	2
OG0029401	0	1	0	1	0	0	0	2
OG0029402	0	2	0	0	0	0	0	2
OG0029403	0	2	0	0	0	0	0	2
OG0029404	0	1	0	0	0	0	1	2
OG0029405	0	1	0	0	0	0	1	2
OG0029406	0	1	0	0	0	0	1	2
OG0029407	0	1	0	0	0	0	1	2
OG0029408	0	2	0	0	0	0	0	2
OG0029409	0	2	0	0	0	0	0	2
OG0029410	0	1	0	0	0	0	1	2
OG0029411	0	1	0	0	0	0	1	2
OG0029412	0	1	0	0	0	0	1	2
OG0029413	0	1	0	0	0	0	1	2
OG0029414	0	2	0	0	0	0	0	2
OG0029415	0	2	0	0	0	0	0	2
OG0029416	0	2	0	0	0	0	0	2
OG0029417	0	2	0	0	0	0	0	2
OG0029418	0	2	0	0	0	0	0	2
OG0029419	0	2	0	0	0	0	0	2
OG0029420	0	2	0	0	0	0	0	2
OG0029421	0	2	0	0	0	0	0	2
OG0029422	0	2	0	0	0	0	0	2
OG0029423	0	2	0	0	0	0	0	2
OG0029424	0	1	1	0	0	0	0	2
OG0029425	0	2	0	0	0	0	0	2
OG0029426	0	1	1	0	0	0	0	2
OG0029427	0	2	0	0	0	0	0	2
OG0029428	0	2	0	0	0	0	0	2
OG0029429	0	1	1	0	0	0	0	2
OG0029430	0	1	0	0	0	0	1	2
OG0029431	0	2	0	0	0	0	0	2
OG0029432	0	1	0	0	0	0	1	2
OG0029433	0	2	0	0	0	0	0	2
OG0029434	0	2	0	0	0	0	0	2
OG0029435	0	1	0	0	0	0	1	2
OG0029436	0	2	0	0	0	0	0	2
OG0029437	0	2	0	0	0	0	0	2
OG0029438	0	2	0	0	0	0	0	2
OG0029439	0	2	0	0	0	0	0	2
OG0029440	0	2	0	0	0	0	0	2
OG0029441	0	2	0	0	0	0	0	2
OG0029442	0	1	1	0	0	0	0	2
OG0029443	0	2	0	0	0	0	0	2
OG0029444	0	2	0	0	0	0	0	2
OG0029445	0	2	0	0	0	0	0	2
OG0029446	0	2	0	0	0	0	0	2
OG0029447	0	2	0	0	0	0	0	2
OG0029448	0	2	0	0	0	0	0	2
OG0029449	0	1	0	1	0	0	0	2
OG0029450	0	2	0	0	0	0	0	2
OG0029451	0	2	0	0	0	0	0	2
OG0029452	0	2	0	0	0	0	0	2
OG0029453	0	2	0	0	0	0	0	2
OG0029454	0	1	0	0	0	0	1	2
OG0029455	0	2	0	0	0	0	0	2
OG0029456	0	2	0	0	0	0	0	2
OG0029457	0	2	0	0	0	0	0	2
OG0029458	0	2	0	0	0	0	0	2
OG0029459	0	2	0	0	0	0	0	2
OG0029460	0	1	0	1	0	0	0	2
OG0029461	0	1	0	0	0	1	0	2
OG0029462	0	2	0	0	0	0	0	2
OG0029463	0	1	0	0	0	0	1	2
OG0029464	0	2	0	0	0	0	0	2
OG0029465	0	1	0	1	0	0	0	2
OG0029466	0	1	0	1	0	0	0	2
OG0029467	0	1	0	1	0	0	0	2
OG0029468	0	2	0	0	0	0	0	2
OG0029469	0	2	0	0	0	0	0	2
OG0029470	0	1	0	1	0	0	0	2
OG0029471	0	2	0	0	0	0	0	2
OG0029472	0	2	0	0	0	0	0	2
OG0029473	0	2	0	0	0	0	0	2
OG0029474	0	2	0	0	0	0	0	2
OG0029475	0	2	0	0	0	0	0	2
OG0029476	0	2	0	0	0	0	0	2
OG0029477	0	1	0	1	0	0	0	2
OG0029478	0	2	0	0	0	0	0	2
OG0029479	0	1	0	1	0	0	0	2
OG0029480	0	1	0	1	0	0	0	2
OG0029481	0	1	0	1	0	0	0	2
OG0029482	0	1	0	1	0	0	0	2
OG0029483	0	2	0	0	0	0	0	2
OG0029484	0	1	0	1	0	0	0	2
OG0029485	0	1	0	1	0	0	0	2
OG0029486	0	2	0	0	0	0	0	2
OG0029487	0	2	0	0	0	0	0	2
OG0029488	0	1	0	1	0	0	0	2
OG0029489	0	1	0	0	0	0	1	2
OG0029490	0	2	0	0	0	0	0	2
OG0029491	0	2	0	0	0	0	0	2
OG0029492	0	1	0	0	0	0	1	2
OG0029493	0	1	1	0	0	0	0	2
OG0029494	0	2	0	0	0	0	0	2
OG0029495	0	2	0	0	0	0	0	2
OG0029496	0	2	0	0	0	0	0	2
OG0029497	0	2	0	0	0	0	0	2
OG0029498	0	1	0	0	1	0	0	2
OG0029499	0	1	0	1	0	0	0	2
OG0029500	0	2	0	0	0	0	0	2
OG0029501	0	2	0	0	0	0	0	2
OG0029502	0	2	0	0	0	0	0	2
OG0029503	0	2	0	0	0	0	0	2
OG0029504	0	2	0	0	0	0	0	2
OG0029505	0	2	0	0	0	0	0	2
OG0029506	0	2	0	0	0	0	0	2
OG0029507	0	2	0	0	0	0	0	2
OG0029508	0	2	0	0	0	0	0	2
OG0029509	0	2	0	0	0	0	0	2
OG0029510	0	1	0	1	0	0	0	2
OG0029511	0	2	0	0	0	0	0	2
OG0029512	0	2	0	0	0	0	0	2
OG0029513	0	2	0	0	0	0	0	2
OG0029514	0	2	0	0	0	0	0	2
OG0029515	0	2	0	0	0	0	0	2
OG0029516	0	1	1	0	0	0	0	2
OG0029517	0	1	0	0	0	0	1	2
OG0029518	0	2	0	0	0	0	0	2
OG0029519	0	2	0	0	0	0	0	2
OG0029520	0	2	0	0	0	0	0	2
OG0029521	0	2	0	0	0	0	0	2
OG0029522	0	1	1	0	0	0	0	2
OG0029523	0	1	0	0	1	0	0	2
OG0029524	0	2	0	0	0	0	0	2
OG0029525	0	1	1	0	0	0	0	2
OG0029526	0	1	0	0	0	0	1	2
OG0029527	0	2	0	0	0	0	0	2
OG0029528	0	2	0	0	0	0	0	2
OG0029529	0	2	0	0	0	0	0	2
OG0029530	0	2	0	0	0	0	0	2
OG0029531	0	1	0	0	0	1	0	2
OG0029532	0	1	0	1	0	0	0	2
OG0029533	0	2	0	0	0	0	0	2
OG0029534	0	2	0	0	0	0	0	2
OG0029535	0	2	0	0	0	0	0	2
OG0029536	0	2	0	0	0	0	0	2
OG0029537	0	2	0	0	0	0	0	2
OG0029538	0	2	0	0	0	0	0	2
OG0029539	0	2	0	0	0	0	0	2
OG0029540	0	2	0	0	0	0	0	2
OG0029541	0	2	0	0	0	0	0	2
OG0029542	0	2	0	0	0	0	0	2
OG0029543	0	2	0	0	0	0	0	2
OG0029544	0	2	0	0	0	0	0	2
OG0029545	0	2	0	0	0	0	0	2
OG0029546	0	1	0	0	1	0	0	2
OG0029547	0	2	0	0	0	0	0	2
OG0029548	0	1	0	0	0	1	0	2
OG0029549	0	2	0	0	0	0	0	2
OG0029550	0	1	0	0	0	1	0	2
OG0029551	0	2	0	0	0	0	0	2
OG0029552	0	2	0	0	0	0	0	2
OG0029553	0	2	0	0	0	0	0	2
OG0029554	0	2	0	0	0	0	0	2
OG0029555	0	2	0	0	0	0	0	2
OG0029556	0	2	0	0	0	0	0	2
OG0029557	0	2	0	0	0	0	0	2
OG0029558	0	2	0	0	0	0	0	2
OG0029559	0	1	0	0	0	0	1	2
OG0029560	0	2	0	0	0	0	0	2
OG0029561	0	1	0	0	0	1	0	2
OG0029562	0	2	0	0	0	0	0	2
OG0029563	0	2	0	0	0	0	0	2
OG0029564	0	2	0	0	0	0	0	2
OG0029565	0	1	0	0	1	0	0	2
OG0029566	0	2	0	0	0	0	0	2
OG0029567	0	2	0	0	0	0	0	2
OG0029568	0	2	0	0	0	0	0	2
OG0029569	0	1	0	0	0	0	1	2
OG0029570	0	1	0	0	0	0	1	2
OG0029571	0	2	0	0	0	0	0	2
OG0029572	0	1	0	0	0	0	1	2
OG0029573	0	1	0	0	1	0	0	2
OG0029574	0	2	0	0	0	0	0	2
OG0029575	0	2	0	0	0	0	0	2
OG0029576	0	1	0	1	0	0	0	2
OG0029577	0	2	0	0	0	0	0	2
OG0029578	0	1	0	0	1	0	0	2
OG0029579	0	2	0	0	0	0	0	2
OG0029580	0	2	0	0	0	0	0	2
OG0029581	0	2	0	0	0	0	0	2
OG0029582	0	1	0	0	0	0	1	2
OG0029583	0	1	0	0	1	0	0	2
OG0029584	0	2	0	0	0	0	0	2
OG0029585	0	2	0	0	0	0	0	2
OG0029586	0	1	0	1	0	0	0	2
OG0029587	0	2	0	0	0	0	0	2
OG0029588	0	1	0	0	0	0	1	2
OG0029589	0	1	0	0	1	0	0	2
OG0029590	0	1	0	0	0	1	0	2
OG0029591	0	2	0	0	0	0	0	2
OG0029592	0	1	1	0	0	0	0	2
OG0029593	0	2	0	0	0	0	0	2
OG0029594	0	2	0	0	0	0	0	2
OG0029595	0	2	0	0	0	0	0	2
OG0029596	0	2	0	0	0	0	0	2
OG0029597	0	2	0	0	0	0	0	2
OG0029598	0	2	0	0	0	0	0	2
OG0029599	0	2	0	0	0	0	0	2
OG0029600	0	2	0	0	0	0	0	2
OG0029601	0	2	0	0	0	0	0	2
OG0029602	0	2	0	0	0	0	0	2
OG0029603	0	2	0	0	0	0	0	2
OG0029604	0	2	0	0	0	0	0	2
OG0029605	0	2	0	0	0	0	0	2
OG0029606	0	1	1	0	0	0	0	2
OG0029607	0	2	0	0	0	0	0	2
OG0029608	0	2	0	0	0	0	0	2
OG0029609	0	1	0	0	1	0	0	2
OG0029610	0	2	0	0	0	0	0	2
OG0029611	0	2	0	0	0	0	0	2
OG0029612	0	2	0	0	0	0	0	2
OG0029613	0	2	0	0	0	0	0	2
OG0029614	0	2	0	0	0	0	0	2
OG0029615	0	1	0	0	1	0	0	2
OG0029616	0	2	0	0	0	0	0	2
OG0029617	0	2	0	0	0	0	0	2
OG0029618	0	2	0	0	0	0	0	2
OG0029619	0	2	0	0	0	0	0	2
OG0029620	0	2	0	0	0	0	0	2
OG0029621	0	2	0	0	0	0	0	2
OG0029622	0	1	0	0	1	0	0	2
OG0029623	0	2	0	0	0	0	0	2
OG0029624	0	1	0	0	1	0	0	2
OG0029625	0	2	0	0	0	0	0	2
OG0029626	0	2	0	0	0	0	0	2
OG0029627	0	2	0	0	0	0	0	2
OG0029628	0	2	0	0	0	0	0	2
OG0029629	0	2	0	0	0	0	0	2
OG0029630	0	2	0	0	0	0	0	2
OG0029631	0	2	0	0	0	0	0	2
OG0029632	0	2	0	0	0	0	0	2
OG0029633	0	2	0	0	0	0	0	2
OG0029634	0	1	0	0	1	0	0	2
OG0029635	0	1	0	0	0	0	1	2
OG0029636	0	1	0	1	0	0	0	2
OG0029637	0	1	0	1	0	0	0	2
OG0029638	0	1	1	0	0	0	0	2
OG0029639	0	1	0	1	0	0	0	2
OG0029640	0	2	0	0	0	0	0	2
OG0029641	0	2	0	0	0	0	0	2
OG0029642	0	2	0	0	0	0	0	2
OG0029643	0	2	0	0	0	0	0	2
OG0029644	0	1	1	0	0	0	0	2
OG0029645	0	2	0	0	0	0	0	2
OG0029646	0	1	0	0	1	0	0	2
OG0029647	0	2	0	0	0	0	0	2
OG0029648	0	1	0	0	1	0	0	2
OG0029649	0	2	0	0	0	0	0	2
OG0029650	0	2	0	0	0	0	0	2
OG0029651	0	2	0	0	0	0	0	2
OG0029652	0	1	0	0	0	0	1	2
OG0029653	0	2	0	0	0	0	0	2
OG0029654	0	2	0	0	0	0	0	2
OG0029655	0	2	0	0	0	0	0	2
OG0029656	0	2	0	0	0	0	0	2
OG0029657	0	1	0	0	0	1	0	2
OG0029658	0	2	0	0	0	0	0	2
OG0029659	0	2	0	0	0	0	0	2
OG0029660	0	2	0	0	0	0	0	2
OG0029661	0	2	0	0	0	0	0	2
OG0029662	0	2	0	0	0	0	0	2
OG0029663	0	2	0	0	0	0	0	2
OG0029664	0	2	0	0	0	0	0	2
OG0029665	0	1	0	1	0	0	0	2
OG0029666	0	1	0	0	0	0	1	2
OG0029667	0	1	1	0	0	0	0	2
OG0029668	0	2	0	0	0	0	0	2
OG0029669	0	2	0	0	0	0	0	2
OG0029670	0	2	0	0	0	0	0	2
OG0029671	0	2	0	0	0	0	0	2
OG0029672	0	1	0	1	0	0	0	2
OG0029673	0	2	0	0	0	0	0	2
OG0029674	0	1	0	1	0	0	0	2
OG0029675	0	2	0	0	0	0	0	2
OG0029676	0	2	0	0	0	0	0	2
OG0029677	0	2	0	0	0	0	0	2
OG0029678	0	1	0	0	0	0	1	2
OG0029679	0	1	1	0	0	0	0	2
OG0029680	0	2	0	0	0	0	0	2
OG0029681	0	2	0	0	0	0	0	2
OG0029682	0	2	0	0	0	0	0	2
OG0029683	0	2	0	0	0	0	0	2
OG0029684	0	2	0	0	0	0	0	2
OG0029685	0	1	0	0	1	0	0	2
OG0029686	0	2	0	0	0	0	0	2
OG0029687	0	2	0	0	0	0	0	2
OG0029688	0	1	0	0	1	0	0	2
OG0029689	0	1	0	0	1	0	0	2
OG0029690	0	2	0	0	0	0	0	2
OG0029691	0	2	0	0	0	0	0	2
OG0029692	0	2	0	0	0	0	0	2
OG0029693	0	2	0	0	0	0	0	2
OG0029694	0	1	0	0	1	0	0	2
OG0029695	0	2	0	0	0	0	0	2
OG0029696	0	2	0	0	0	0	0	2
OG0029697	0	2	0	0	0	0	0	2
OG0029698	0	2	0	0	0	0	0	2
OG0029699	0	1	1	0	0	0	0	2
OG0029700	0	1	0	1	0	0	0	2
OG0029701	0	1	0	0	0	0	1	2
OG0029702	0	2	0	0	0	0	0	2
OG0029703	0	1	0	1	0	0	0	2
OG0029704	0	2	0	0	0	0	0	2
OG0029705	0	2	0	0	0	0	0	2
OG0029706	0	2	0	0	0	0	0	2
OG0029707	0	1	0	0	1	0	0	2
OG0029708	0	2	0	0	0	0	0	2
OG0029709	0	1	0	0	1	0	0	2
OG0029710	0	2	0	0	0	0	0	2
OG0029711	0	2	0	0	0	0	0	2
OG0029712	0	2	0	0	0	0	0	2
OG0029713	0	2	0	0	0	0	0	2
OG0029714	0	1	0	0	1	0	0	2
OG0029715	0	2	0	0	0	0	0	2
OG0029716	0	2	0	0	0	0	0	2
OG0029717	0	1	0	0	1	0	0	2
OG0029718	0	1	0	0	1	0	0	2
OG0029719	0	1	0	0	0	0	1	2
OG0029720	0	2	0	0	0	0	0	2
OG0029721	0	2	0	0	0	0	0	2
OG0029722	0	1	0	0	1	0	0	2
OG0029723	0	2	0	0	0	0	0	2
OG0029724	0	2	0	0	0	0	0	2
OG0029725	0	2	0	0	0	0	0	2
OG0029726	0	2	0	0	0	0	0	2
OG0029727	0	2	0	0	0	0	0	2
OG0029728	0	2	0	0	0	0	0	2
OG0029729	0	1	0	0	1	0	0	2
OG0029730	0	2	0	0	0	0	0	2
OG0029731	0	1	1	0	0	0	0	2
OG0029732	0	1	0	0	1	0	0	2
OG0029733	0	2	0	0	0	0	0	2
OG0029734	0	2	0	0	0	0	0	2
OG0029735	0	2	0	0	0	0	0	2
OG0029736	0	2	0	0	0	0	0	2
OG0029737	0	2	0	0	0	0	0	2
OG0029738	0	2	0	0	0	0	0	2
OG0029739	0	1	0	1	0	0	0	2
OG0029740	0	1	0	1	0	0	0	2
OG0029741	0	1	0	0	0	0	1	2
OG0029742	0	1	0	0	0	1	0	2
OG0029743	0	2	0	0	0	0	0	2
OG0029744	0	2	0	0	0	0	0	2
OG0029745	0	2	0	0	0	0	0	2
OG0029746	0	2	0	0	0	0	0	2
OG0029747	0	2	0	0	0	0	0	2
OG0029748	0	2	0	0	0	0	0	2
OG0029749	0	2	0	0	0	0	0	2
OG0029750	0	1	1	0	0	0	0	2
OG0029751	0	2	0	0	0	0	0	2
OG0029752	0	2	0	0	0	0	0	2
OG0029753	0	1	0	0	1	0	0	2
OG0029754	0	1	0	0	0	0	1	2
OG0029755	0	1	0	0	1	0	0	2
OG0029756	0	1	0	0	1	0	0	2
OG0029757	0	1	0	0	1	0	0	2
OG0029758	0	1	0	0	1	0	0	2
OG0029759	0	1	0	0	1	0	0	2
OG0029760	0	2	0	0	0	0	0	2
OG0029761	0	1	1	0	0	0	0	2
OG0029762	0	1	0	0	0	1	0	2
OG0029763	0	1	0	0	1	0	0	2
OG0029764	0	1	0	0	1	0	0	2
OG0029765	0	1	0	0	1	0	0	2
OG0029766	0	1	0	0	1	0	0	2
OG0029767	0	2	0	0	0	0	0	2
OG0029768	0	2	0	0	0	0	0	2
OG0029769	0	2	0	0	0	0	0	2
OG0029770	0	1	0	0	0	0	1	2
OG0029771	0	1	0	0	1	0	0	2
OG0029772	0	1	0	1	0	0	0	2
OG0029773	0	1	0	0	1	0	0	2
OG0029774	0	1	0	0	1	0	0	2
OG0029775	0	1	0	0	1	0	0	2
OG0029776	0	1	0	0	1	0	0	2
OG0029777	0	2	0	0	0	0	0	2
OG0029778	0	1	0	0	0	0	1	2
OG0029779	0	1	0	0	1	0	0	2
OG0029780	0	1	0	0	1	0	0	2
OG0029781	0	2	0	0	0	0	0	2
OG0029782	0	2	0	0	0	0	0	2
OG0029783	0	1	0	0	1	0	0	2
OG0029784	0	1	1	0	0	0	0	2
OG0029785	0	2	0	0	0	0	0	2
OG0029786	0	2	0	0	0	0	0	2
OG0029787	0	1	0	0	1	0	0	2
OG0029788	0	2	0	0	0	0	0	2
OG0029789	0	2	0	0	0	0	0	2
OG0029790	0	2	0	0	0	0	0	2
OG0029791	0	1	0	0	1	0	0	2
OG0029792	0	2	0	0	0	0	0	2
OG0029793	0	2	0	0	0	0	0	2
OG0029794	0	1	0	0	0	0	1	2
OG0029795	0	1	0	0	1	0	0	2
OG0029796	0	1	0	0	1	0	0	2
OG0029797	0	1	0	0	1	0	0	2
OG0029798	0	1	0	0	1	0	0	2
OG0029799	0	2	0	0	0	0	0	2
OG0029800	0	1	0	0	1	0	0	2
OG0029801	0	1	0	0	1	0	0	2
OG0029802	0	2	0	0	0	0	0	2
OG0029803	0	2	0	0	0	0	0	2
OG0029804	0	1	0	0	0	0	1	2
OG0029805	0	1	0	1	0	0	0	2
OG0029806	0	1	0	1	0	0	0	2
OG0029807	0	1	0	0	0	0	1	2
OG0029808	0	1	0	0	1	0	0	2
OG0029809	0	1	0	0	0	0	1	2
OG0029810	0	1	0	1	0	0	0	2
OG0029811	0	2	0	0	0	0	0	2
OG0029812	0	1	0	0	1	0	0	2
OG0029813	0	1	0	0	1	0	0	2
OG0029814	0	1	0	0	1	0	0	2
OG0029815	0	2	0	0	0	0	0	2
OG0029816	0	2	0	0	0	0	0	2
OG0029817	0	2	0	0	0	0	0	2
OG0029818	0	1	0	0	0	1	0	2
OG0029819	0	1	0	0	0	0	1	2
OG0029820	0	2	0	0	0	0	0	2
OG0029821	0	2	0	0	0	0	0	2
OG0029822	0	2	0	0	0	0	0	2
OG0029823	0	1	0	0	0	0	1	2
OG0029824	0	1	0	0	0	0	1	2
OG0029825	0	2	0	0	0	0	0	2
OG0029826	0	1	0	0	0	1	0	2
OG0029827	0	1	0	1	0	0	0	2
OG0029828	0	1	0	0	0	1	0	2
OG0029829	0	1	0	0	0	0	1	2
OG0029830	0	2	0	0	0	0	0	2
OG0029831	0	2	0	0	0	0	0	2
OG0029832	0	2	0	0	0	0	0	2
OG0029833	0	2	0	0	0	0	0	2
OG0029834	0	2	0	0	0	0	0	2
OG0029835	0	2	0	0	0	0	0	2
OG0029836	0	2	0	0	0	0	0	2
OG0029837	0	1	0	0	1	0	0	2
OG0029838	0	2	0	0	0	0	0	2
OG0029839	0	2	0	0	0	0	0	2
OG0029840	0	2	0	0	0	0	0	2
OG0029841	0	2	0	0	0	0	0	2
OG0029842	0	2	0	0	0	0	0	2
OG0029843	0	2	0	0	0	0	0	2
OG0029844	0	2	0	0	0	0	0	2
OG0029845	0	1	0	0	0	0	1	2
OG0029846	0	2	0	0	0	0	0	2
OG0029847	0	2	0	0	0	0	0	2
OG0029848	0	2	0	0	0	0	0	2
OG0029849	0	1	0	0	0	1	0	2
OG0029850	0	2	0	0	0	0	0	2
OG0029851	0	2	0	0	0	0	0	2
OG0029852	0	2	0	0	0	0	0	2
OG0029853	0	2	0	0	0	0	0	2
OG0029854	0	2	0	0	0	0	0	2
OG0029855	0	2	0	0	0	0	0	2
OG0029856	0	2	0	0	0	0	0	2
OG0029857	0	2	0	0	0	0	0	2
OG0029858	0	2	0	0	0	0	0	2
OG0029859	0	2	0	0	0	0	0	2
OG0029860	0	2	0	0	0	0	0	2
OG0029861	0	2	0	0	0	0	0	2
OG0029862	0	2	0	0	0	0	0	2
OG0029863	0	1	0	1	0	0	0	2
OG0029864	0	2	0	0	0	0	0	2
OG0029865	0	2	0	0	0	0	0	2
OG0029866	0	2	0	0	0	0	0	2
OG0029867	0	2	0	0	0	0	0	2
OG0029868	0	2	0	0	0	0	0	2
OG0029869	0	1	0	0	1	0	0	2
OG0029870	0	2	0	0	0	0	0	2
OG0029871	0	1	0	0	0	0	1	2
OG0029872	0	1	0	0	0	0	1	2
OG0029873	0	1	0	1	0	0	0	2
OG0029874	0	2	0	0	0	0	0	2
OG0029875	0	2	0	0	0	0	0	2
OG0029876	0	1	0	1	0	0	0	2
OG0029877	0	2	0	0	0	0	0	2
OG0029878	0	2	0	0	0	0	0	2
OG0029879	0	2	0	0	0	0	0	2
OG0029880	0	2	0	0	0	0	0	2
OG0029881	0	2	0	0	0	0	0	2
OG0029882	0	2	0	0	0	0	0	2
OG0029883	0	2	0	0	0	0	0	2
OG0029884	0	2	0	0	0	0	0	2
OG0029885	0	2	0	0	0	0	0	2
OG0029886	0	2	0	0	0	0	0	2
OG0029887	0	2	0	0	0	0	0	2
OG0029888	0	2	0	0	0	0	0	2
OG0029889	0	2	0	0	0	0	0	2
OG0029890	0	1	0	0	0	0	1	2
OG0029891	0	2	0	0	0	0	0	2
OG0029892	0	1	0	0	0	1	0	2
OG0029893	0	2	0	0	0	0	0	2
OG0029894	0	2	0	0	0	0	0	2
OG0029895	0	2	0	0	0	0	0	2
OG0029896	0	1	0	1	0	0	0	2
OG0029897	0	1	1	0	0	0	0	2
OG0029898	0	1	0	1	0	0	0	2
OG0029899	0	1	0	0	0	0	1	2
OG0029900	0	2	0	0	0	0	0	2
OG0029901	0	2	0	0	0	0	0	2
OG0029902	0	2	0	0	0	0	0	2
OG0029903	0	1	0	1	0	0	0	2
OG0029904	0	1	1	0	0	0	0	2
OG0029905	0	2	0	0	0	0	0	2
OG0029906	0	2	0	0	0	0	0	2
OG0029907	0	2	0	0	0	0	0	2
OG0029908	0	1	0	1	0	0	0	2
OG0029909	0	1	0	0	1	0	0	2
OG0029910	0	1	0	0	0	0	1	2
OG0029911	0	1	0	0	0	0	1	2
OG0029912	0	1	0	0	1	0	0	2
OG0029913	0	1	0	0	0	0	1	2
OG0029914	0	1	0	1	0	0	0	2
OG0029915	0	2	0	0	0	0	0	2
OG0029916	0	1	0	1	0	0	0	2
OG0029917	0	2	0	0	0	0	0	2
OG0029918	0	2	0	0	0	0	0	2
OG0029919	0	1	0	0	1	0	0	2
OG0029920	0	1	0	0	1	0	0	2
OG0029921	0	2	0	0	0	0	0	2
OG0029922	0	2	0	0	0	0	0	2
OG0029923	0	2	0	0	0	0	0	2
OG0029924	0	2	0	0	0	0	0	2
OG0029925	0	1	0	0	0	0	1	2
OG0029926	0	1	0	0	1	0	0	2
OG0029927	0	1	0	0	1	0	0	2
OG0029928	0	2	0	0	0	0	0	2
OG0029929	0	2	0	0	0	0	0	2
OG0029930	0	1	0	0	0	0	1	2
OG0029931	0	2	0	0	0	0	0	2
OG0029932	0	2	0	0	0	0	0	2
OG0029933	0	2	0	0	0	0	0	2
OG0029934	0	2	0	0	0	0	0	2
OG0029935	0	2	0	0	0	0	0	2
OG0029936	0	2	0	0	0	0	0	2
OG0029937	0	2	0	0	0	0	0	2
OG0029938	0	2	0	0	0	0	0	2
OG0029939	0	2	0	0	0	0	0	2
OG0029940	0	2	0	0	0	0	0	2
OG0029941	0	2	0	0	0	0	0	2
OG0029942	0	2	0	0	0	0	0	2
OG0029943	0	1	1	0	0	0	0	2
OG0029944	0	2	0	0	0	0	0	2
OG0029945	0	2	0	0	0	0	0	2
OG0029946	0	2	0	0	0	0	0	2
OG0029947	0	1	0	0	0	1	0	2
OG0029948	0	1	0	1	0	0	0	2
OG0029949	0	2	0	0	0	0	0	2
OG0029950	0	2	0	0	0	0	0	2
OG0029951	0	2	0	0	0	0	0	2
OG0029952	0	1	0	1	0	0	0	2
OG0029953	0	2	0	0	0	0	0	2
OG0029954	0	1	0	1	0	0	0	2
OG0029955	0	1	0	1	0	0	0	2
OG0029956	0	2	0	0	0	0	0	2
OG0029957	0	1	0	0	1	0	0	2
OG0029958	0	2	0	0	0	0	0	2
OG0029959	0	2	0	0	0	0	0	2
OG0029960	0	1	1	0	0	0	0	2
OG0029961	0	2	0	0	0	0	0	2
OG0029962	0	1	0	0	1	0	0	2
OG0029963	0	2	0	0	0	0	0	2
OG0029964	0	2	0	0	0	0	0	2
OG0029965	0	1	0	0	0	0	1	2
OG0029966	0	1	1	0	0	0	0	2
OG0029967	0	1	0	0	1	0	0	2
OG0029968	0	1	0	0	0	0	1	2
OG0029969	0	2	0	0	0	0	0	2
OG0029970	0	2	0	0	0	0	0	2
OG0029971	0	2	0	0	0	0	0	2
OG0029972	0	2	0	0	0	0	0	2
OG0029973	0	2	0	0	0	0	0	2
OG0029974	0	1	0	0	1	0	0	2
OG0029975	0	2	0	0	0	0	0	2
OG0029976	0	1	0	1	0	0	0	2
OG0029977	0	1	0	1	0	0	0	2
OG0029978	0	2	0	0	0	0	0	2
OG0029979	0	1	0	0	0	0	1	2
OG0029980	0	2	0	0	0	0	0	2
OG0029981	0	2	0	0	0	0	0	2
OG0029982	0	1	0	1	0	0	0	2
OG0029983	0	1	0	0	0	1	0	2
OG0029984	0	1	0	1	0	0	0	2
OG0029985	0	1	0	0	0	0	1	2
OG0029986	0	2	0	0	0	0	0	2
OG0029987	0	1	0	1	0	0	0	2
OG0029988	0	2	0	0	0	0	0	2
OG0029989	0	1	0	0	0	1	0	2
OG0029990	0	1	0	1	0	0	0	2
OG0029991	0	2	0	0	0	0	0	2
OG0029992	0	2	0	0	0	0	0	2
OG0029993	0	2	0	0	0	0	0	2
OG0029994	0	2	0	0	0	0	0	2
OG0029995	0	2	0	0	0	0	0	2
OG0029996	0	1	0	1	0	0	0	2
OG0029997	0	1	0	0	0	1	0	2
OG0029998	0	2	0	0	0	0	0	2
OG0029999	0	1	0	1	0	0	0	2
OG0030000	0	2	0	0	0	0	0	2
OG0030001	0	2	0	0	0	0	0	2
OG0030002	0	1	0	1	0	0	0	2
OG0030003	0	1	0	1	0	0	0	2
OG0030004	0	2	0	0	0	0	0	2
OG0030005	0	1	0	1	0	0	0	2
OG0030006	0	1	0	1	0	0	0	2
OG0030007	0	2	0	0	0	0	0	2
OG0030008	0	2	0	0	0	0	0	2
OG0030009	0	2	0	0	0	0	0	2
OG0030010	0	2	0	0	0	0	0	2
OG0030011	0	2	0	0	0	0	0	2
OG0030012	0	2	0	0	0	0	0	2
OG0030013	0	1	1	0	0	0	0	2
OG0030014	0	2	0	0	0	0	0	2
OG0030015	0	1	0	1	0	0	0	2
OG0030016	0	2	0	0	0	0	0	2
OG0030017	0	2	0	0	0	0	0	2
OG0030018	0	1	0	1	0	0	0	2
OG0030019	0	2	0	0	0	0	0	2
OG0030020	0	1	1	0	0	0	0	2
OG0030021	0	2	0	0	0	0	0	2
OG0030022	0	1	0	0	0	0	1	2
OG0030023	0	2	0	0	0	0	0	2
OG0030024	0	2	0	0	0	0	0	2
OG0030025	0	2	0	0	0	0	0	2
OG0030026	0	1	0	0	1	0	0	2
OG0030027	0	1	0	0	1	0	0	2
OG0030028	0	1	0	0	1	0	0	2
OG0030029	0	2	0	0	0	0	0	2
OG0030030	0	1	0	0	0	0	1	2
OG0030031	0	1	0	1	0	0	0	2
OG0030032	0	2	0	0	0	0	0	2
OG0030033	0	2	0	0	0	0	0	2
OG0030034	0	1	0	0	0	0	1	2
OG0030035	0	2	0	0	0	0	0	2
OG0030036	0	2	0	0	0	0	0	2
OG0030037	0	1	0	1	0	0	0	2
OG0030038	0	2	0	0	0	0	0	2
OG0030039	0	2	0	0	0	0	0	2
OG0030040	0	2	0	0	0	0	0	2
OG0030041	0	1	0	0	0	0	1	2
OG0030042	0	1	0	1	0	0	0	2
OG0030043	0	1	0	1	0	0	0	2
OG0030044	0	2	0	0	0	0	0	2
OG0030045	0	2	0	0	0	0	0	2
OG0030046	0	2	0	0	0	0	0	2
OG0030047	0	2	0	0	0	0	0	2
OG0030048	0	2	0	0	0	0	0	2
OG0030049	0	2	0	0	0	0	0	2
OG0030050	0	2	0	0	0	0	0	2
OG0030051	0	2	0	0	0	0	0	2
OG0030052	0	1	0	1	0	0	0	2
OG0030053	0	1	0	1	0	0	0	2
OG0030054	0	2	0	0	0	0	0	2
OG0030055	0	2	0	0	0	0	0	2
OG0030056	0	2	0	0	0	0	0	2
OG0030057	0	2	0	0	0	0	0	2
OG0030058	0	2	0	0	0	0	0	2
OG0030059	0	2	0	0	0	0	0	2
OG0030060	0	2	0	0	0	0	0	2
OG0030061	0	2	0	0	0	0	0	2
OG0030062	0	1	0	1	0	0	0	2
OG0030063	0	2	0	0	0	0	0	2
OG0030064	0	2	0	0	0	0	0	2
OG0030065	0	2	0	0	0	0	0	2
OG0030066	0	2	0	0	0	0	0	2
OG0030067	0	1	0	0	1	0	0	2
OG0030068	0	2	0	0	0	0	0	2
OG0030069	0	1	0	1	0	0	0	2
OG0030070	0	1	0	1	0	0	0	2
OG0030071	0	2	0	0	0	0	0	2
OG0030072	0	1	1	0	0	0	0	2
OG0030073	0	2	0	0	0	0	0	2
OG0030074	0	1	0	1	0	0	0	2
OG0030075	0	1	0	1	0	0	0	2
OG0030076	0	2	0	0	0	0	0	2
OG0030077	0	1	0	1	0	0	0	2
OG0030078	0	2	0	0	0	0	0	2
OG0030079	0	2	0	0	0	0	0	2
OG0030080	0	2	0	0	0	0	0	2
OG0030081	0	2	0	0	0	0	0	2
OG0030082	0	2	0	0	0	0	0	2
OG0030083	0	2	0	0	0	0	0	2
OG0030084	0	2	0	0	0	0	0	2
OG0030085	0	2	0	0	0	0	0	2
OG0030086	0	2	0	0	0	0	0	2
OG0030087	0	2	0	0	0	0	0	2
OG0030088	0	2	0	0	0	0	0	2
OG0030089	0	2	0	0	0	0	0	2
OG0030090	0	1	0	1	0	0	0	2
OG0030091	0	2	0	0	0	0	0	2
OG0030092	0	1	0	1	0	0	0	2
OG0030093	0	1	0	1	0	0	0	2
OG0030094	0	1	0	1	0	0	0	2
OG0030095	0	1	0	1	0	0	0	2
OG0030096	0	1	0	1	0	0	0	2
OG0030097	0	1	0	1	0	0	0	2
OG0030098	0	1	0	0	0	0	1	2
OG0030099	0	2	0	0	0	0	0	2
OG0030100	0	1	0	1	0	0	0	2
OG0030101	0	2	0	0	0	0	0	2
OG0030102	0	1	0	0	0	0	1	2
OG0030103	0	2	0	0	0	0	0	2
OG0030104	0	2	0	0	0	0	0	2
OG0030105	0	1	0	1	0	0	0	2
OG0030106	0	2	0	0	0	0	0	2
OG0030107	0	1	0	0	1	0	0	2
OG0030108	0	1	1	0	0	0	0	2
OG0030109	0	1	0	0	0	0	1	2
OG0030110	0	2	0	0	0	0	0	2
OG0030111	0	2	0	0	0	0	0	2
OG0030112	0	1	0	0	0	1	0	2
OG0030113	0	1	0	1	0	0	0	2
OG0030114	0	2	0	0	0	0	0	2
OG0030115	0	1	0	1	0	0	0	2
OG0030116	0	2	0	0	0	0	0	2
OG0030117	0	2	0	0	0	0	0	2
OG0030118	0	2	0	0	0	0	0	2
OG0030119	0	2	0	0	0	0	0	2
OG0030120	0	1	0	1	0	0	0	2
OG0030121	0	2	0	0	0	0	0	2
OG0030122	0	1	0	0	0	0	1	2
OG0030123	0	1	0	0	0	1	0	2
OG0030124	0	1	0	0	0	0	1	2
OG0030125	0	2	0	0	0	0	0	2
OG0030126	0	2	0	0	0	0	0	2
OG0030127	0	1	0	0	0	0	1	2
OG0030128	0	1	0	0	1	0	0	2
OG0030129	0	2	0	0	0	0	0	2
OG0030130	0	1	0	0	1	0	0	2
OG0030131	0	1	0	0	1	0	0	2
OG0030132	0	1	0	0	1	0	0	2
OG0030133	0	2	0	0	0	0	0	2
OG0030134	0	2	0	0	0	0	0	2
OG0030135	0	2	0	0	0	0	0	2
OG0030136	0	2	0	0	0	0	0	2
OG0030137	0	2	0	0	0	0	0	2
OG0030138	0	1	0	0	0	1	0	2
OG0030139	0	1	0	0	0	0	1	2
OG0030140	0	2	0	0	0	0	0	2
OG0030141	0	1	1	0	0	0	0	2
OG0030142	0	1	1	0	0	0	0	2
OG0030143	0	2	0	0	0	0	0	2
OG0030144	0	2	0	0	0	0	0	2
OG0030145	0	2	0	0	0	0	0	2
OG0030146	0	1	0	1	0	0	0	2
OG0030147	0	1	0	1	0	0	0	2
OG0030148	0	1	0	1	0	0	0	2
OG0030149	0	1	0	1	0	0	0	2
OG0030150	0	2	0	0	0	0	0	2
OG0030151	0	2	0	0	0	0	0	2
OG0030152	0	2	0	0	0	0	0	2
OG0030153	0	1	0	0	1	0	0	2
OG0030154	0	1	0	0	0	1	0	2
OG0030155	0	2	0	0	0	0	0	2
OG0030156	0	2	0	0	0	0	0	2
OG0030157	0	2	0	0	0	0	0	2
OG0030158	0	2	0	0	0	0	0	2
OG0030159	0	1	0	0	0	0	1	2
OG0030160	0	2	0	0	0	0	0	2
OG0030161	0	2	0	0	0	0	0	2
OG0030162	0	1	0	0	1	0	0	2
OG0030163	0	2	0	0	0	0	0	2
OG0030164	0	2	0	0	0	0	0	2
OG0030165	0	2	0	0	0	0	0	2
OG0030166	0	1	0	0	1	0	0	2
OG0030167	0	2	0	0	0	0	0	2
OG0030168	0	2	0	0	0	0	0	2
OG0030169	0	1	0	0	1	0	0	2
OG0030170	0	1	0	0	0	0	1	2
OG0030171	0	2	0	0	0	0	0	2
OG0030172	0	1	0	0	1	0	0	2
OG0030173	0	2	0	0	0	0	0	2
OG0030174	0	2	0	0	0	0	0	2
OG0030175	0	1	0	0	1	0	0	2
OG0030176	0	2	0	0	0	0	0	2
OG0030177	0	2	0	0	0	0	0	2
OG0030178	0	1	0	0	0	0	1	2
OG0030179	0	2	0	0	0	0	0	2
OG0030180	0	1	0	0	0	0	1	2
OG0030181	0	1	0	0	1	0	0	2
OG0030182	0	2	0	0	0	0	0	2
OG0030183	0	1	0	0	1	0	0	2
OG0030184	0	2	0	0	0	0	0	2
OG0030185	0	1	0	0	0	0	1	2
OG0030186	0	1	0	0	1	0	0	2
OG0030187	0	2	0	0	0	0	0	2
OG0030188	0	2	0	0	0	0	0	2
OG0030189	0	2	0	0	0	0	0	2
OG0030190	0	2	0	0	0	0	0	2
OG0030191	0	2	0	0	0	0	0	2
OG0030192	0	2	0	0	0	0	0	2
OG0030193	0	2	0	0	0	0	0	2
OG0030194	0	2	0	0	0	0	0	2
OG0030195	0	2	0	0	0	0	0	2
OG0030196	0	2	0	0	0	0	0	2
OG0030197	0	1	0	0	1	0	0	2
OG0030198	0	2	0	0	0	0	0	2
OG0030199	0	2	0	0	0	0	0	2
OG0030200	0	2	0	0	0	0	0	2
OG0030201	0	2	0	0	0	0	0	2
OG0030202	0	2	0	0	0	0	0	2
OG0030203	0	1	0	0	0	0	1	2
OG0030204	0	2	0	0	0	0	0	2
OG0030205	0	2	0	0	0	0	0	2
OG0030206	0	2	0	0	0	0	0	2
OG0030207	0	1	0	0	0	0	1	2
OG0030208	0	1	0	1	0	0	0	2
OG0030209	0	2	0	0	0	0	0	2
OG0030210	0	1	0	0	0	0	1	2
OG0030211	0	1	0	0	0	0	1	2
OG0030212	0	2	0	0	0	0	0	2
OG0030213	0	2	0	0	0	0	0	2
OG0030214	0	2	0	0	0	0	0	2
OG0030215	0	2	0	0	0	0	0	2
OG0030216	0	1	0	0	1	0	0	2
OG0030217	0	2	0	0	0	0	0	2
OG0030218	0	1	0	0	1	0	0	2
OG0030219	0	1	0	0	1	0	0	2
OG0030220	0	1	0	0	1	0	0	2
OG0030221	0	2	0	0	0	0	0	2
OG0030222	0	2	0	0	0	0	0	2
OG0030223	0	1	0	0	1	0	0	2
OG0030224	0	2	0	0	0	0	0	2
OG0030225	0	1	0	0	0	0	1	2
OG0030226	0	1	0	0	1	0	0	2
OG0030227	0	2	0	0	0	0	0	2
OG0030228	0	2	0	0	0	0	0	2
OG0030229	0	1	0	0	0	0	1	2
OG0030230	0	2	0	0	0	0	0	2
OG0030231	0	2	0	0	0	0	0	2
OG0030232	0	1	0	1	0	0	0	2
OG0030233	0	1	0	1	0	0	0	2
OG0030234	0	1	1	0	0	0	0	2
OG0030235	0	1	0	1	0	0	0	2
OG0030236	0	2	0	0	0	0	0	2
OG0030237	0	1	0	1	0	0	0	2
OG0030238	0	2	0	0	0	0	0	2
OG0030239	0	2	0	0	0	0	0	2
OG0030240	0	2	0	0	0	0	0	2
OG0030241	0	2	0	0	0	0	0	2
OG0030242	0	1	1	0	0	0	0	2
OG0030243	0	2	0	0	0	0	0	2
OG0030244	0	1	0	0	0	0	1	2
OG0030245	0	2	0	0	0	0	0	2
OG0030246	0	1	0	1	0	0	0	2
OG0030247	0	1	0	1	0	0	0	2
OG0030248	0	1	0	1	0	0	0	2
OG0030249	0	1	0	1	0	0	0	2
OG0030250	0	1	0	1	0	0	0	2
OG0030251	0	1	0	1	0	0	0	2
OG0030252	0	1	1	0	0	0	0	2
OG0030253	0	1	0	0	0	0	1	2
OG0030254	0	1	0	1	0	0	0	2
OG0030255	0	1	0	0	1	0	0	2
OG0030256	0	1	0	1	0	0	0	2
OG0030257	0	2	0	0	0	0	0	2
OG0030258	0	2	0	0	0	0	0	2
OG0030259	0	2	0	0	0	0	0	2
OG0030260	0	2	0	0	0	0	0	2
OG0030261	0	2	0	0	0	0	0	2
OG0030262	0	1	0	0	0	1	0	2
OG0030263	0	1	0	0	0	0	1	2
OG0030264	0	1	0	0	0	0	1	2
OG0030265	0	1	0	0	0	0	1	2
OG0030266	0	2	0	0	0	0	0	2
OG0030267	0	1	0	0	1	0	0	2
OG0030268	0	1	0	0	1	0	0	2
OG0030269	0	1	0	0	0	0	1	2
OG0030270	0	1	0	0	1	0	0	2
OG0030271	0	2	0	0	0	0	0	2
OG0030272	0	1	0	0	1	0	0	2
OG0030273	0	1	0	0	0	0	1	2
OG0030274	0	1	0	0	0	1	0	2
OG0030275	0	2	0	0	0	0	0	2
OG0030276	0	2	0	0	0	0	0	2
OG0030277	0	2	0	0	0	0	0	2
OG0030278	0	2	0	0	0	0	0	2
OG0030279	0	1	0	1	0	0	0	2
OG0030280	0	2	0	0	0	0	0	2
OG0030281	0	2	0	0	0	0	0	2
OG0030282	0	1	0	0	1	0	0	2
OG0030283	0	1	0	0	1	0	0	2
OG0030284	0	2	0	0	0	0	0	2
OG0030285	0	2	0	0	0	0	0	2
OG0030286	0	2	0	0	0	0	0	2
OG0030287	0	2	0	0	0	0	0	2
OG0030288	0	2	0	0	0	0	0	2
OG0030289	0	2	0	0	0	0	0	2
OG0030290	0	2	0	0	0	0	0	2
OG0030291	0	1	0	0	1	0	0	2
OG0030292	0	1	0	0	1	0	0	2
OG0030293	0	1	0	0	1	0	0	2
OG0030294	0	1	0	0	1	0	0	2
OG0030295	0	1	0	0	1	0	0	2
OG0030296	0	2	0	0	0	0	0	2
OG0030297	0	1	0	0	1	0	0	2
OG0030298	0	1	0	0	1	0	0	2
OG0030299	0	1	0	0	0	0	1	2
OG0030300	0	1	0	0	1	0	0	2
OG0030301	0	1	0	0	1	0	0	2
OG0030302	0	1	0	0	1	0	0	2
OG0030303	0	2	0	0	0	0	0	2
OG0030304	0	1	0	1	0	0	0	2
OG0030305	0	1	0	1	0	0	0	2
OG0030306	0	1	0	0	0	1	0	2
OG0030307	0	2	0	0	0	0	0	2
OG0030308	0	1	0	1	0	0	0	2
OG0030309	0	2	0	0	0	0	0	2
OG0030310	0	2	0	0	0	0	0	2
OG0030311	0	2	0	0	0	0	0	2
OG0030312	0	2	0	0	0	0	0	2
OG0030313	0	2	0	0	0	0	0	2
OG0030314	0	2	0	0	0	0	0	2
OG0030315	0	2	0	0	0	0	0	2
OG0030316	0	1	0	1	0	0	0	2
OG0030317	0	2	0	0	0	0	0	2
OG0030318	0	1	0	1	0	0	0	2
OG0030319	0	2	0	0	0	0	0	2
OG0030320	0	1	0	0	1	0	0	2
OG0030321	0	2	0	0	0	0	0	2
OG0030322	0	2	0	0	0	0	0	2
OG0030323	0	2	0	0	0	0	0	2
OG0030324	0	2	0	0	0	0	0	2
OG0030325	0	1	1	0	0	0	0	2
OG0030326	0	2	0	0	0	0	0	2
OG0030327	0	2	0	0	0	0	0	2
OG0030328	0	2	0	0	0	0	0	2
OG0030329	0	2	0	0	0	0	0	2
OG0030330	0	2	0	0	0	0	0	2
OG0030331	0	1	1	0	0	0	0	2
OG0030332	0	2	0	0	0	0	0	2
OG0030333	0	2	0	0	0	0	0	2
OG0030334	0	1	0	0	0	0	1	2
OG0030335	0	2	0	0	0	0	0	2
OG0030336	0	1	0	0	1	0	0	2
OG0030337	0	1	0	0	1	0	0	2
OG0030338	0	2	0	0	0	0	0	2
OG0030339	0	2	0	0	0	0	0	2
OG0030340	0	2	0	0	0	0	0	2
OG0030341	0	2	0	0	0	0	0	2
OG0030342	0	1	0	0	1	0	0	2
OG0030343	0	2	0	0	0	0	0	2
OG0030344	0	1	0	0	1	0	0	2
OG0030345	0	1	1	0	0	0	0	2
OG0030346	0	2	0	0	0	0	0	2
OG0030347	0	2	0	0	0	0	0	2
OG0030348	0	2	0	0	0	0	0	2
OG0030349	0	2	0	0	0	0	0	2
OG0030350	0	2	0	0	0	0	0	2
OG0030351	0	1	0	0	0	0	1	2
OG0030352	0	1	0	0	0	0	1	2
OG0030353	0	1	0	0	1	0	0	2
OG0030354	0	2	0	0	0	0	0	2
OG0030355	0	2	0	0	0	0	0	2
OG0030356	0	1	0	0	1	0	0	2
OG0030357	0	2	0	0	0	0	0	2
OG0030358	0	1	0	1	0	0	0	2
OG0030359	0	2	0	0	0	0	0	2
OG0030360	0	1	1	0	0	0	0	2
OG0030361	0	2	0	0	0	0	0	2
OG0030362	0	2	0	0	0	0	0	2
OG0030363	0	1	1	0	0	0	0	2
OG0030364	0	2	0	0	0	0	0	2
OG0030365	0	1	0	0	0	0	1	2
OG0030366	0	1	0	0	0	0	1	2
OG0030367	0	2	0	0	0	0	0	2
OG0030368	0	1	0	1	0	0	0	2
OG0030369	0	2	0	0	0	0	0	2
OG0030370	0	2	0	0	0	0	0	2
OG0030371	0	2	0	0	0	0	0	2
OG0030372	0	2	0	0	0	0	0	2
OG0030373	0	2	0	0	0	0	0	2
OG0030374	0	1	0	0	1	0	0	2
OG0030375	0	2	0	0	0	0	0	2
OG0030376	0	2	0	0	0	0	0	2
OG0030377	0	1	0	0	1	0	0	2
OG0030378	0	2	0	0	0	0	0	2
OG0030379	0	1	0	0	0	0	1	2
OG0030380	0	2	0	0	0	0	0	2
OG0030381	0	1	0	0	1	0	0	2
OG0030382	0	2	0	0	0	0	0	2
OG0030383	0	1	0	1	0	0	0	2
OG0030384	0	2	0	0	0	0	0	2
OG0030385	0	1	0	0	1	0	0	2
OG0030386	0	1	0	1	0	0	0	2
OG0030387	0	1	0	1	0	0	0	2
OG0030388	0	2	0	0	0	0	0	2
OG0030389	0	1	0	0	0	1	0	2
OG0030390	0	2	0	0	0	0	0	2
OG0030391	0	2	0	0	0	0	0	2
OG0030392	0	1	0	0	1	0	0	2
OG0030393	0	1	0	1	0	0	0	2
OG0030394	0	1	1	0	0	0	0	2
OG0030395	0	2	0	0	0	0	0	2
OG0030396	0	2	0	0	0	0	0	2
OG0030397	0	2	0	0	0	0	0	2
OG0030398	0	2	0	0	0	0	0	2
OG0030399	0	1	0	0	1	0	0	2
OG0030400	0	2	0	0	0	0	0	2
OG0030401	0	2	0	0	0	0	0	2
OG0030402	0	2	0	0	0	0	0	2
OG0030403	0	1	0	0	1	0	0	2
OG0030404	0	2	0	0	0	0	0	2
OG0030405	0	2	0	0	0	0	0	2
OG0030406	0	1	0	0	1	0	0	2
OG0030407	0	1	0	1	0	0	0	2
OG0030408	0	1	0	1	0	0	0	2
OG0030409	0	2	0	0	0	0	0	2
OG0030410	0	1	0	0	0	0	1	2
OG0030411	0	2	0	0	0	0	0	2
OG0030412	0	2	0	0	0	0	0	2
OG0030413	0	2	0	0	0	0	0	2
OG0030414	0	2	0	0	0	0	0	2
OG0030415	0	2	0	0	0	0	0	2
OG0030416	0	1	1	0	0	0	0	2
OG0030417	0	2	0	0	0	0	0	2
OG0030418	0	1	0	1	0	0	0	2
OG0030419	0	1	0	0	0	0	1	2
OG0030420	0	1	0	1	0	0	0	2
OG0030421	0	1	0	1	0	0	0	2
OG0030422	0	2	0	0	0	0	0	2
OG0030423	0	2	0	0	0	0	0	2
OG0030424	0	2	0	0	0	0	0	2
OG0030425	0	1	0	0	1	0	0	2
OG0030426	0	1	0	0	1	0	0	2
OG0030427	0	2	0	0	0	0	0	2
OG0030428	0	2	0	0	0	0	0	2
OG0030429	0	1	0	0	1	0	0	2
OG0030430	0	1	0	0	1	0	0	2
OG0030431	0	1	0	0	1	0	0	2
OG0030432	0	1	0	0	0	0	1	2
OG0030433	0	2	0	0	0	0	0	2
OG0030434	0	2	0	0	0	0	0	2
OG0030435	0	2	0	0	0	0	0	2
OG0030436	0	1	0	0	1	0	0	2
OG0030437	0	2	0	0	0	0	0	2
OG0030438	0	1	0	0	1	0	0	2
OG0030439	0	2	0	0	0	0	0	2
OG0030440	0	1	0	1	0	0	0	2
OG0030441	0	2	0	0	0	0	0	2
OG0030442	0	1	0	0	1	0	0	2
OG0030443	0	1	0	0	1	0	0	2
OG0030444	0	1	0	0	0	0	1	2
OG0030445	0	2	0	0	0	0	0	2
OG0030446	0	2	0	0	0	0	0	2
OG0030447	0	2	0	0	0	0	0	2
OG0030448	0	2	0	0	0	0	0	2
OG0030449	0	2	0	0	0	0	0	2
OG0030450	0	2	0	0	0	0	0	2
OG0030451	0	2	0	0	0	0	0	2
OG0030452	0	1	0	1	0	0	0	2
OG0030453	0	2	0	0	0	0	0	2
OG0030454	0	1	1	0	0	0	0	2
OG0030455	0	2	0	0	0	0	0	2
OG0030456	0	1	0	0	1	0	0	2
OG0030457	0	1	0	0	1	0	0	2
OG0030458	0	1	1	0	0	0	0	2
OG0030459	0	1	0	0	1	0	0	2
OG0030460	0	2	0	0	0	0	0	2
OG0030461	0	2	0	0	0	0	0	2
OG0030462	0	2	0	0	0	0	0	2
OG0030463	0	1	0	1	0	0	0	2
OG0030464	0	2	0	0	0	0	0	2
OG0030465	0	2	0	0	0	0	0	2
OG0030466	0	1	0	0	1	0	0	2
OG0030467	0	1	0	1	0	0	0	2
OG0030468	0	1	0	1	0	0	0	2
OG0030469	0	1	0	1	0	0	0	2
OG0030470	0	1	0	0	0	0	1	2
OG0030471	0	2	0	0	0	0	0	2
OG0030472	0	2	0	0	0	0	0	2
OG0030473	0	2	0	0	0	0	0	2
OG0030474	0	2	0	0	0	0	0	2
OG0030475	0	1	0	0	0	0	1	2
OG0030476	0	2	0	0	0	0	0	2
OG0030477	0	1	0	1	0	0	0	2
OG0030478	0	2	0	0	0	0	0	2
OG0030479	0	1	0	0	1	0	0	2
OG0030480	0	1	0	0	1	0	0	2
OG0030481	0	2	0	0	0	0	0	2
OG0030482	0	2	0	0	0	0	0	2
OG0030483	0	2	0	0	0	0	0	2
OG0030484	0	2	0	0	0	0	0	2
OG0030485	0	2	0	0	0	0	0	2
OG0030486	0	1	1	0	0	0	0	2
OG0030487	0	1	0	0	1	0	0	2
OG0030488	0	2	0	0	0	0	0	2
OG0030489	0	2	0	0	0	0	0	2
OG0030490	0	2	0	0	0	0	0	2
OG0030491	0	2	0	0	0	0	0	2
OG0030492	0	1	0	0	1	0	0	2
OG0030493	0	2	0	0	0	0	0	2
OG0030494	0	2	0	0	0	0	0	2
OG0030495	0	1	1	0	0	0	0	2
OG0030496	0	1	1	0	0	0	0	2
OG0030497	0	1	0	0	0	0	1	2
OG0030498	0	2	0	0	0	0	0	2
OG0030499	0	2	0	0	0	0	0	2
OG0030500	0	1	0	0	1	0	0	2
OG0030501	0	1	0	0	1	0	0	2
OG0030502	0	2	0	0	0	0	0	2
OG0030503	0	2	0	0	0	0	0	2
OG0030504	0	1	0	0	0	0	1	2
OG0030505	0	2	0	0	0	0	0	2
OG0030506	0	1	1	0	0	0	0	2
OG0030507	0	2	0	0	0	0	0	2
OG0030508	0	2	0	0	0	0	0	2
OG0030509	0	2	0	0	0	0	0	2
OG0030510	0	1	0	0	1	0	0	2
OG0030511	0	2	0	0	0	0	0	2
OG0030512	0	1	0	0	0	0	1	2
OG0030513	0	2	0	0	0	0	0	2
OG0030514	0	2	0	0	0	0	0	2
OG0030515	0	2	0	0	0	0	0	2
OG0030516	0	1	0	0	0	0	1	2
OG0030517	0	2	0	0	0	0	0	2
OG0030518	0	2	0	0	0	0	0	2
OG0030519	0	1	1	0	0	0	0	2
OG0030520	0	2	0	0	0	0	0	2
OG0030521	0	1	0	0	1	0	0	2
OG0030522	0	2	0	0	0	0	0	2
OG0030523	0	2	0	0	0	0	0	2
OG0030524	0	2	0	0	0	0	0	2
OG0030525	0	2	0	0	0	0	0	2
OG0030526	0	1	0	0	1	0	0	2
OG0030527	0	1	1	0	0	0	0	2
OG0030528	0	2	0	0	0	0	0	2
OG0030529	0	2	0	0	0	0	0	2
OG0030530	0	1	0	0	1	0	0	2
OG0030531	0	2	0	0	0	0	0	2
OG0030532	0	1	1	0	0	0	0	2
OG0030533	0	1	0	0	1	0	0	2
OG0030534	0	1	0	0	1	0	0	2
OG0030535	0	1	0	0	0	0	1	2
OG0030536	0	1	0	1	0	0	0	2
OG0030537	0	1	0	0	1	0	0	2
OG0030538	0	2	0	0	0	0	0	2
OG0030539	0	1	0	0	0	0	1	2
OG0030540	0	2	0	0	0	0	0	2
OG0030541	0	2	0	0	0	0	0	2
OG0030542	0	1	1	0	0	0	0	2
OG0030543	0	1	1	0	0	0	0	2
OG0030544	0	2	0	0	0	0	0	2
OG0030545	0	1	0	1	0	0	0	2
OG0030546	0	2	0	0	0	0	0	2
OG0030547	0	2	0	0	0	0	0	2
OG0030548	0	2	0	0	0	0	0	2
OG0030549	0	1	0	0	0	0	1	2
OG0030550	0	2	0	0	0	0	0	2
OG0030551	0	2	0	0	0	0	0	2
OG0030552	0	1	0	1	0	0	0	2
OG0030553	0	1	0	1	0	0	0	2
OG0030554	0	1	1	0	0	0	0	2
OG0030555	0	1	0	1	0	0	0	2
OG0030556	0	2	0	0	0	0	0	2
OG0030557	0	1	0	1	0	0	0	2
OG0030558	0	1	1	0	0	0	0	2
OG0030559	0	2	0	0	0	0	0	2
OG0030560	0	1	0	0	1	0	0	2
OG0030561	0	1	0	0	1	0	0	2
OG0030562	0	2	0	0	0	0	0	2
OG0030563	0	2	0	0	0	0	0	2
OG0030564	0	2	0	0	0	0	0	2
OG0030565	0	2	0	0	0	0	0	2
OG0030566	0	1	0	0	1	0	0	2
OG0030567	0	2	0	0	0	0	0	2
OG0030568	0	1	0	1	0	0	0	2
OG0030569	0	1	0	1	0	0	0	2
OG0030570	0	2	0	0	0	0	0	2
OG0030571	0	2	0	0	0	0	0	2
OG0030572	0	2	0	0	0	0	0	2
OG0030573	0	1	0	0	1	0	0	2
OG0030574	0	1	0	0	1	0	0	2
OG0030575	0	2	0	0	0	0	0	2
OG0030576	0	1	0	0	1	0	0	2
OG0030577	0	2	0	0	0	0	0	2
OG0030578	0	2	0	0	0	0	0	2
OG0030579	0	2	0	0	0	0	0	2
OG0030580	0	2	0	0	0	0	0	2
OG0030581	0	2	0	0	0	0	0	2
OG0030582	0	2	0	0	0	0	0	2
OG0030583	0	2	0	0	0	0	0	2
OG0030584	0	1	0	0	0	1	0	2
OG0030585	0	2	0	0	0	0	0	2
OG0030586	0	2	0	0	0	0	0	2
OG0030587	0	1	0	0	1	0	0	2
OG0030588	0	1	0	0	1	0	0	2
OG0030589	0	1	0	0	0	1	0	2
OG0030590	0	2	0	0	0	0	0	2
OG0030591	0	2	0	0	0	0	0	2
OG0030592	0	1	0	0	1	0	0	2
OG0030593	0	1	0	0	1	0	0	2
OG0030594	0	1	0	0	1	0	0	2
OG0030595	0	1	0	0	1	0	0	2
OG0030596	0	1	0	0	1	0	0	2
OG0030597	0	1	0	0	1	0	0	2
OG0030598	0	2	0	0	0	0	0	2
OG0030599	0	2	0	0	0	0	0	2
OG0030600	0	2	0	0	0	0	0	2
OG0030601	0	2	0	0	0	0	0	2
OG0030602	0	1	0	0	1	0	0	2
OG0030603	0	1	0	0	1	0	0	2
OG0030604	0	1	0	0	1	0	0	2
OG0030605	0	1	0	0	0	0	1	2
OG0030606	0	1	0	0	1	0	0	2
OG0030607	0	1	0	1	0	0	0	2
OG0030608	0	1	0	1	0	0	0	2
OG0030609	0	2	0	0	0	0	0	2
OG0030610	0	2	0	0	0	0	0	2
OG0030611	0	2	0	0	0	0	0	2
OG0030612	0	2	0	0	0	0	0	2
OG0030613	0	2	0	0	0	0	0	2
OG0030614	0	1	0	0	1	0	0	2
OG0030615	0	2	0	0	0	0	0	2
OG0030616	0	2	0	0	0	0	0	2
OG0030617	0	2	0	0	0	0	0	2
OG0030618	0	2	0	0	0	0	0	2
OG0030619	0	2	0	0	0	0	0	2
OG0030620	0	2	0	0	0	0	0	2
OG0030621	0	2	0	0	0	0	0	2
OG0030622	0	2	0	0	0	0	0	2
OG0030623	0	1	0	0	0	0	1	2
OG0030624	0	2	0	0	0	0	0	2
OG0030625	0	2	0	0	0	0	0	2
OG0030626	0	2	0	0	0	0	0	2
OG0030627	0	2	0	0	0	0	0	2
OG0030628	0	2	0	0	0	0	0	2
OG0030629	0	2	0	0	0	0	0	2
OG0030630	0	1	0	0	0	1	0	2
OG0030631	0	2	0	0	0	0	0	2
OG0030632	0	1	0	0	0	1	0	2
OG0030633	0	1	0	0	0	1	0	2
OG0030634	0	1	0	0	0	1	0	2
OG0030635	0	1	0	0	1	0	0	2
OG0030636	0	2	0	0	0	0	0	2
OG0030637	0	2	0	0	0	0	0	2
OG0030638	0	1	0	0	1	0	0	2
OG0030639	0	1	0	0	0	0	1	2
OG0030640	0	1	0	0	0	1	0	2
OG0030641	0	1	0	0	1	0	0	2
OG0030642	0	2	0	0	0	0	0	2
OG0030643	0	1	0	0	1	0	0	2
OG0030644	0	1	0	0	1	0	0	2
OG0030645	0	1	0	0	0	0	1	2
OG0030646	0	1	1	0	0	0	0	2
OG0030647	0	1	0	0	1	0	0	2
OG0030648	0	1	0	0	0	0	1	2
OG0030649	0	1	0	0	1	0	0	2
OG0030650	0	2	0	0	0	0	0	2
OG0030651	0	1	0	0	1	0	0	2
OG0030652	0	1	0	0	0	0	1	2
OG0030653	0	1	0	0	1	0	0	2
OG0030654	0	1	0	0	0	1	0	2
OG0030655	0	1	0	0	1	0	0	2
OG0030656	0	2	0	0	0	0	0	2
OG0030657	0	1	0	0	0	0	1	2
OG0030658	0	1	0	1	0	0	0	2
OG0030659	0	2	0	0	0	0	0	2
OG0030660	0	1	0	0	0	0	1	2
OG0030661	0	2	0	0	0	0	0	2
OG0030662	0	2	0	0	0	0	0	2
OG0030663	0	1	0	0	1	0	0	2
OG0030664	0	2	0	0	0	0	0	2
OG0030665	0	1	0	0	0	1	0	2
OG0030666	0	2	0	0	0	0	0	2
OG0030667	0	1	0	0	1	0	0	2
OG0030668	0	1	0	0	0	1	0	2
OG0030669	0	1	0	0	0	0	1	2
OG0030670	0	1	1	0	0	0	0	2
OG0030671	0	1	0	1	0	0	0	2
OG0030672	0	1	0	1	0	0	0	2
OG0030673	0	2	0	0	0	0	0	2
OG0030674	0	1	0	1	0	0	0	2
OG0030675	0	2	0	0	0	0	0	2
OG0030676	0	2	0	0	0	0	0	2
OG0030677	0	1	0	1	0	0	0	2
OG0030678	0	1	0	0	1	0	0	2
OG0030679	0	2	0	0	0	0	0	2
OG0030680	0	2	0	0	0	0	0	2
OG0030681	0	2	0	0	0	0	0	2
OG0030682	0	2	0	0	0	0	0	2
OG0030683	0	1	0	0	0	0	1	2
OG0030684	0	1	0	1	0	0	0	2
OG0030685	0	2	0	0	0	0	0	2
OG0030686	0	1	0	1	0	0	0	2
OG0030687	0	1	1	0	0	0	0	2
OG0030688	0	1	0	1	0	0	0	2
OG0030689	0	1	0	0	0	0	1	2
OG0030690	0	2	0	0	0	0	0	2
OG0030691	0	1	0	0	0	1	0	2
OG0030692	0	1	0	1	0	0	0	2
OG0030693	0	1	0	1	0	0	0	2
OG0030694	0	1	0	1	0	0	0	2
OG0030695	0	2	0	0	0	0	0	2
OG0030696	0	2	0	0	0	0	0	2
OG0030697	0	1	0	0	1	0	0	2
OG0030698	0	1	0	0	1	0	0	2
OG0030699	0	1	0	0	0	1	0	2
OG0030700	0	1	0	0	1	0	0	2
OG0030701	0	2	0	0	0	0	0	2
OG0030702	0	1	0	0	1	0	0	2
OG0030703	0	1	0	0	1	0	0	2
OG0030704	0	1	0	0	1	0	0	2
OG0030705	0	1	1	0	0	0	0	2
OG0030706	0	1	0	0	1	0	0	2
OG0030707	0	1	0	0	0	0	1	2
OG0030708	0	1	0	0	0	0	1	2
OG0030709	0	1	0	0	0	0	1	2
OG0030710	0	2	0	0	0	0	0	2
OG0030711	0	1	0	0	0	0	1	2
OG0030712	0	1	0	0	1	0	0	2
OG0030713	0	1	1	0	0	0	0	2
OG0030714	0	2	0	0	0	0	0	2
OG0030715	0	1	0	0	1	0	0	2
OG0030716	0	1	0	0	0	0	1	2
OG0030717	0	1	0	0	1	0	0	2
OG0030718	0	1	1	0	0	0	0	2
OG0030719	0	1	0	0	1	0	0	2
OG0030720	0	1	0	0	1	0	0	2
OG0030721	0	1	0	0	0	0	1	2
OG0030722	0	1	0	0	0	0	1	2
OG0030723	0	1	0	0	0	0	1	2
OG0030724	0	1	1	0	0	0	0	2
OG0030725	0	1	0	0	0	0	1	2
OG0030726	0	1	0	0	1	0	0	2
OG0030727	0	1	1	0	0	0	0	2
OG0030728	0	1	0	0	1	0	0	2
OG0030729	0	1	0	0	1	0	0	2
OG0030730	0	1	0	0	1	0	0	2
OG0030731	0	1	0	0	0	0	1	2
OG0030732	0	2	0	0	0	0	0	2
OG0030733	0	2	0	0	0	0	0	2
OG0030734	0	1	0	0	0	0	1	2
OG0030735	0	1	0	0	0	0	1	2
OG0030736	0	1	0	0	0	0	1	2
OG0030737	0	1	0	0	0	0	1	2
OG0030738	0	1	1	0	0	0	0	2
OG0030739	0	1	0	0	0	1	0	2
OG0030740	0	1	0	0	0	0	1	2
OG0030741	0	2	0	0	0	0	0	2
OG0030742	0	2	0	0	0	0	0	2
OG0030743	0	1	0	0	0	0	1	2
OG0030744	0	1	1	0	0	0	0	2
OG0030745	0	1	0	0	0	0	1	2
OG0030746	0	1	0	0	1	0	0	2
OG0030747	0	2	0	0	0	0	0	2
OG0030748	0	1	1	0	0	0	0	2
OG0030749	0	1	0	1	0	0	0	2
OG0030750	0	2	0	0	0	0	0	2
OG0030751	0	2	0	0	0	0	0	2
OG0030752	0	2	0	0	0	0	0	2
OG0030753	0	1	0	0	1	0	0	2
OG0030754	0	2	0	0	0	0	0	2
OG0030755	0	2	0	0	0	0	0	2
OG0030756	0	1	0	0	0	1	0	2
OG0030757	0	1	0	0	1	0	0	2
OG0030758	0	2	0	0	0	0	0	2
OG0030759	0	2	0	0	0	0	0	2
OG0030760	0	2	0	0	0	0	0	2
OG0030761	0	2	0	0	0	0	0	2
OG0030762	0	2	0	0	0	0	0	2
OG0030763	0	2	0	0	0	0	0	2
OG0030764	0	2	0	0	0	0	0	2
OG0030765	0	2	0	0	0	0	0	2
OG0030766	0	1	0	0	1	0	0	2
OG0030767	0	1	1	0	0	0	0	2
OG0030768	0	1	0	1	0	0	0	2
OG0030769	0	1	0	1	0	0	0	2
OG0030770	0	2	0	0	0	0	0	2
OG0030771	0	2	0	0	0	0	0	2
OG0030772	0	2	0	0	0	0	0	2
OG0030773	0	2	0	0	0	0	0	2
OG0030774	0	2	0	0	0	0	0	2
OG0030775	0	2	0	0	0	0	0	2
OG0030776	0	2	0	0	0	0	0	2
OG0030777	0	2	0	0	0	0	0	2
OG0030778	0	1	0	0	0	0	1	2
OG0030779	0	1	0	0	1	0	0	2
OG0030780	0	1	1	0	0	0	0	2
OG0030781	0	1	1	0	0	0	0	2
OG0030782	0	1	0	0	1	0	0	2
OG0030783	0	2	0	0	0	0	0	2
OG0030784	0	1	0	1	0	0	0	2
OG0030785	0	1	0	1	0	0	0	2
OG0030786	0	1	0	1	0	0	0	2
OG0030787	0	2	0	0	0	0	0	2
OG0030788	0	1	0	0	0	0	1	2
OG0030789	0	2	0	0	0	0	0	2
OG0030790	0	1	0	0	1	0	0	2
OG0030791	0	1	1	0	0	0	0	2
OG0030792	0	1	0	0	1	0	0	2
OG0030793	0	1	0	0	0	1	0	2
OG0030794	0	2	0	0	0	0	0	2
OG0030795	0	1	0	0	1	0	0	2
OG0030796	0	2	0	0	0	0	0	2
OG0030797	0	2	0	0	0	0	0	2
OG0030798	0	2	0	0	0	0	0	2
OG0030799	0	2	0	0	0	0	0	2
OG0030800	0	1	0	0	1	0	0	2
OG0030801	0	2	0	0	0	0	0	2
OG0030802	0	1	0	0	0	0	1	2
OG0030803	0	2	0	0	0	0	0	2
OG0030804	0	1	1	0	0	0	0	2
OG0030805	0	2	0	0	0	0	0	2
OG0030806	0	1	0	0	1	0	0	2
OG0030807	0	2	0	0	0	0	0	2
OG0030808	0	2	0	0	0	0	0	2
OG0030809	0	1	0	0	0	0	1	2
OG0030810	0	2	0	0	0	0	0	2
OG0030811	0	2	0	0	0	0	0	2
OG0030812	0	2	0	0	0	0	0	2
OG0030813	0	1	1	0	0	0	0	2
OG0030814	0	1	1	0	0	0	0	2
OG0030815	0	2	0	0	0	0	0	2
OG0030816	0	1	0	0	1	0	0	2
OG0030817	0	1	0	0	1	0	0	2
OG0030818	0	1	0	0	1	0	0	2
OG0030819	0	2	0	0	0	0	0	2
OG0030820	0	1	0	0	1	0	0	2
OG0030821	0	1	0	0	1	0	0	2
OG0030822	0	1	0	0	0	0	1	2
OG0030823	0	1	0	0	1	0	0	2
OG0030824	0	2	0	0	0	0	0	2
OG0030825	0	2	0	0	0	0	0	2
OG0030826	0	2	0	0	0	0	0	2
OG0030827	0	2	0	0	0	0	0	2
OG0030828	0	1	0	0	1	0	0	2
OG0030829	0	1	0	0	1	0	0	2
OG0030830	0	1	0	0	1	0	0	2
OG0030831	0	1	0	0	1	0	0	2
OG0030832	0	2	0	0	0	0	0	2
OG0030833	0	1	0	0	1	0	0	2
OG0030834	0	1	0	0	1	0	0	2
OG0030835	0	1	0	0	1	0	0	2
OG0030836	0	1	0	0	1	0	0	2
OG0030837	0	2	0	0	0	0	0	2
OG0030838	0	1	0	0	1	0	0	2
OG0030839	0	1	1	0	0	0	0	2
OG0030840	0	1	0	0	0	1	0	2
OG0030841	0	1	0	0	0	1	0	2
OG0030842	0	1	0	0	0	1	0	2
OG0030843	0	1	0	0	0	0	1	2
OG0030844	0	1	0	0	0	1	0	2
OG0030845	0	1	0	0	0	1	0	2
OG0030846	0	1	0	0	1	0	0	2
OG0030847	0	1	0	1	0	0	0	2
OG0030848	0	1	0	0	0	1	0	2
OG0030849	0	1	0	0	0	0	1	2
OG0030850	0	1	0	0	1	0	0	2
OG0030851	0	1	0	0	1	0	0	2
OG0030852	0	1	0	0	1	0	0	2
OG0030853	0	2	0	0	0	0	0	2
OG0030854	0	1	0	1	0	0	0	2
OG0030855	0	1	0	1	0	0	0	2
OG0030856	0	1	1	0	0	0	0	2
OG0030857	0	2	0	0	0	0	0	2
OG0030858	0	2	0	0	0	0	0	2
OG0030859	0	2	0	0	0	0	0	2
OG0030860	0	2	0	0	0	0	0	2
OG0030861	0	2	0	0	0	0	0	2
OG0030862	0	2	0	0	0	0	0	2
OG0030863	0	1	0	0	1	0	0	2
OG0030864	0	1	0	0	1	0	0	2
OG0030865	0	1	1	0	0	0	0	2
OG0030866	0	2	0	0	0	0	0	2
OG0030867	0	1	0	0	0	0	1	2
OG0030868	0	2	0	0	0	0	0	2
OG0030869	0	2	0	0	0	0	0	2
OG0030870	0	1	0	0	0	1	0	2
OG0030871	0	1	1	0	0	0	0	2
OG0030872	0	1	0	0	1	0	0	2
OG0030873	0	2	0	0	0	0	0	2
OG0030874	0	2	0	0	0	0	0	2
OG0030875	0	2	0	0	0	0	0	2
OG0030876	0	1	0	0	0	1	0	2
OG0030877	0	2	0	0	0	0	0	2
OG0030878	0	2	0	0	0	0	0	2
OG0030879	0	2	0	0	0	0	0	2
OG0030880	0	1	0	0	0	0	1	2
OG0030881	0	2	0	0	0	0	0	2
OG0030882	0	1	0	0	0	1	0	2
OG0030883	0	1	0	0	1	0	0	2
OG0030884	0	1	0	1	0	0	0	2
OG0030885	0	1	0	0	0	0	1	2
OG0030886	0	2	0	0	0	0	0	2
OG0030887	0	1	0	0	1	0	0	2
OG0030888	0	1	0	0	0	0	1	2
OG0030889	0	2	0	0	0	0	0	2
OG0030890	0	2	0	0	0	0	0	2
OG0030891	0	2	0	0	0	0	0	2
OG0030892	0	2	0	0	0	0	0	2
OG0030893	0	2	0	0	0	0	0	2
OG0030894	0	1	1	0	0	0	0	2
OG0030895	0	1	0	1	0	0	0	2
OG0030896	0	1	1	0	0	0	0	2
OG0030897	0	1	0	1	0	0	0	2
OG0030898	0	2	0	0	0	0	0	2
OG0030899	0	2	0	0	0	0	0	2
OG0030900	0	1	0	0	1	0	0	2
OG0030901	0	1	0	1	0	0	0	2
OG0030902	0	2	0	0	0	0	0	2
OG0030903	0	1	0	0	0	0	1	2
OG0030904	0	1	1	0	0	0	0	2
OG0030905	0	1	0	1	0	0	0	2
OG0030906	0	1	0	1	0	0	0	2
OG0030907	0	1	0	1	0	0	0	2
OG0030908	0	2	0	0	0	0	0	2
OG0030909	0	2	0	0	0	0	0	2
OG0030910	0	2	0	0	0	0	0	2
OG0030911	0	1	0	0	0	0	1	2
OG0030912	0	1	0	1	0	0	0	2
OG0030913	0	1	0	0	0	0	1	2
OG0030914	0	1	0	0	0	0	1	2
OG0030915	0	1	0	1	0	0	0	2
OG0030916	0	1	0	1	0	0	0	2
OG0030917	0	1	0	0	0	1	0	2
OG0030918	0	2	0	0	0	0	0	2
OG0030919	0	2	0	0	0	0	0	2
OG0030920	0	1	0	1	0	0	0	2
OG0030921	0	1	0	1	0	0	0	2
OG0030922	0	1	0	1	0	0	0	2
OG0030923	0	1	0	1	0	0	0	2
OG0030924	0	1	0	1	0	0	0	2
OG0030925	0	1	0	1	0	0	0	2
OG0030926	0	2	0	0	0	0	0	2
OG0030927	0	2	0	0	0	0	0	2
OG0030928	0	1	0	1	0	0	0	2
OG0030929	0	1	0	1	0	0	0	2
OG0030930	0	1	0	1	0	0	0	2
OG0030931	0	1	1	0	0	0	0	2
OG0030932	0	1	0	1	0	0	0	2
OG0030933	0	1	0	1	0	0	0	2
OG0030934	0	1	0	1	0	0	0	2
OG0030935	0	1	0	1	0	0	0	2
OG0030936	0	1	0	0	0	0	1	2
OG0030937	0	1	0	0	1	0	0	2
OG0030938	0	1	0	1	0	0	0	2
OG0030939	0	1	0	1	0	0	0	2
OG0030940	0	2	0	0	0	0	0	2
OG0030941	0	1	0	0	0	1	0	2
OG0030942	0	1	1	0	0	0	0	2
OG0030943	0	1	0	1	0	0	0	2
OG0030944	0	1	0	1	0	0	0	2
OG0030945	0	1	0	1	0	0	0	2
OG0030946	0	2	0	0	0	0	0	2
OG0030947	0	1	0	0	1	0	0	2
OG0030948	0	1	0	0	1	0	0	2
OG0030949	0	1	0	0	1	0	0	2
OG0030950	0	2	0	0	0	0	0	2
OG0030951	0	2	0	0	0	0	0	2
OG0030952	0	1	0	0	1	0	0	2
OG0030953	0	1	0	0	0	1	0	2
OG0030954	0	2	0	0	0	0	0	2
OG0030955	0	1	0	0	1	0	0	2
OG0030956	0	1	0	0	1	0	0	2
OG0030957	0	1	0	0	1	0	0	2
OG0030958	0	1	0	0	0	0	1	2
OG0030959	0	1	0	0	0	0	1	2
OG0030960	0	1	0	0	1	0	0	2
OG0030961	0	1	0	0	1	0	0	2
OG0030962	0	1	0	0	1	0	0	2
OG0030963	0	1	0	0	0	0	1	2
OG0030964	0	1	1	0	0	0	0	2
OG0030965	0	1	0	0	0	0	1	2
OG0030966	0	1	0	1	0	0	0	2
OG0030967	0	1	0	0	0	0	1	2
OG0030968	0	1	0	0	1	0	0	2
OG0030969	0	2	0	0	0	0	0	2
OG0030970	0	1	1	0	0	0	0	2
OG0030971	0	1	0	0	0	0	1	2
OG0030972	0	1	0	0	1	0	0	2
OG0030973	0	1	0	0	0	1	0	2
OG0030974	0	1	0	0	0	1	0	2
OG0030975	0	1	0	0	1	0	0	2
OG0030976	0	1	0	0	0	0	1	2
OG0030977	0	2	0	0	0	0	0	2
OG0030978	0	2	0	0	0	0	0	2
OG0030979	0	2	0	0	0	0	0	2
OG0030980	0	1	0	0	1	0	0	2
OG0030981	0	2	0	0	0	0	0	2
OG0030982	0	1	0	0	0	1	0	2
OG0030983	0	1	0	0	0	0	1	2
OG0030984	0	1	0	1	0	0	0	2
OG0030985	0	2	0	0	0	0	0	2
OG0030986	0	2	0	0	0	0	0	2
OG0030987	0	2	0	0	0	0	0	2
OG0030988	0	1	0	0	0	0	1	2
OG0030989	0	2	0	0	0	0	0	2
OG0030990	0	2	0	0	0	0	0	2
OG0030991	0	2	0	0	0	0	0	2
OG0030992	0	1	0	0	1	0	0	2
OG0030993	0	1	1	0	0	0	0	2
OG0030994	0	2	0	0	0	0	0	2
OG0030995	0	1	1	0	0	0	0	2
OG0030996	0	1	0	0	0	0	1	2
OG0030997	0	1	0	0	0	0	1	2
OG0030998	0	2	0	0	0	0	0	2
OG0030999	0	1	0	1	0	0	0	2
OG0031000	0	1	0	1	0	0	0	2
OG0031001	0	1	0	0	1	0	0	2
OG0031002	0	2	0	0	0	0	0	2
OG0031003	0	1	0	0	0	1	0	2
OG0031004	0	1	0	0	1	0	0	2
OG0031005	0	1	0	0	0	1	0	2
OG0031006	0	1	0	0	1	0	0	2
OG0031007	0	1	0	0	1	0	0	2
OG0031008	0	1	0	0	1	0	0	2
OG0031009	0	1	0	0	1	0	0	2
OG0031010	0	1	0	0	0	1	0	2
OG0031011	0	2	0	0	0	0	0	2
OG0031012	0	1	0	0	0	0	1	2
OG0031013	0	1	0	0	1	0	0	2
OG0031014	0	1	1	0	0	0	0	2
OG0031015	0	1	0	0	1	0	0	2
OG0031016	0	2	0	0	0	0	0	2
OG0031017	0	2	0	0	0	0	0	2
OG0031018	0	2	0	0	0	0	0	2
OG0031019	0	2	0	0	0	0	0	2
OG0031020	0	1	0	0	0	0	1	2
OG0031021	0	1	0	0	1	0	0	2
OG0031022	0	1	0	0	1	0	0	2
OG0031023	0	1	0	0	1	0	0	2
OG0031024	0	1	0	0	0	0	1	2
OG0031025	0	1	0	1	0	0	0	2
OG0031026	0	2	0	0	0	0	0	2
OG0031027	0	2	0	0	0	0	0	2
OG0031028	0	1	0	0	1	0	0	2
OG0031029	0	1	1	0	0	0	0	2
OG0031030	0	1	0	1	0	0	0	2
OG0031031	0	1	0	1	0	0	0	2
OG0031032	0	1	0	1	0	0	0	2
OG0031033	0	1	1	0	0	0	0	2
OG0031034	0	2	0	0	0	0	0	2
OG0031035	0	2	0	0	0	0	0	2
OG0031036	0	1	0	1	0	0	0	2
OG0031037	0	1	0	1	0	0	0	2
OG0031038	0	1	0	1	0	0	0	2
OG0031039	0	2	0	0	0	0	0	2
OG0031040	0	2	0	0	0	0	0	2
OG0031041	0	1	0	1	0	0	0	2
OG0031042	0	1	0	1	0	0	0	2
OG0031043	0	1	0	1	0	0	0	2
OG0031044	0	2	0	0	0	0	0	2
OG0031045	0	1	0	0	0	1	0	2
OG0031046	0	1	0	1	0	0	0	2
OG0031047	0	1	0	0	0	0	1	2
OG0031048	0	1	0	1	0	0	0	2
OG0031049	0	2	0	0	0	0	0	2
OG0031050	0	2	0	0	0	0	0	2
OG0031051	0	2	0	0	0	0	0	2
OG0031052	0	1	0	0	0	0	1	2
OG0031053	0	1	0	1	0	0	0	2
OG0031054	0	1	0	0	1	0	0	2
OG0031055	0	1	0	0	0	0	1	2
OG0031056	0	2	0	0	0	0	0	2
OG0031057	0	1	1	0	0	0	0	2
OG0031058	0	1	0	0	0	1	0	2
OG0031059	0	1	0	0	1	0	0	2
OG0031060	0	1	0	1	0	0	0	2
OG0031061	0	1	0	0	0	0	1	2
OG0031062	0	2	0	0	0	0	0	2
OG0031063	0	1	1	0	0	0	0	2
OG0031064	0	1	0	0	0	1	0	2
OG0031065	0	2	0	0	0	0	0	2
OG0031066	0	2	0	0	0	0	0	2
OG0031067	0	1	1	0	0	0	0	2
OG0031068	0	1	0	0	1	0	0	2
OG0031069	0	1	0	0	1	0	0	2
OG0031070	0	1	1	0	0	0	0	2
OG0031071	0	1	0	0	1	0	0	2
OG0031072	0	1	0	0	1	0	0	2
OG0031073	0	1	1	0	0	0	0	2
OG0031074	0	1	0	0	1	0	0	2
OG0031075	0	2	0	0	0	0	0	2
OG0031076	0	1	0	0	1	0	0	2
OG0031077	0	2	0	0	0	0	0	2
OG0031078	0	2	0	0	0	0	0	2
OG0031079	0	2	0	0	0	0	0	2
OG0031080	0	1	0	0	1	0	0	2
OG0031081	0	1	0	0	0	0	1	2
OG0031082	0	1	0	0	1	0	0	2
OG0031083	0	1	0	1	0	0	0	2
OG0031084	0	1	1	0	0	0	0	2
OG0031085	0	2	0	0	0	0	0	2
OG0031086	0	2	0	0	0	0	0	2
OG0031087	0	2	0	0	0	0	0	2
OG0031088	0	1	0	0	1	0	0	2
OG0031089	0	1	0	0	1	0	0	2
OG0031090	0	1	0	1	0	0	0	2
OG0031091	0	2	0	0	0	0	0	2
OG0031092	0	1	0	0	0	0	1	2
OG0031093	0	1	0	1	0	0	0	2
OG0031094	0	1	0	0	0	0	1	2
OG0031095	0	1	0	1	0	0	0	2
OG0031096	0	1	0	0	0	1	0	2
OG0031097	0	1	0	1	0	0	0	2
OG0031098	0	1	0	1	0	0	0	2
OG0031099	0	1	0	1	0	0	0	2
OG0031100	0	1	0	1	0	0	0	2
OG0031101	0	1	0	1	0	0	0	2
OG0031102	0	1	0	1	0	0	0	2
OG0031103	0	1	0	1	0	0	0	2
OG0031104	0	1	0	1	0	0	0	2
OG0031105	0	1	0	1	0	0	0	2
OG0031106	0	1	0	1	0	0	0	2
OG0031107	0	1	0	1	0	0	0	2
OG0031108	0	1	1	0	0	0	0	2
OG0031109	0	1	0	0	0	0	1	2
OG0031110	0	1	0	0	0	0	1	2
OG0031111	0	1	0	0	0	0	1	2
OG0031112	0	2	0	0	0	0	0	2
OG0031113	0	1	0	0	1	0	0	2
OG0031114	0	2	0	0	0	0	0	2
OG0031115	0	1	0	1	0	0	0	2
OG0031116	0	1	0	0	1	0	0	2
OG0031117	0	2	0	0	0	0	0	2
OG0031118	0	1	0	1	0	0	0	2
OG0031119	0	1	1	0	0	0	0	2
OG0031120	0	1	0	0	0	1	0	2
OG0031121	0	2	0	0	0	0	0	2
OG0031122	0	2	0	0	0	0	0	2
OG0031123	0	2	0	0	0	0	0	2
OG0031124	0	1	0	1	0	0	0	2
OG0031125	0	2	0	0	0	0	0	2
OG0031126	0	2	0	0	0	0	0	2
OG0031127	0	1	0	1	0	0	0	2
OG0031128	0	1	0	1	0	0	0	2
OG0031129	0	1	0	0	0	0	1	2
OG0031130	0	1	0	0	0	0	1	2
OG0031131	0	1	0	0	0	0	1	2
OG0031132	0	1	1	0	0	0	0	2
OG0031133	0	1	1	0	0	0	0	2
OG0031134	0	1	0	1	0	0	0	2
OG0031135	0	1	0	1	0	0	0	2
OG0031136	0	2	0	0	0	0	0	2
OG0031137	0	1	0	1	0	0	0	2
OG0031138	0	1	0	1	0	0	0	2
OG0031139	0	1	0	1	0	0	0	2
OG0031140	0	1	0	0	1	0	0	2
OG0031141	0	1	0	1	0	0	0	2
OG0031142	0	1	0	1	0	0	0	2
OG0031143	0	1	0	1	0	0	0	2
OG0031144	0	1	0	1	0	0	0	2
OG0031145	0	2	0	0	0	0	0	2
OG0031146	0	1	0	1	0	0	0	2
OG0031147	0	2	0	0	0	0	0	2
OG0031148	0	2	0	0	0	0	0	2
OG0031149	0	1	0	1	0	0	0	2
OG0031150	0	1	0	1	0	0	0	2
OG0031151	0	1	0	1	0	0	0	2
OG0031152	0	1	0	1	0	0	0	2
OG0031153	0	1	0	1	0	0	0	2
OG0031154	0	1	1	0	0	0	0	2
OG0031155	0	1	0	1	0	0	0	2
OG0031156	0	1	0	1	0	0	0	2
OG0031157	0	1	0	1	0	0	0	2
OG0031158	0	1	0	1	0	0	0	2
OG0031159	0	1	0	1	0	0	0	2
OG0031160	0	1	0	1	0	0	0	2
OG0031161	0	1	0	1	0	0	0	2
OG0031162	0	1	0	1	0	0	0	2
OG0031163	0	1	0	1	0	0	0	2
OG0031164	0	1	0	1	0	0	0	2
OG0031165	0	1	0	1	0	0	0	2
OG0031166	0	1	0	1	0	0	0	2
OG0031167	0	1	0	0	0	0	1	2
OG0031168	0	1	0	0	0	0	1	2
OG0031169	0	1	0	0	1	0	0	2
OG0031170	0	1	0	0	1	0	0	2
OG0031171	0	1	0	0	1	0	0	2
OG0031172	0	1	0	1	0	0	0	2
OG0031173	0	1	0	1	0	0	0	2
OG0031174	0	1	0	1	0	0	0	2
OG0031175	0	1	1	0	0	0	0	2
OG0031176	0	1	0	0	1	0	0	2
OG0031177	0	1	0	0	1	0	0	2
OG0031178	0	1	0	0	1	0	0	2
OG0031179	0	1	0	0	1	0	0	2
OG0031180	0	1	0	0	0	1	0	2
OG0031181	0	1	0	0	1	0	0	2
OG0031182	0	1	0	0	1	0	0	2
OG0031183	0	1	0	0	1	0	0	2
OG0031184	0	1	0	0	0	0	1	2
OG0031185	0	1	0	0	1	0	0	2
OG0031186	0	1	0	0	0	0	1	2
OG0031187	0	1	0	0	0	0	1	2
OG0031188	0	2	0	0	0	0	0	2
OG0031189	0	1	0	0	1	0	0	2
OG0031190	0	1	0	1	0	0	0	2
OG0031191	0	0	2	0	0	0	0	2
OG0031192	0	0	2	0	0	0	0	2
OG0031193	0	0	2	0	0	0	0	2
OG0031194	0	0	2	0	0	0	0	2
OG0031195	0	0	2	0	0	0	0	2
OG0031196	0	0	1	0	0	0	1	2
OG0031197	0	0	2	0	0	0	0	2
OG0031198	0	0	2	0	0	0	0	2
OG0031199	0	0	1	0	0	0	1	2
OG0031200	0	0	2	0	0	0	0	2
OG0031201	0	0	1	0	1	0	0	2
OG0031202	0	0	1	0	0	0	1	2
OG0031203	0	0	2	0	0	0	0	2
OG0031204	0	0	1	0	0	1	0	2
OG0031205	0	0	2	0	0	0	0	2
OG0031206	0	0	1	0	0	0	1	2
OG0031207	0	0	2	0	0	0	0	2
OG0031208	0	0	2	0	0	0	0	2
OG0031209	0	0	1	1	0	0	0	2
OG0031210	0	0	1	0	0	0	1	2
OG0031211	0	0	2	0	0	0	0	2
OG0031212	0	0	2	0	0	0	0	2
OG0031213	0	0	1	0	1	0	0	2
OG0031214	0	0	2	0	0	0	0	2
OG0031215	0	0	2	0	0	0	0	2
OG0031216	0	0	2	0	0	0	0	2
OG0031217	0	0	1	1	0	0	0	2
OG0031218	0	0	1	0	0	0	1	2
OG0031219	0	0	1	0	0	0	1	2
OG0031220	0	0	1	0	0	0	1	2
OG0031221	0	0	2	0	0	0	0	2
OG0031222	0	0	2	0	0	0	0	2
OG0031223	0	0	2	0	0	0	0	2
OG0031224	0	0	1	0	0	1	0	2
OG0031225	0	0	1	0	1	0	0	2
OG0031226	0	0	1	0	0	0	1	2
OG0031227	0	0	2	0	0	0	0	2
OG0031228	0	0	1	0	0	0	1	2
OG0031229	0	0	1	0	1	0	0	2
OG0031230	0	0	1	0	0	0	1	2
OG0031231	0	0	1	0	0	0	1	2
OG0031232	0	0	2	0	0	0	0	2
OG0031233	0	0	1	1	0	0	0	2
OG0031234	0	0	2	0	0	0	0	2
OG0031235	0	0	2	0	0	0	0	2
OG0031236	0	0	2	0	0	0	0	2
OG0031237	0	0	2	0	0	0	0	2
OG0031238	0	0	1	0	0	0	1	2
OG0031239	0	0	2	0	0	0	0	2
OG0031240	0	0	2	0	0	0	0	2
OG0031241	0	0	1	0	0	0	1	2
OG0031242	0	0	1	0	1	0	0	2
OG0031243	0	0	2	0	0	0	0	2
OG0031244	0	0	1	0	0	0	1	2
OG0031245	0	0	2	0	0	0	0	2
OG0031246	0	0	1	1	0	0	0	2
OG0031247	0	0	2	0	0	0	0	2
OG0031248	0	0	2	0	0	0	0	2
OG0031249	0	0	2	0	0	0	0	2
OG0031250	0	0	2	0	0	0	0	2
OG0031251	0	0	1	0	0	0	1	2
OG0031252	0	0	2	0	0	0	0	2
OG0031253	0	0	2	0	0	0	0	2
OG0031254	0	0	1	0	0	0	1	2
OG0031255	0	0	1	0	0	0	1	2
OG0031256	0	0	1	0	0	0	1	2
OG0031257	0	0	1	0	0	0	1	2
OG0031258	0	0	1	0	0	0	1	2
OG0031259	0	0	1	1	0	0	0	2
OG0031260	0	0	2	0	0	0	0	2
OG0031261	0	0	2	0	0	0	0	2
OG0031262	0	0	2	0	0	0	0	2
OG0031263	0	0	2	0	0	0	0	2
OG0031264	0	0	1	0	0	0	1	2
OG0031265	0	0	1	0	0	0	1	2
OG0031266	0	0	1	0	0	0	1	2
OG0031267	0	0	1	0	1	0	0	2
OG0031268	0	0	1	0	0	0	1	2
OG0031269	0	0	1	0	0	0	1	2
OG0031270	0	0	2	0	0	0	0	2
OG0031271	0	0	1	0	0	0	1	2
OG0031272	0	0	1	0	0	0	1	2
OG0031273	0	0	2	0	0	0	0	2
OG0031274	0	0	1	0	0	0	1	2
OG0031275	0	0	2	0	0	0	0	2
OG0031276	0	0	1	0	1	0	0	2
OG0031277	0	0	1	0	0	0	1	2
OG0031278	0	0	1	0	0	1	0	2
OG0031279	0	0	1	0	0	0	1	2
OG0031280	0	0	1	1	0	0	0	2
OG0031281	0	0	2	0	0	0	0	2
OG0031282	0	0	1	0	0	0	1	2
OG0031283	0	0	1	0	1	0	0	2
OG0031284	0	0	1	0	0	0	1	2
OG0031285	0	0	2	0	0	0	0	2
OG0031286	0	0	1	0	0	0	1	2
OG0031287	0	0	1	0	0	0	1	2
OG0031288	0	0	1	0	0	0	1	2
OG0031289	0	0	1	1	0	0	0	2
OG0031290	0	0	1	0	0	0	1	2
OG0031291	0	0	1	0	0	0	1	2
OG0031292	0	0	1	0	0	0	1	2
OG0031293	0	0	1	0	0	0	1	2
OG0031294	0	0	1	1	0	0	0	2
OG0031295	0	0	2	0	0	0	0	2
OG0031296	0	0	1	0	0	1	0	2
OG0031297	0	0	2	0	0	0	0	2
OG0031298	0	0	2	0	0	0	0	2
OG0031299	0	0	2	0	0	0	0	2
OG0031300	0	0	1	0	0	0	1	2
OG0031301	0	0	1	0	0	0	1	2
OG0031302	0	0	1	0	0	0	1	2
OG0031303	0	0	2	0	0	0	0	2
OG0031304	0	0	2	0	0	0	0	2
OG0031305	0	0	1	1	0	0	0	2
OG0031306	0	0	2	0	0	0	0	2
OG0031307	0	0	2	0	0	0	0	2
OG0031308	0	0	1	0	0	0	1	2
OG0031309	0	0	1	0	0	0	1	2
OG0031310	0	0	1	0	0	0	1	2
OG0031311	0	0	2	0	0	0	0	2
OG0031312	0	0	1	0	0	0	1	2
OG0031313	0	0	1	0	0	0	1	2
OG0031314	0	0	1	0	0	1	0	2
OG0031315	0	0	1	0	0	0	1	2
OG0031316	0	0	1	0	0	0	1	2
OG0031317	0	0	2	0	0	0	0	2
OG0031318	0	0	1	0	0	0	1	2
OG0031319	0	0	1	0	0	0	1	2
OG0031320	0	0	1	1	0	0	0	2
OG0031321	0	0	2	0	0	0	0	2
OG0031322	0	0	1	0	1	0	0	2
OG0031323	0	0	1	1	0	0	0	2
OG0031324	0	0	2	0	0	0	0	2
OG0031325	0	0	1	0	0	0	1	2
OG0031326	0	0	2	0	0	0	0	2
OG0031327	0	0	1	0	0	0	1	2
OG0031328	0	0	1	0	0	0	1	2
OG0031329	0	0	2	0	0	0	0	2
OG0031330	0	0	1	1	0	0	0	2
OG0031331	0	0	1	0	0	1	0	2
OG0031332	0	0	1	0	1	0	0	2
OG0031333	0	0	1	1	0	0	0	2
OG0031334	0	0	1	0	0	1	0	2
OG0031335	0	0	2	0	0	0	0	2
OG0031336	0	0	2	0	0	0	0	2
OG0031337	0	0	2	0	0	0	0	2
OG0031338	0	0	2	0	0	0	0	2
OG0031339	0	0	2	0	0	0	0	2
OG0031340	0	0	1	0	1	0	0	2
OG0031341	0	0	2	0	0	0	0	2
OG0031342	0	0	1	0	1	0	0	2
OG0031343	0	0	1	0	0	0	1	2
OG0031344	0	0	2	0	0	0	0	2
OG0031345	0	0	1	0	0	0	1	2
OG0031346	0	0	1	1	0	0	0	2
OG0031347	0	0	1	0	0	1	0	2
OG0031348	0	0	2	0	0	0	0	2
OG0031349	0	0	2	0	0	0	0	2
OG0031350	0	0	1	0	0	1	0	2
OG0031351	0	0	1	0	0	1	0	2
OG0031352	0	0	1	0	1	0	0	2
OG0031353	0	0	1	1	0	0	0	2
OG0031354	0	0	2	0	0	0	0	2
OG0031355	0	0	1	0	0	0	1	2
OG0031356	0	0	1	0	1	0	0	2
OG0031357	0	0	2	0	0	0	0	2
OG0031358	0	0	1	0	0	0	1	2
OG0031359	0	0	1	0	0	0	1	2
OG0031360	0	0	1	0	0	0	1	2
OG0031361	0	0	1	0	0	0	1	2
OG0031362	0	0	1	0	0	0	1	2
OG0031363	0	0	1	0	0	0	1	2
OG0031364	0	0	0	2	0	0	0	2
OG0031365	0	0	0	1	1	0	0	2
OG0031366	0	0	0	1	1	0	0	2
OG0031367	0	0	0	1	0	1	0	2
OG0031368	0	0	0	1	0	0	1	2
OG0031369	0	0	0	2	0	0	0	2
OG0031370	0	0	0	1	0	1	0	2
OG0031371	0	0	0	1	0	1	0	2
OG0031372	0	0	0	1	1	0	0	2
OG0031373	0	0	0	2	0	0	0	2
OG0031374	0	0	0	2	0	0	0	2
OG0031375	0	0	0	1	0	1	0	2
OG0031376	0	0	0	1	1	0	0	2
OG0031377	0	0	0	1	1	0	0	2
OG0031378	0	0	0	1	0	1	0	2
OG0031379	0	0	0	1	1	0	0	2
OG0031380	0	0	0	1	1	0	0	2
OG0031381	0	0	0	1	1	0	0	2
OG0031382	0	0	0	1	1	0	0	2
OG0031383	0	0	0	1	1	0	0	2
OG0031384	0	0	0	2	0	0	0	2
OG0031385	0	0	0	1	1	0	0	2
OG0031386	0	0	0	1	0	1	0	2
OG0031387	0	0	0	1	1	0	0	2
OG0031388	0	0	0	2	0	0	0	2
OG0031389	0	0	0	1	0	1	0	2
OG0031390	0	0	0	1	0	0	1	2
OG0031391	0	0	0	1	0	1	0	2
OG0031392	0	0	0	1	0	0	1	2
OG0031393	0	0	0	1	0	0	1	2
OG0031394	0	0	0	1	1	0	0	2
OG0031395	0	0	0	1	0	1	0	2
OG0031396	0	0	0	1	0	1	0	2
OG0031397	0	0	0	2	0	0	0	2
OG0031398	0	0	0	1	0	1	0	2
OG0031399	0	0	0	1	0	1	0	2
OG0031400	0	0	0	1	1	0	0	2
OG0031401	0	0	0	1	1	0	0	2
OG0031402	0	0	0	1	1	0	0	2
OG0031403	0	0	0	1	0	1	0	2
OG0031404	0	0	0	1	1	0	0	2
OG0031405	0	0	0	1	1	0	0	2
OG0031406	0	0	0	1	0	1	0	2
OG0031407	0	0	0	1	1	0	0	2
OG0031408	0	0	0	1	1	0	0	2
OG0031409	0	0	0	2	0	0	0	2
OG0031410	0	0	0	1	0	1	0	2
OG0031411	0	0	0	1	1	0	0	2
OG0031412	0	0	0	1	0	1	0	2
OG0031413	0	0	0	2	0	0	0	2
OG0031414	0	0	0	1	0	0	1	2
OG0031415	0	0	0	1	0	0	1	2
OG0031416	0	0	0	1	1	0	0	2
OG0031417	0	0	0	1	1	0	0	2
OG0031418	0	0	0	1	1	0	0	2
OG0031419	0	0	0	1	0	1	0	2
OG0031420	0	0	0	1	0	0	1	2
OG0031421	0	0	0	1	0	1	0	2
OG0031422	0	0	0	1	0	1	0	2
OG0031423	0	0	0	2	0	0	0	2
OG0031424	0	0	0	1	1	0	0	2
OG0031425	0	0	0	1	1	0	0	2
OG0031426	0	0	0	1	0	0	1	2
OG0031427	0	0	0	1	1	0	0	2
OG0031428	0	0	0	1	1	0	0	2
OG0031429	0	0	0	1	0	0	1	2
OG0031430	0	0	0	1	0	0	1	2
OG0031431	0	0	0	1	0	0	1	2
OG0031432	0	0	0	1	0	1	0	2
OG0031433	0	0	0	1	0	1	0	2
OG0031434	0	0	0	1	1	0	0	2
OG0031435	0	0	0	2	0	0	0	2
OG0031436	0	0	0	1	1	0	0	2
OG0031437	0	0	0	1	0	1	0	2
OG0031438	0	0	0	1	0	0	1	2
OG0031439	0	0	0	1	1	0	0	2
OG0031440	0	0	0	1	0	1	0	2
OG0031441	0	0	0	1	1	0	0	2
OG0031442	0	0	0	1	1	0	0	2
OG0031443	0	0	0	1	0	0	1	2
OG0031444	0	0	0	2	0	0	0	2
OG0031445	0	0	0	2	0	0	0	2
OG0031446	0	0	0	1	0	0	1	2
OG0031447	0	0	0	1	0	1	0	2
OG0031448	0	0	0	1	1	0	0	2
OG0031449	0	0	0	1	1	0	0	2
OG0031450	0	0	0	1	1	0	0	2
OG0031451	0	0	0	1	1	0	0	2
OG0031452	0	0	0	1	0	0	1	2
OG0031453	0	0	0	0	1	0	1	2
OG0031454	0	0	0	0	1	1	0	2
OG0031455	0	0	0	0	1	1	0	2
OG0031456	0	0	0	0	2	0	0	2
OG0031457	0	0	0	0	2	0	0	2
OG0031458	0	0	0	0	1	0	1	2
OG0031459	0	0	0	0	1	1	0	2
OG0031460	0	0	0	0	2	0	0	2
OG0031461	0	0	0	0	1	1	0	2
OG0031462	0	0	0	0	1	1	0	2
OG0031463	0	0	0	0	1	0	1	2
OG0031464	0	0	0	0	1	1	0	2
OG0031465	0	0	0	0	1	1	0	2
OG0031466	0	0	0	0	1	0	1	2
OG0031467	0	0	0	0	2	0	0	2
OG0031468	0	0	0	0	2	0	0	2
OG0031469	0	0	0	0	1	1	0	2
OG0031470	0	0	0	0	1	1	0	2
OG0031471	0	0	0	0	1	0	1	2
OG0031472	0	0	0	0	2	0	0	2
OG0031473	0	0	0	0	2	0	0	2
OG0031474	0	0	0	0	2	0	0	2
OG0031475	0	0	0	0	1	1	0	2
OG0031476	0	0	0	0	1	1	0	2
OG0031477	0	0	0	0	1	0	1	2
OG0031478	0	0	0	0	1	0	1	2
OG0031479	0	0	0	0	1	1	0	2
OG0031480	0	0	0	0	2	0	0	2
OG0031481	0	0	0	0	1	1	0	2
OG0031482	0	0	0	0	1	1	0	2
OG0031483	0	0	0	0	2	0	0	2
OG0031484	0	0	0	0	1	0	1	2
OG0031485	0	0	0	0	1	0	1	2
OG0031486	0	0	0	0	1	1	0	2
OG0031487	0	0	0	0	1	1	0	2
OG0031488	0	0	0	0	1	1	0	2
OG0031489	0	0	0	0	1	0	1	2
OG0031490	0	0	0	0	1	1	0	2
OG0031491	0	0	0	0	1	0	1	2
OG0031492	0	0	0	0	2	0	0	2
OG0031493	0	0	0	0	1	0	1	2
OG0031494	0	0	0	0	1	0	1	2
OG0031495	0	0	0	0	1	0	1	2
OG0031496	0	0	0	0	1	1	0	2
OG0031497	0	0	0	0	1	1	0	2
OG0031498	0	0	0	0	1	0	1	2
OG0031499	0	0	0	0	2	0	0	2
OG0031500	0	0	0	0	1	1	0	2
OG0031501	0	0	0	0	1	1	0	2
OG0031502	0	0	0	0	1	0	1	2
OG0031503	0	0	0	0	1	1	0	2
OG0031504	0	0	0	0	1	1	0	2
OG0031505	0	0	0	0	1	1	0	2
OG0031506	0	0	0	0	1	0	1	2
OG0031507	0	0	0	0	1	0	1	2
OG0031508	0	0	0	0	2	0	0	2
OG0031509	0	0	0	0	1	0	1	2
OG0031510	0	0	0	0	1	1	0	2
OG0031511	0	0	0	0	1	1	0	2
OG0031512	0	0	0	0	2	0	0	2
OG0031513	0	0	0	0	2	0	0	2
OG0031514	0	0	0	0	2	0	0	2
OG0031515	0	0	0	0	1	0	1	2
OG0031516	0	0	0	0	2	0	0	2
OG0031517	0	0	0	0	1	0	1	2
OG0031518	0	0	0	0	2	0	0	2
OG0031519	0	0	0	0	1	1	0	2
OG0031520	0	0	0	0	1	1	0	2
OG0031521	0	0	0	0	1	0	1	2
OG0031522	0	0	0	0	1	1	0	2
OG0031523	0	0	0	0	1	0	1	2
OG0031524	0	0	0	0	1	1	0	2
OG0031525	0	0	0	0	1	1	0	2
OG0031526	0	0	0	0	1	1	0	2
OG0031527	0	0	0	0	1	1	0	2
OG0031528	0	0	0	0	0	2	0	2
OG0031529	0	0	0	0	0	1	1	2
OG0031530	0	0	0	0	0	2	0	2
OG0031531	0	0	0	0	0	1	1	2
OG0031532	0	0	0	0	0	1	1	2
OG0031533	0	0	0	0	0	1	1	2
OG0031534	0	0	0	0	0	1	1	2
OG0031535	0	0	0	0	0	1	1	2
OG0031536	0	0	0	0	0	1	1	2
OG0031537	0	0	0	0	0	1	1	2
OG0031538	0	0	0	0	0	1	1	2
OG0031539	0	0	0	0	0	1	1	2
OG0031540	0	0	0	0	0	1	1	2
OG0031541	0	0	0	0	0	1	1	2
OG0031542	0	0	0	0	0	1	1	2
OG0031543	0	0	0	0	0	1	1	2
OG0031544	0	0	0	0	0	1	1	2
OG0031545	0	0	0	0	0	1	1	2
OG0031546	0	0	0	0	0	1	1	2
OG0031547	0	0	0	0	0	1	1	2
OG0031548	0	0	0	0	0	1	1	2
OG0031549	0	0	0	0	0	1	1	2
OG0031550	0	0	0	0	0	1	1	2
OG0031551	0	0	0	0	0	1	1	2
OG0031552	0	0	0	0	0	2	0	2
OG0031553	0	0	0	0	0	1	1	2
OG0031554	0	0	0	0	0	1	1	2
OG0031555	0	0	0	0	0	2	0	2
OG0031556	0	0	0	0	0	2	0	2
OG0031557	0	0	0	0	0	1	1	2
OG0031558	0	0	0	0	0	1	1	2
OG0031559	0	0	0	0	0	1	1	2
OG0031560	0	0	0	0	0	1	1	2
OG0031561	0	0	0	0	0	1	1	2
OG0031562	0	0	0	0	0	1	1	2
OG0031563	0	0	0	0	0	1	1	2
OG0031564	0	0	0	0	0	1	1	2
OG0031565	0	0	0	0	0	1	1	2
OG0031566	0	0	0	0	0	1	1	2
OG0031567	0	0	0	0	0	1	1	2
OG0031568	0	0	0	0	0	1	1	2
OG0031569	0	0	0	0	0	1	1	2
OG0031570	0	0	0	0	0	1	1	2
OG0031571	0	0	0	0	0	1	1	2
OG0031572	0	0	0	0	0	1	1	2
OG0031573	0	0	0	0	0	1	1	2
OG0031574	0	0	0	0	0	2	0	2
OG0031575	0	0	0	0	0	1	1	2
OG0031576	0	0	0	0	0	1	1	2
OG0031577	0	0	0	0	0	1	1	2
OG0031578	0	0	0	0	0	1	1	2
OG0031579	0	0	0	0	0	2	0	2
OG0031580	0	0	0	0	0	1	1	2
OG0031581	0	0	0	0	0	1	1	2
OG0031582	0	0	0	0	0	1	1	2
OG0031583	0	0	0	0	0	1	1	2
OG0031584	0	0	0	0	0	1	1	2
OG0031585	0	0	0	0	0	1	1	2
OG0031586	0	0	0	0	0	1	1	2
OG0031587	0	0	0	0	0	1	1	2
OG0031588	0	0	0	0	0	1	1	2
OG0031589	0	0	0	0	0	1	1	2
OG0031590	0	0	0	0	0	1	1	2
OG0031591	0	0	0	0	0	1	1	2
OG0031592	0	0	0	0	0	1	1	2
OG0031593	0	0	0	0	0	1	1	2
OG0031594	0	0	0	0	0	1	1	2
OG0031595	0	0	0	0	0	1	1	2
OG0031596	0	0	0	0	0	1	1	2
OG0031597	0	0	0	0	0	1	1	2
OG0031598	0	0	0	0	0	1	1	2
OG0031599	0	0	0	0	0	1	1	2
OG0031600	0	0	0	0	0	1	1	2
OG0031601	0	0	0	0	0	1	1	2
OG0031602	0	0	0	0	0	1	1	2
OG0031603	0	0	0	0	0	1	1	2
OG0031604	0	0	0	0	0	1	1	2
OG0031605	0	0	0	0	0	1	1	2
OG0031606	0	0	0	0	0	1	1	2
OG0031607	0	0	0	0	0	2	0	2
OG0031608	0	0	0	0	0	1	1	2
OG0031609	0	0	0	0	0	1	1	2
OG0031610	0	0	0	0	0	1	1	2
OG0031611	0	0	0	0	0	1	1	2
OG0031612	0	0	0	0	0	1	1	2
OG0031613	0	0	0	0	0	2	0	2
OG0031614	0	0	0	0	0	2	0	2
OG0031615	0	0	0	0	0	1	1	2
OG0031616	0	0	0	0	0	1	1	2
OG0031617	0	0	0	0	0	1	1	2
OG0031618	0	0	0	0	0	2	0	2
OG0031619	0	0	0	0	0	1	1	2
OG0031620	0	0	0	0	0	1	1	2
OG0031621	0	0	0	0	0	2	0	2
OG0031622	0	0	0	0	0	2	0	2
OG0031623	0	0	0	0	0	1	1	2
OG0031624	0	0	0	0	0	1	1	2
OG0031625	0	0	0	0	0	1	1	2
OG0031626	0	0	0	0	0	1	1	2
OG0031627	0	0	0	0	0	1	1	2
OG0031628	0	0	0	0	0	1	1	2
OG0031629	0	0	0	0	0	1	1	2
OG0031630	0	0	0	0	0	1	1	2
OG0031631	0	0	0	0	0	1	1	2
OG0031632	0	0	0	0	0	2	0	2
OG0031633	0	0	0	0	0	1	1	2
OG0031634	0	0	0	0	0	1	1	2
OG0031635	0	0	0	0	0	1	1	2
OG0031636	0	0	0	0	0	1	1	2
OG0031637	0	0	0	0	0	1	1	2
OG0031638	0	0	0	0	0	1	1	2
OG0031639	0	0	0	0	0	1	1	2
OG0031640	0	0	0	0	0	1	1	2
OG0031641	0	0	0	0	0	1	1	2
OG0031642	0	0	0	0	0	1	1	2
OG0031643	0	0	0	0	0	1	1	2
OG0031644	0	0	0	0	0	1	1	2
OG0031645	0	0	0	0	0	1	1	2
OG0031646	0	0	0	0	0	1	1	2
OG0031647	0	0	0	0	0	1	1	2
OG0031648	0	0	0	0	0	1	1	2
OG0031649	0	0	0	0	0	1	1	2
OG0031650	0	0	0	0	0	1	1	2
OG0031651	0	0	0	0	0	1	1	2
OG0031652	0	0	0	0	0	1	1	2
OG0031653	0	0	0	0	0	1	1	2
OG0031654	0	0	0	0	0	1	1	2
OG0031655	0	0	0	0	0	1	1	2
OG0031656	0	0	0	0	0	1	1	2
OG0031657	0	0	0	0	0	1	1	2
OG0031658	0	0	0	0	0	1	1	2
OG0031659	0	0	0	0	0	1	1	2
OG0031660	0	0	0	0	0	1	1	2
OG0031661	0	0	0	0	0	1	1	2
OG0031662	0	0	0	0	0	1	1	2
OG0031663	0	0	0	0	0	1	1	2
OG0031664	0	0	0	0	0	1	1	2
OG0031665	0	0	0	0	0	1	1	2
OG0031666	0	0	0	0	0	1	1	2
OG0031667	0	0	0	0	0	1	1	2
OG0031668	0	0	0	0	0	2	0	2
OG0031669	0	0	0	0	0	1	1	2
OG0031670	0	0	0	0	0	2	0	2
OG0031671	0	0	0	0	0	1	1	2
OG0031672	0	0	0	0	0	1	1	2
OG0031673	0	0	0	0	0	1	1	2
OG0031674	0	0	0	0	0	1	1	2
OG0031675	0	0	0	0	0	1	1	2
OG0031676	0	0	0	0	0	1	1	2
OG0031677	0	0	0	0	0	1	1	2
OG0031678	0	0	0	0	0	1	1	2
OG0031679	0	0	0	0	0	1	1	2
OG0031680	0	0	0	0	0	1	1	2
OG0031681	0	0	0	0	0	1	1	2
OG0031682	0	0	0	0	0	1	1	2
OG0031683	0	0	0	0	0	1	1	2
OG0031684	0	0	0	0	0	1	1	2
OG0031685	0	0	0	0	0	1	1	2
OG0031686	0	0	0	0	0	1	1	2
OG0031687	0	0	0	0	0	1	1	2
OG0031688	0	0	0	0	0	1	1	2
OG0031689	0	0	0	0	0	1	1	2
OG0031690	0	0	0	0	0	1	1	2
OG0031691	0	0	0	0	0	1	1	2
OG0031692	0	0	0	0	0	1	1	2
OG0031693	0	0	0	0	0	2	0	2
OG0031694	0	0	0	0	0	1	1	2
OG0031695	0	0	0	0	0	1	1	2
OG0031696	0	0	0	0	0	1	1	2
OG0031697	0	0	0	0	0	1	1	2
OG0031698	0	0	0	0	0	1	1	2
OG0031699	0	0	0	0	0	1	1	2
OG0031700	0	0	0	0	0	1	1	2
OG0031701	0	0	0	0	0	1	1	2
OG0031702	0	0	0	0	0	1	1	2
OG0031703	0	0	0	0	0	1	1	2
OG0031704	0	0	0	0	0	1	1	2
OG0031705	0	0	0	0	0	1	1	2
OG0031706	0	0	0	0	0	1	1	2
OG0031707	0	0	0	0	0	1	1	2
OG0031708	0	0	0	0	0	1	1	2
OG0031709	0	0	0	0	0	1	1	2
OG0031710	0	0	0	0	0	1	1	2
OG0031711	0	0	0	0	0	1	1	2
OG0031712	0	0	0	0	0	1	1	2
OG0031713	0	0	0	0	0	1	1	2
OG0031714	0	0	0	0	0	1	1	2
OG0031715	0	0	0	0	0	1	1	2
OG0031716	0	0	0	0	0	1	1	2
OG0031717	0	0	0	0	0	1	1	2
OG0031718	0	0	0	0	0	1	1	2
OG0031719	0	0	0	0	0	1	1	2
OG0031720	0	0	0	0	0	1	1	2
OG0031721	0	0	0	0	0	2	0	2
OG0031722	0	0	0	0	0	2	0	2
OG0031723	0	0	0	0	0	1	1	2
OG0031724	0	0	0	0	0	1	1	2
OG0031725	0	0	0	0	0	2	0	2
OG0031726	0	0	0	0	0	1	1	2
OG0031727	0	0	0	0	0	1	1	2
OG0031728	0	0	0	0	0	1	1	2
OG0031729	0	0	0	0	0	1	1	2
OG0031730	0	0	0	0	0	1	1	2
OG0031731	0	0	0	0	0	1	1	2
OG0031732	0	0	0	0	0	1	1	2
OG0031733	0	0	0	0	0	1	1	2
OG0031734	0	0	0	0	0	1	1	2
OG0031735	0	0	0	0	0	1	1	2
OG0031736	0	0	0	0	0	0	2	2
OG0031737	0	0	0	0	0	0	2	2
OG0031738	0	0	0	0	0	0	2	2
OG0031739	0	0	0	0	0	0	2	2
OG0031740	0	0	0	0	0	0	2	2
OG0031741	0	0	0	0	0	0	2	2
OG0031742	0	0	0	0	0	0	2	2
OG0031743	0	0	0	0	0	0	2	2
OG0031744	0	0	0	0	0	0	2	2
OG0031745	0	0	0	0	0	0	2	2
OG0031746	0	0	0	0	0	0	2	2
OG0031747	0	0	0	0	0	0	2	2
OG0031748	0	0	0	0	0	0	2	2
OG0031749	0	0	0	0	0	0	2	2
OG0031750	0	0	0	0	0	0	2	2
OG0031751	0	0	0	0	0	0	2	2
OG0031752	0	0	0	0	0	0	2	2
OG0031753	0	0	0	0	0	0	2	2
OG0031754	0	0	0	0	0	0	2	2
OG0031755	0	0	0	0	0	0	2	2
OG0031756	0	0	0	0	0	0	2	2
OG0031757	0	0	0	0	0	0	2	2
OG0031758	0	0	0	0	0	0	2	2
OG0031759	0	0	0	0	0	0	2	2
OG0031760	0	0	0	0	0	0	2	2
OG0031761	0	0	0	0	0	0	2	2
OG0031762	0	0	0	0	0	0	2	2
OG0031763	0	0	0	0	0	0	2	2
OG0031764	0	0	0	0	0	0	2	2
OG0031765	0	0	0	0	0	0	2	2
OG0031766	0	0	0	0	0	0	2	2
OG0031767	0	0	0	0	0	0	2	2
OG0031768	0	0	0	0	0	0	2	2
OG0031769	0	0	0	0	0	0	2	2
OG0031770	0	0	0	0	0	0	2	2
OG0031771	0	0	0	0	0	0	2	2
OG0031772	0	0	0	0	0	0	2	2
OG0031773	0	0	0	0	0	0	2	2
OG0031774	0	0	0	0	0	0	2	2
OG0031775	0	0	0	0	0	0	2	2
OG0031776	0	0	0	0	0	0	2	2
OG0031777	0	0	0	0	0	0	2	2
OG0031778	0	0	0	0	0	0	2	2
OG0031779	0	0	0	0	0	0	2	2
OG0031780	0	0	0	0	0	0	2	2
OG0031781	0	0	0	0	0	0	2	2
OG0031782	0	0	0	0	0	0	2	2
OG0031783	0	0	0	0	0	0	2	2
OG0031784	0	0	0	0	0	0	2	2
OG0031785	0	0	0	0	0	0	2	2
OG0031786	0	0	0	0	0	0	2	2
OG0031787	0	0	0	0	0	0	2	2
OG0031788	0	0	0	0	0	0	2	2
OG0031789	0	0	0	0	0	0	2	2
OG0031790	0	0	0	0	0	0	2	2
OG0031791	0	0	0	0	0	0	2	2
OG0031792	0	0	0	0	0	0	2	2
OG0031793	0	0	0	0	0	0	2	2
OG0031794	0	0	0	0	0	0	2	2
OG0031795	0	0	0	0	0	0	2	2
OG0031796	0	0	0	0	0	0	2	2
OG0031797	0	0	0	0	0	0	2	2
OG0031798	0	0	0	0	0	0	2	2
OG0031799	0	0	0	0	0	0	2	2
OG0031800	0	0	0	0	0	0	2	2
OG0031801	0	0	0	0	0	0	2	2
OG0031802	0	0	0	0	0	0	2	2
OG0031803	0	0	0	0	0	0	2	2
OG0031804	0	0	0	0	0	0	2	2
OG0031805	0	0	0	0	0	0	2	2
OG0031806	0	0	0	0	0	0	2	2
OG0031807	0	0	0	0	0	0	2	2
OG0031808	0	0	0	0	0	0	2	2
OG0031809	0	0	0	0	0	0	2	2
OG0031810	0	0	0	0	0	0	2	2
OG0031811	0	0	0	0	0	0	2	2
OG0031812	0	0	0	0	0	0	2	2
OG0031813	0	0	0	0	0	0	2	2
OG0031814	0	0	0	0	0	0	2	2
OG0031815	0	0	0	0	0	0	2	2
OG0031816	0	0	0	0	0	0	2	2
OG0031817	0	0	0	0	0	0	2	2
OG0031818	0	0	0	0	0	0	2	2
OG0031819	0	0	0	0	0	0	2	2
OG0031820	0	0	0	0	0	0	2	2
OG0031821	0	0	0	0	0	0	2	2
OG0031822	0	0	0	0	0	0	2	2
OG0031823	0	0	0	0	0	0	2	2
OG0031824	0	0	0	0	0	0	2	2
OG0031825	0	0	0	0	0	0	2	2
OG0031826	0	0	0	0	0	0	2	2
OG0031827	0	0	0	0	0	0	2	2
OG0031828	0	0	0	0	0	0	2	2
OG0031829	0	0	0	0	0	0	2	2
OG0031830	0	0	0	0	0	0	2	2
OG0031831	0	0	0	0	0	0	2	2
OG0031832	0	0	0	0	0	0	2	2
OG0031833	0	0	0	0	0	0	2	2
OG0031834	0	0	0	0	0	0	2	2
OG0031835	0	0	0	0	0	0	2	2
OG0031836	0	0	0	0	0	0	2	2
OG0031837	0	0	0	0	0	0	2	2
OG0031838	0	0	0	0	0	0	2	2
OG0031839	0	0	0	0	0	0	2	2
OG0031840	0	0	0	0	0	0	2	2
OG0031841	0	0	0	0	0	0	2	2
OG0031842	0	0	0	0	0	0	2	2
OG0031843	0	0	0	0	0	0	2	2
OG0031844	0	0	0	0	0	0	2	2
OG0031845	0	0	0	0	0	0	2	2
OG0031846	0	0	0	0	0	0	2	2
OG0031847	0	0	0	0	0	0	2	2
OG0031848	0	0	0	0	0	0	2	2
OG0031849	0	0	0	0	0	0	2	2
OG0031850	0	0	0	0	0	0	2	2
OG0031851	0	0	0	0	0	0	2	2
OG0031852	0	0	0	0	0	0	2	2
OG0031853	0	0	0	0	0	0	2	2
OG0031854	0	0	0	0	0	0	2	2
OG0031855	0	0	0	0	0	0	2	2
OG0031856	0	0	0	0	0	0	2	2
OG0031857	0	0	0	0	0	0	2	2
OG0031858	0	0	0	0	0	0	2	2
OG0031859	0	0	0	0	0	0	2	2
OG0031860	0	0	0	0	0	0	2	2
OG0031861	0	0	0	0	0	0	2	2
OG0031862	0	0	0	0	0	0	2	2
OG0031863	0	0	0	0	0	0	2	2
OG0031864	0	0	0	0	0	0	2	2
OG0031865	0	0	0	0	0	0	2	2
OG0031866	0	0	0	0	0	0	2	2
OG0031867	0	0	0	0	0	0	2	2
OG0031868	0	0	0	0	0	0	2	2
OG0031869	0	0	0	0	0	0	2	2
OG0031870	0	0	0	0	0	0	2	2
OG0031871	0	0	0	0	0	0	2	2
OG0031872	0	0	0	0	0	0	2	2
OG0031873	0	0	0	0	0	0	2	2
OG0031874	0	0	0	0	0	0	2	2
OG0031875	0	0	0	0	0	0	2	2
OG0031876	0	0	0	0	0	0	2	2
OG0031877	0	0	0	0	0	0	2	2
OG0031878	0	0	0	0	0	0	2	2
OG0031879	0	0	0	0	0	0	2	2
OG0031880	0	0	0	0	0	0	2	2
OG0031881	0	0	0	0	0	0	2	2
OG0031882	0	0	0	0	0	0	2	2
OG0031883	0	0	0	0	0	0	2	2
OG0031884	0	0	0	0	0	0	2	2
OG0031885	0	0	0	0	0	0	2	2
OG0031886	0	0	0	0	0	0	2	2
OG0031887	0	0	0	0	0	0	2	2
OG0031888	0	0	0	0	0	0	2	2
OG0031889	0	0	0	0	0	0	2	2
OG0031890	0	0	0	0	0	0	2	2
